GeneName,up5,dn5,unchange5,all,HN5
HSPA6,247,2,73,322,245
HSPA1A,240,1,81,322,239
HSPA1B,233,2,87,322,231
DNAJB1,212,2,108,322,210
BAG3,182,1,139,322,181
PNLDC1,177,2,143,322,175
CRYAB,174,1,147,322,173
HSPH1,167,0,155,322,167
FOS,172,7,143,322,165
ZFAND2A,168,3,151,322,165
RRAD,159,4,159,322,155
LTA,156,2,164,322,154
HSPA1L,151,1,170,322,150
DNAJB4,150,1,171,322,149
DEDD2,146,3,173,322,143
DCAF4L1,141,0,181,322,141
PGF,144,3,175,322,141
IER5,140,0,182,322,140
HBA2,149,10,163,322,139
FKBP4,132,3,187,322,129
MIA,140,13,169,322,127
TENT5A,129,2,191,322,127
ACTRT3,129,3,190,322,126
RGS2,130,8,184,322,122
VHLL,124,3,195,322,121
TEX43,129,10,183,322,119
SERPINH1,120,1,201,322,119
FOSB,125,7,190,322,118
RFPL2,119,2,201,322,117
FBLL1,120,4,198,322,116
LSMEM1,116,3,203,322,113
CCDC121,114,1,207,322,113
HSPB1,115,3,204,322,112
NHLH1,112,1,209,322,111
CCDC81,110,1,211,322,109
TULP2,122,14,186,322,108
DNAJA4,110,4,208,322,106
EGR2,108,4,210,322,104
ALOXE3,100,0,222,322,100
HSPB8,103,3,216,322,100
C2orf66,102,2,218,322,100
TMEM95,100,1,221,322,99
LCN10,104,6,212,322,98
PCSK5,105,7,210,322,98
ADCY10,100,3,219,322,97
HSPA4L,96,0,226,322,96
SESN3,95,0,227,322,95
CCL26,113,18,191,322,95
CASS4,92,1,229,322,91
HSPE1-MOB4,99,9,214,322,90
USPL1,91,2,229,322,89
LY6G6C,95,6,221,322,89
ATF3,94,6,222,322,88
EGR1,97,10,215,322,87
DUSP1,90,3,229,322,87
MAFB,87,1,234,322,86
FOXJ1,83,0,239,322,83
ENGASE,85,2,235,322,83
COX8C,98,15,209,322,83
DEFB115,88,5,229,322,83
DHDH,96,14,212,322,82
TICAM2,83,2,237,322,81
CSF3,82,1,239,322,81
CLU,85,4,233,322,81
CHRNA2,84,4,234,322,80
MIA-RAB4B,99,19,204,322,80
C11orf94,104,25,193,322,79
THEGL,81,2,239,322,79
CHORDC1,79,0,243,322,79
DUX4,82,4,236,322,78
CCNP,82,4,236,322,78
HSPB9,86,10,226,322,76
SUMO4,85,9,228,322,76
FAM177B,81,6,235,322,75
B3GALT4,79,4,239,322,75
CACNA1G,77,3,242,322,74
RASD1,80,6,236,322,74
KLHL25,74,0,248,322,74
HSPB2,80,7,235,322,73
FZD8,75,2,245,322,73
IGLV1-50,95,23,204,322,72
SERPINC1,73,1,248,322,72
C11orf96,75,3,244,322,72
CFAP53,73,1,248,322,72
TMPRSS9,75,3,244,322,72
H1-6,76,4,242,322,72
GAL3ST1,81,9,232,322,72
ARC,72,1,249,322,71
CDRT1,74,3,245,322,71
IFI35,72,1,249,322,71
LGALS4,82,12,228,322,70
DEPP1,79,9,234,322,70
CFP,73,3,246,322,70
CD14,75,5,242,322,70
TMEM31,75,5,242,322,70
EGR3,71,2,249,322,69
MAFA,71,2,249,322,69
HBA1,80,11,231,322,69
C7orf61,70,1,251,322,69
GEM,69,0,253,322,69
NR4A3,70,2,250,322,68
SERINC4,71,3,248,322,68
TNF,70,2,250,322,68
HSP90AA1,69,1,252,322,68
DNAJA1,69,2,251,322,67
JMJD6,68,1,253,322,67
RSPH10B2,73,6,243,322,67
ESR1,73,6,243,322,67
XIRP1,69,2,251,322,67
COL26A1,70,3,249,322,67
LAG3,69,2,251,322,67
SEMA4A,72,5,245,322,67
EFCAB12,67,1,254,322,66
OOEP,72,6,244,322,66
CLDN9,68,2,252,322,66
UCP3,68,3,251,322,65
LENEP,71,6,245,322,65
CLDN6,72,7,243,322,65
SULT6B1,75,11,236,322,64
PNCK,76,12,234,322,64
IGHG4,67,3,252,322,64
FOXD4L3,68,4,250,322,64
CLK1,63,0,259,322,63
C17orf67,64,1,257,322,63
BMP4,65,2,255,322,63
JUN,66,3,253,322,63
TRIML2,65,2,255,322,63
LRIT3,63,0,259,322,63
MRPL18,66,3,253,322,63
OR2B6,68,6,248,322,62
MAP7D2,64,2,256,322,62
IL31,65,3,254,322,62
KCNE5,64,2,256,322,62
PLA2G12B,68,6,248,322,62
CCL20,73,11,238,322,62
GAS1,66,4,252,322,62
NCR3,67,5,250,322,62
SLC6A13,67,6,249,322,61
MGARP,62,1,259,322,61
C4orf47,63,2,257,322,61
CLEC18B,73,12,237,322,61
FRG2B,62,3,257,322,59
SPDYA,67,8,247,322,59
WDR49,69,10,243,322,59
HIBCH,62,3,257,322,59
SLC5A3,61,3,258,322,58
FBXL14,59,1,262,322,58
N4BP2L1,61,3,258,322,58
RASL11A,59,1,262,322,58
DYNLT2,65,7,250,322,58
RSPH10B,69,11,242,322,58
NOXRED1,59,1,262,322,58
PLPPR5,58,1,263,322,57
GPA33,60,3,259,322,57
ADORA2A,65,8,249,322,57
PPP1R15A,62,5,255,322,57
TRAF3IP3,66,9,247,322,57
GZMM,66,9,247,322,57
ALDH8A1,60,3,259,322,57
NKRF,59,2,261,322,57
NPIPB9,67,10,245,322,57
CEP295NL,64,7,251,322,57
TBR1,60,3,259,322,57
PROCA1,58,2,262,322,56
FAM209A,75,19,228,322,56
NXT2,61,5,256,322,56
POU2F2,60,4,258,322,56
CYP39A1,57,1,264,322,56
FOXD4L6,69,13,240,322,56
GCGR,60,4,258,322,56
KCTD14,60,5,257,322,55
HSPD1,57,2,263,322,55
TSSK4,61,6,255,322,55
PLAC8L1,57,2,263,322,55
UBB,57,2,263,322,55
UPK1A,61,7,254,322,54
GAGE10,65,11,246,322,54
CACFD1,59,5,258,322,54
EID3,60,6,256,322,54
GAST,73,20,229,322,53
FERMT3,57,4,261,322,53
PRSS55,53,0,269,322,53
PPP1R3C,53,0,269,322,53
SELPLG,59,6,257,322,53
CFAP97D2,54,1,267,322,53
ERICH5,55,3,264,322,52
NPC1L1,56,4,262,322,52
C9orf152,54,2,266,322,52
CACYBP,57,5,260,322,52
TMC4,63,11,248,322,52
TSPYL2,54,3,265,322,51
PRR18,53,2,267,322,51
HEY1,55,4,263,322,51
TMEM216,55,4,263,322,51
FAM83C,54,3,265,322,51
FBXW10,52,1,269,322,51
SPOCK2,52,1,269,322,51
SBSN,53,2,267,322,51
PNMA8A,53,2,267,322,51
SNX31,61,10,251,322,51
LYG2,58,8,256,322,50
OIT3,51,1,270,322,50
ACRBP,57,7,258,322,50
RPL3L,54,5,263,322,49
NUCB1,52,3,267,322,49
TEX54,69,20,233,322,49
AOC3,52,3,267,322,49
OXT,57,8,257,322,49
TAL2,57,8,257,322,49
LEAP2,52,3,267,322,49
IGHV1OR21-1,50,1,271,322,49
UBC,51,2,269,322,49
GADD45G,55,7,260,322,48
ACTA1,55,7,260,322,48
TCP10L,67,19,236,322,48
SYNM,48,0,274,322,48
EFNA2,54,6,262,322,48
MICB,48,1,273,322,47
ABHD3,51,4,267,322,47
SOCS3,49,2,271,322,47
SLC1A3,50,3,269,322,47
NR4A2,50,3,269,322,47
HSPA8,50,3,269,322,47
CCDC194,54,7,261,322,47
AHSA1,48,1,273,322,47
TEX19,48,2,272,322,46
C19orf38,51,5,266,322,46
KCNN2,46,0,276,322,46
DDIT4,50,4,268,322,46
GPR89A,46,0,276,322,46
MAPK10,52,6,264,322,46
PPP1R42,53,7,262,322,46
FSCN3,48,2,272,322,46
COL1A1,48,2,272,322,46
PTPN22,50,5,267,322,45
OR6B3,45,0,277,322,45
ZC3H12A,47,2,273,322,45
TMEM100,49,4,269,322,45
TENT5C,46,1,275,322,45
H3-4,53,8,261,322,45
STPG4,61,16,245,322,45
DCLRE1B,49,4,269,322,45
FOXD4L4,49,4,269,322,45
S100A14,53,8,261,322,45
PROX1,47,2,273,322,45
RNF225,57,12,253,322,45
ARL14EPL,44,0,278,322,44
RAB39A,45,1,276,322,44
NR4A1,48,4,270,322,44
SCN7A,47,3,272,322,44
SEMA4D,47,3,272,322,44
LYPD4,48,4,270,322,44
C8G,59,15,248,322,44
CRYBA4,52,8,262,322,44
ARHGEF33,50,6,266,322,44
APOE,47,3,272,322,44
DAZL,46,2,274,322,44
ARHGAP30,46,2,274,322,44
GJD4,44,0,278,322,44
FOXD4L1,44,0,278,322,44
ARL9,45,2,275,322,43
LCT,43,0,279,322,43
FRG2C,47,4,271,322,43
MASP2,55,12,255,322,43
ANKRD65,50,7,265,322,43
TTYH2,44,1,277,322,43
NCF1,57,14,251,322,43
TBX3,45,2,275,322,43
C17orf98,68,25,229,322,43
BEST2,50,7,265,322,43
DUSP2,48,5,269,322,43
LSMEM2,54,11,257,322,43
KCTD11,43,1,278,322,42
KCNQ2,48,6,268,322,42
CHRNA5,44,2,276,322,42
TMIE,45,3,274,322,42
NDUFC2-KCTD14,60,18,244,322,42
RAB40AL,47,5,270,322,42
SLC45A2,46,4,272,322,42
WHRN,43,1,278,322,42
H2BC1,45,3,274,322,42
PPP1R27,52,10,260,322,42
GAGE12F,60,18,244,322,42
FAM71E2,42,0,280,322,42
BAMBI,45,3,274,322,42
DNAJC24,45,3,274,322,42
PHKG1,45,3,274,322,42
LY6G6E,58,16,248,322,42
BDKRB1,47,5,270,322,42
RFPL4A,47,6,269,322,41
FAM209B,55,14,253,322,41
TMEM262,54,13,255,322,41
DHRS2,47,6,269,322,41
PTGER1,48,7,267,322,41
MYRFL,41,0,281,322,41
SLCO2B1,50,9,263,322,41
RFPL4AL1,45,4,273,322,41
GPBAR1,46,5,271,322,41
AKR7L,49,8,265,322,41
ID2,41,0,281,322,41
MEX3B,41,0,281,322,41
NUDT17,46,5,271,322,41
CPED1,42,1,279,322,41
CD79A,44,4,274,322,40
OTOR,41,1,280,322,40
COL2A1,42,2,278,322,40
SMIM24,51,11,260,322,40
RRH,40,0,282,322,40
PCK1,41,1,280,322,40
JSRP1,49,9,264,322,40
STPG3,44,4,274,322,40
C11orf52,49,9,264,322,40
GABRE,42,2,278,322,40
BCL2L10,45,5,272,322,40
C11orf91,64,24,234,322,40
MRC1,40,0,282,322,40
MOB4,41,1,280,322,40
LYG1,48,8,266,322,40
CA3,46,6,270,322,40
H2AC1,47,7,268,322,40
DLX2,42,2,278,322,40
TIGD3,41,1,280,322,40
RNF148,42,3,277,322,39
HSPE1,44,5,273,322,39
SPDYE21,45,6,271,322,39
SLC35G5,41,2,279,322,39
CMYA5,40,1,281,322,39
H4C7,53,14,255,322,39
SCYGR2,53,14,255,322,39
TCTE1,42,3,277,322,39
PRR20A,40,1,281,322,39
TCAP,50,11,261,322,39
MUC12,45,6,271,322,39
FHL5,39,0,283,322,39
CARD9,41,2,279,322,39
CPEB4,44,5,273,322,39
MMP23B,46,7,269,322,39
ZNF80,39,1,282,322,38
SNAI1,45,7,270,322,38
CITED1,54,16,252,322,38
BMT2,38,0,284,322,38
IQCA1L,40,2,280,322,38
PILRA,43,5,274,322,38
AP4B1,41,3,278,322,38
ACSBG1,42,4,276,322,38
CGB2,52,14,256,322,38
RBFOX3,49,11,262,322,38
SLC17A8,38,0,284,322,38
ZFP91-CNTF,57,19,246,322,38
GDF9,39,2,281,322,37
FBXO15,45,8,269,322,37
DHH,39,2,281,322,37
ATF7IP2,40,3,279,322,37
CCNO,41,4,277,322,37
VSIG2,42,5,275,322,37
TMED6,47,10,265,322,37
SRRM5,37,0,285,322,37
PDZK1,38,1,283,322,37
TMEM238,52,15,255,322,37
IFI27,53,16,253,322,37
C20orf204,43,6,273,322,37
MYOCOS,41,4,277,322,37
FOXD4L5,38,1,283,322,37
PABPC4L,37,0,285,322,37
LCN12,52,15,255,322,37
TLR9,44,7,271,322,37
USP50,49,12,261,322,37
CD300H,48,11,263,322,37
H2AC8,53,17,252,322,36
OTUD1,37,1,284,322,36
SLC7A9,37,1,284,322,36
MBNL2,36,0,286,322,36
PLVAP,42,6,274,322,36
GNLY,40,4,278,322,36
PDE2A,51,15,256,322,36
CORT,59,23,240,322,36
ADGRF3,37,1,284,322,36
LMAN1L,45,9,268,322,36
DIRAS1,41,5,276,322,36
SCUBE2,44,8,270,322,36
COLEC11,45,9,268,322,36
SLC6A12,38,2,282,322,36
PTHLH,41,5,276,322,36
SOCS1,44,9,269,322,35
RAB4B-EGLN2,49,14,259,322,35
C10orf99,38,3,281,322,35
CBFA2T3,40,5,277,322,35
RGS16,38,3,281,322,35
TCEAL9,37,2,283,322,35
SORBS1,38,3,281,322,35
SHISA2,37,2,283,322,35
CPLX4,37,2,283,322,35
GADD45B,38,3,281,322,35
DNMT3L,39,4,279,322,35
TMEM240,38,3,281,322,35
C1orf189,53,18,251,322,35
EIF3CL,59,24,239,322,35
LYPD5,38,3,281,322,35
GPR89B,40,5,277,322,35
WDR88,40,6,276,322,34
PDE6G,51,17,254,322,34
MMP10,38,4,280,322,34
FGF18,37,3,282,322,34
TRIM15,39,5,278,322,34
CDKN1C,37,3,282,322,34
GRIP1,56,22,244,322,34
DPYS,39,5,278,322,34
AKAP14,48,14,260,322,34
GGN,44,10,268,322,34
FAM167B,43,9,270,322,34
SYNE4,45,11,266,322,34
ATP2B3,36,2,284,322,34
IL17F,40,6,276,322,34
NBL1,35,1,286,322,34
SLC8A2,34,0,288,322,34
CGAS,35,1,286,322,34
TMEM210,47,13,262,322,34
TSHZ1,39,5,278,322,34
DNAJB6,36,2,284,322,34
IQCF1,38,4,280,322,34
ABTB2,37,3,282,322,34
ISL1,37,3,282,322,34
WFDC2,46,12,264,322,34
MYCL,34,1,287,322,33
ACHE,37,4,281,322,33
CFAP61,47,14,261,322,33
HSPA5,36,3,283,322,33
HOXD1,34,1,287,322,33
SOX2,34,1,287,322,33
MXD1,34,1,287,322,33
GATA5,40,7,275,322,33
GCNA,34,1,287,322,33
FES,39,6,277,322,33
TG,40,7,275,322,33
CETP,35,2,285,322,33
NRARP,33,0,289,322,33
CHAC1,54,21,247,322,33
OOSP4B,36,3,283,322,33
KCNJ2,38,5,279,322,33
CYP2C18,34,1,287,322,33
CATSPER4,33,0,289,322,33
GFPT2,34,1,287,322,33
SRRM3,34,1,287,322,33
MRLN,60,27,235,322,33
TNFRSF4,41,8,273,322,33
IRF8,35,2,285,322,33
TNFRSF18,37,4,281,322,33
EFEMP1,43,10,269,322,33
C20orf144,52,19,251,322,33
VSTM1,42,9,271,322,33
GUCA1B,34,1,287,322,33
CLDN24,42,9,271,322,33
HES1,43,10,269,322,33
ZNF177,43,11,268,322,32
KCNK7,43,11,268,322,32
TMEM119,39,7,276,322,32
FAM222A,36,4,282,322,32
BST2,36,4,282,322,32
SIX1,39,7,276,322,32
PPIAL4G,58,26,238,322,32
S100P,48,16,258,322,32
C9orf153,40,8,274,322,32
IFNA5,35,3,284,322,32
CDKN2C,35,3,284,322,32
TNN,32,0,290,322,32
CSPG5,35,3,284,322,32
CASP12,32,0,290,322,32
NEU4,40,8,274,322,32
ZFP36,39,7,276,322,32
FTCD,41,10,271,322,31
PTGER3,31,0,291,322,31
PRLR,33,2,287,322,31
ASTL,34,3,285,322,31
TRIB1,32,1,289,322,31
PLA2G10,47,16,259,322,31
TNFSF14,36,5,281,322,31
PIP5KL1,33,2,287,322,31
RFPL3,35,4,283,322,31
H3C8,33,2,287,322,31
ELAVL3,32,1,289,322,31
C9orf24,40,9,273,322,31
EPGN,38,7,277,322,31
PPP1R32,34,3,285,322,31
IL5,54,23,245,322,31
DBP,33,2,287,322,31
ITK,42,11,269,322,31
CPEB3,31,0,291,322,31
PLCD4,36,5,281,322,31
ACR,38,7,277,322,31
CXCR4,33,2,287,322,31
NRN1L,42,11,269,322,31
CYP21A2,37,6,279,322,31
SCT,55,24,243,322,31
CASP5,43,13,266,322,30
BTN3A3,38,8,276,322,30
TEX29,45,15,262,322,30
AQP3,32,2,288,322,30
FOXD3,31,1,290,322,30
TNNC2,51,21,250,322,30
LBH,38,8,276,322,30
C7orf25,32,2,288,322,30
CRACR2B,39,9,274,322,30
PTGDS,43,13,266,322,30
TEX13B,30,0,292,322,30
C17orf99,38,8,276,322,30
OVGP1,34,4,284,322,30
RNF133,30,0,292,322,30
CCDC13,33,3,286,322,30
VPREB3,53,23,246,322,30
TMED7-TICAM2,33,3,286,322,30
C10orf62,31,1,290,322,30
TNFAIP3,35,5,282,322,30
CFAP44,39,9,274,322,30
DIRAS2,38,8,276,322,30
LRRC4,39,9,274,322,30
ADAM20,31,1,290,322,30
STIP1,34,4,284,322,30
TMEM37,41,11,270,322,30
ARL14,36,6,280,322,30
HMOX1,33,3,286,322,30
NPIPB11,36,7,279,322,29
TRIM26,29,0,293,322,29
LRRC70,35,6,281,322,29
TMEM163,39,10,273,322,29
CERS1,32,3,287,322,29
GPBP1,29,0,293,322,29
CCDC168,29,0,293,322,29
MMD2,29,0,293,322,29
ATP6V1G2,39,10,273,322,29
ZNF559-ZNF177,43,14,265,322,29
SHISA4,30,1,291,322,29
MYO1A,38,9,275,322,29
HERPUD1,35,6,281,322,29
YIPF7,44,15,263,322,29
TAS2R3,32,3,287,322,29
HGD,36,7,279,322,29
EMX1,36,7,279,322,29
C19orf67,32,3,287,322,29
CD7,33,4,285,322,29
DOK2,31,2,289,322,29
RFTN2,34,5,283,322,29
LGALS7,36,7,279,322,29
ADIG,48,19,255,322,29
TAC3,38,9,275,322,29
ULBP1,30,1,291,322,29
RCN3,46,17,259,322,29
BCL2L11,34,5,283,322,29
TPH2,31,2,289,322,29
DPEP2NB,30,1,291,322,29
ZNF596,31,2,289,322,29
GLYAT,32,3,287,322,29
IHH,28,0,294,322,28
SLC22A18AS,35,7,280,322,28
GUCA2A,39,11,272,322,28
VWA7,30,2,290,322,28
CTRB2,37,9,276,322,28
MCF2,28,0,294,322,28
MCU,30,2,290,322,28
SEPTIN12,45,17,260,322,28
CT45A8,38,10,274,322,28
CT45A10,41,13,268,322,28
MUC20,30,2,290,322,28
SYCP3,35,7,280,322,28
FABP3,32,4,286,322,28
CD74,38,10,274,322,28
RGPD6,65,37,220,322,28
MLKL,31,3,288,322,28
MAGEB3,31,3,288,322,28
ANKRD37,40,12,270,322,28
L3MBTL3,31,3,288,322,28
ZDHHC11,33,5,284,322,28
ATP6V1FNB,30,2,290,322,28
KIF5A,41,13,268,322,28
CRIP2,35,7,280,322,28
SESN2,39,11,272,322,28
MSH4,29,1,292,322,28
WDR38,35,7,280,322,28
PTPN6,33,5,284,322,28
LCK,33,5,284,322,28
TRIM69,29,1,292,322,28
EFCAB13,40,12,270,322,28
TMEM235,28,0,294,322,28
KRTAP12-2,29,1,292,322,28
KCNH3,33,5,284,322,28
CXCL8,48,20,254,322,28
ZNF560,28,0,294,322,28
MZB1,40,12,270,322,28
CHRNA7,42,14,266,322,28
GALNT9,32,4,286,322,28
GTF2A1L,40,12,270,322,28
USP17L2,30,2,290,322,28
TAS2R9,31,3,288,322,28
BTK,29,1,292,322,28
CNKSR1,30,2,290,322,28
HIC1,33,5,284,322,28
HSD17B3,35,7,280,322,28
ESAM,34,6,282,322,28
HP,37,10,275,322,27
EFCAB7,29,2,291,322,27
FOXD4,32,5,285,322,27
GPR50,27,0,295,322,27
SAMD11,38,11,273,322,27
SORD,28,1,293,322,27
HYPK,31,4,287,322,27
SAMD14,30,3,289,322,27
UTP14C,41,14,267,322,27
MTRNR2L11,29,2,291,322,27
FAM53A,30,3,289,322,27
ICAM4,36,9,277,322,27
PTGES3,29,2,291,322,27
BAAT,29,2,291,322,27
TAS2R5,32,5,285,322,27
FAM83E,30,3,289,322,27
INO80B-WBP1,54,27,241,322,27
MAP1A,28,1,293,322,27
DMRTB1,29,2,291,322,27
PMVK,29,2,291,322,27
MKNK2,30,3,289,322,27
MT1H,40,13,269,322,27
TCP1,29,2,291,322,27
MYO10,28,1,293,322,27
MBOAT7,29,2,291,322,27
CLEC18A,46,19,257,322,27
CHADL,36,9,277,322,27
CHRNA3,34,7,281,322,27
FMR1NB,29,2,291,322,27
LRIF1,27,0,295,322,27
ABHD16B,34,7,281,322,27
VAMP8,38,11,273,322,27
GPRC5D,44,17,261,322,27
FAM25A,59,32,231,322,27
MITF,29,3,290,322,26
S100A7,30,4,288,322,26
IGHG2,27,1,294,322,26
NPIPB6,50,24,248,322,26
ZMAT5,30,4,288,322,26
C17orf64,39,13,270,322,26
ADRA2B,26,0,296,322,26
MEGF10,27,1,294,322,26
SOX4,27,1,294,322,26
SAG,33,7,282,322,26
NUTM2E,32,6,284,322,26
MEP1B,26,0,296,322,26
SPDYE1,34,8,280,322,26
ABCB4,33,7,282,322,26
ATP2C1,28,2,292,322,26
SCHIP1,36,10,276,322,26
SIRT4,30,4,288,322,26
GNRH2,47,21,254,322,26
ZCCHC12,34,8,280,322,26
DNHD1,26,0,296,322,26
GPN1,26,0,296,322,26
DPPA5,29,3,290,322,26
AQP8,26,0,296,322,26
RHOB,27,1,294,322,26
GRHL1,30,4,288,322,26
BCO2,30,4,288,322,26
KSR1,31,5,286,322,26
CELF2,26,0,296,322,26
HSPA4,27,1,294,322,26
DUSP4,32,6,284,322,26
DUSP5,32,6,284,322,26
INIP,28,2,292,322,26
SCYGR3,31,5,286,322,26
FGF21,36,10,276,322,26
TTC23L,29,3,290,322,26
EDN2,32,7,283,322,25
NDRG1,36,11,275,322,25
TEX46,55,30,237,322,25
CT45A1,39,14,269,322,25
MCCD1,35,10,277,322,25
ZSCAN31,27,2,293,322,25
CLEC4A,36,11,275,322,25
MT3,35,10,277,322,25
MTHFD2L,26,1,295,322,25
IGHG3,26,1,295,322,25
LRP3,35,10,277,322,25
CCDC89,26,1,295,322,25
MTRNR2L10,31,6,285,322,25
ERRFI1,29,4,289,322,25
IFFO1,27,2,293,322,25
ADGRL2,25,0,297,322,25
H4C9,32,7,283,322,25
ACTL7B,28,3,291,322,25
P2RY8,26,1,295,322,25
BCL6B,31,6,285,322,25
MDGA1,36,11,275,322,25
NR2E1,25,0,297,322,25
STYK1,39,14,269,322,25
DUOXA1,29,4,289,322,25
BCL2L15,33,8,281,322,25
HLA-DQA1,43,18,261,322,25
ADAM32,33,8,281,322,25
MAFF,36,11,275,322,25
CGREF1,28,3,291,322,25
IGLV9-49,32,7,283,322,25
MLIP,34,9,279,322,25
ANKDD1B,32,7,283,322,25
MXRA8,26,1,295,322,25
C1QTNF4,32,7,283,322,25
GPR84,35,10,277,322,25
COPZ2,29,4,289,322,25
HIKESHI,25,1,296,322,24
NTN4,26,2,294,322,24
RND1,32,8,282,322,24
TM6SF2,28,4,290,322,24
BCL10,26,2,294,322,24
PITX2,27,3,292,322,24
GABRG2,36,12,274,322,24
NPR3,28,4,290,322,24
RANGAP1,28,4,290,322,24
NAALAD2,31,7,284,322,24
TENT4B,24,0,298,322,24
MT1G,53,29,240,322,24
NPPC,29,5,288,322,24
NECTIN4,25,1,296,322,24
KLK6,29,5,288,322,24
TPPP3,27,3,292,322,24
OR2B2,31,7,284,322,24
ITIH1,27,3,292,322,24
RBAK-RBAKDN,35,11,276,322,24
MYL4,37,13,272,322,24
UBE2F-SCLY,41,17,264,322,24
WNT11,36,12,274,322,24
ASB16,26,2,294,322,24
MSMB,35,11,276,322,24
CALCA,24,0,298,322,24
ICAM2,30,6,286,322,24
ANKRD1,28,4,290,322,24
SYCE3,50,26,246,322,24
EDN1,28,5,289,322,23
MEIG1,35,12,275,322,23
PRKD2,28,5,289,322,23
CSRP2,26,3,293,322,23
SQOR,26,3,293,322,23
CLDN22,29,6,287,322,23
ST14,23,0,299,322,23
SCGB3A2,39,16,267,322,23
RAB6B,24,1,297,322,23
HUNK,25,2,295,322,23
VCX3A,34,11,277,322,23
POU3F1,32,9,281,322,23
OSM,25,2,295,322,23
H4C4,43,20,259,322,23
ROPN1L,28,5,289,322,23
CENPV,24,1,297,322,23
ASB2,27,4,291,322,23
PMEPA1,30,7,285,322,23
APOC1,55,32,235,322,23
KCNK4,27,4,291,322,23
VIPAS39,24,1,297,322,23
DNAJB2,27,4,291,322,23
UCMA,25,2,295,322,23
VWA3A,35,12,275,322,23
MAF,26,3,293,322,23
TMPRSS13,23,0,299,322,23
C15orf62,26,3,293,322,23
TAS2R10,38,15,269,322,23
SLPI,30,7,285,322,23
NUDC,25,2,295,322,23
BNIPL,24,1,297,322,23
EOMES,25,2,295,322,23
RSPH14,39,16,267,322,23
SNAP23,26,3,293,322,23
HBZ,37,14,271,322,23
GPRC5B,27,4,291,322,23
RGPD5,36,13,273,322,23
OSR2,24,1,297,322,23
LGALS7B,35,12,275,322,23
IGLC1,47,24,251,322,23
SCG5,26,3,293,322,23
ZNF436,26,3,293,322,23
YPEL2,24,2,296,322,22
CYP2D6,30,8,284,322,22
CHST11,23,1,298,322,22
FGF8,35,13,274,322,22
KIF4B,22,0,300,322,22
CBSL,41,19,262,322,22
ZFP2,26,4,292,322,22
NPW,49,27,246,322,22
DNAH10,23,1,298,322,22
FUT3,28,6,288,322,22
SPOCK1,23,1,298,322,22
TAS2R7,27,5,290,322,22
B4GALNT3,26,4,292,322,22
IQUB,23,1,298,322,22
TAS2R60,22,0,300,322,22
DGKE,23,1,298,322,22
CLEC10A,22,0,300,322,22
RBM24,28,6,288,322,22
CYP27A1,27,5,290,322,22
HIPK4,23,1,298,322,22
KRTDAP,40,18,264,322,22
NKAPL,24,2,296,322,22
OPRD1,22,0,300,322,22
F2,24,2,296,322,22
TSPOAP1,24,2,296,322,22
COL6A2,24,2,296,322,22
ACTN3,26,4,292,322,22
CT45A9,36,14,272,322,22
C5AR1,27,5,290,322,22
DQX1,23,1,298,322,22
FAM71A,28,6,288,322,22
VMO1,38,16,268,322,22
HHATL,29,7,286,322,22
FAM183A,50,28,244,322,22
ELOA3CP,30,8,284,322,22
CLEC18C,41,19,262,322,22
CST6,32,10,280,322,22
H2AC19,34,12,276,322,22
C8orf89,45,23,254,322,22
CIART,32,10,280,322,22
GCNT4,23,1,298,322,22
GNA15,26,4,292,322,22
ARPC4-TTLL3,30,8,284,322,22
ADAP1,26,4,292,322,22
LHX4,23,1,298,322,22
WFIKKN2,23,1,298,322,22
FRG2,30,8,284,322,22
HVCN1,33,12,277,322,21
OR4F16,35,14,273,322,21
MST1R,26,5,291,322,21
RSPH6A,24,3,295,322,21
NLGN3,22,1,299,322,21
AMDHD1,25,4,293,322,21
GKAP1,21,0,301,322,21
IL13,28,7,287,322,21
CFAP94,28,7,287,322,21
PRX,28,7,287,322,21
SEMA4G,28,7,287,322,21
F13B,26,5,291,322,21
CDO1,23,2,297,322,21
ATRNL1,23,2,297,322,21
BANP,21,0,301,322,21
RAP1GAP,24,3,295,322,21
C2orf42,22,1,299,322,21
HSPB6,26,5,291,322,21
CSRNP1,25,4,293,322,21
GJC2,28,7,287,322,21
HOXC9,24,3,295,322,21
STMN4,23,2,297,322,21
FILIP1L,23,2,297,322,21
DBN1,24,3,295,322,21
PRKCH,30,9,283,322,21
CATSPER3,27,6,289,322,21
CP,24,3,295,322,21
ARMH2,29,8,285,322,21
GGT1,26,5,291,322,21
HOXA4,21,0,301,322,21
PRH1,45,24,253,322,21
ALDOC,25,4,293,322,21
TEKT2,23,2,297,322,21
TMCO2,30,9,283,322,21
TBC1D26,36,15,271,322,21
CASP1,32,11,279,322,21
RASGRP1,26,5,291,322,21
CGB8,33,12,277,322,21
CCDC166,23,2,297,322,21
GH1,26,5,291,322,21
ZNF473,23,2,297,322,21
CREB3L4,23,2,297,322,21
UBTFL1,26,5,291,322,21
TBC1D3I,53,32,237,322,21
FOXL3,22,1,299,322,21
SCYGR7,23,2,297,322,21
EGR4,25,4,293,322,21
SPEF1,24,3,295,322,21
CPLX3,24,3,295,322,21
IL5RA,24,3,295,322,21
GBP5,21,0,301,322,21
CLIC2,28,7,287,322,21
NMRK2,27,6,289,322,21
GGT5,31,10,281,322,21
HK3,37,16,269,322,21
KLKB1,24,3,295,322,21
NUDT4B,52,31,239,322,21
MMP25,27,6,289,322,21
DYNLRB2,42,21,259,322,21
ASPRV1,24,4,294,322,20
LDHC,27,7,288,322,20
SPACA4,27,7,288,322,20
H2AB1,48,28,246,322,20
WSCD1,22,2,298,322,20
DPP4,21,1,300,322,20
PTPRN,29,9,284,322,20
CGA,32,12,278,322,20
SEC31B,21,1,300,322,20
ST13,24,4,294,322,20
DLL1,20,0,302,322,20
MACROH2A2,38,18,266,322,20
QRICH2,20,0,302,322,20
PWWP3A,24,4,294,322,20
PLGLB1,27,7,288,322,20
EFNB2,20,0,302,322,20
KANSL1L,20,0,302,322,20
NCALD,33,13,276,322,20
RPE65,27,7,288,322,20
CPT1C,36,16,270,322,20
TMEM81,24,4,294,322,20
NSUN6,23,3,296,322,20
ARMH1,37,17,268,322,20
GYS2,22,2,298,322,20
ASNS,22,2,298,322,20
ALK,24,4,294,322,20
SENP3-EIF4A1,21,1,300,322,20
SLC23A3,25,5,292,322,20
OR5B21,21,1,300,322,20
TMIGD2,27,7,288,322,20
RBP7,26,6,290,322,20
HHIPL2,21,1,300,322,20
CPA2,21,1,300,322,20
MAP3K8,24,4,294,322,20
KDM5A,21,1,300,322,20
OOSP4A,29,9,284,322,20
AGBL2,31,11,280,322,20
NOCT,26,6,290,322,20
GOLGA6L1,27,7,288,322,20
RASSF9,23,3,296,322,20
FHL1,26,6,290,322,20
HSP90AB1,21,1,300,322,20
RFPL1,20,0,302,322,20
PAGE2,38,18,266,322,20
FCGR1B,23,3,296,322,20
CILP2,24,4,294,322,20
CXCL11,22,2,298,322,20
KLF2,31,11,280,322,20
CAPN11,27,7,288,322,20
KLK5,22,2,298,322,20
FITM1,25,5,292,322,20
PLCG2,21,1,300,322,20
KRTAP19-5,32,12,278,322,20
AKR7A3,31,11,280,322,20
LRRN4CL,21,1,300,322,20
BCL6,26,6,290,322,20
UNC13D,27,7,288,322,20
EVPL,35,15,272,322,20
RPA4,28,8,286,322,20
IL4,36,16,270,322,20
ERO1B,24,4,294,322,20
FAM214A,24,4,294,322,20
SOBP,22,2,298,322,20
HES5,25,5,292,322,20
HTN3,25,5,292,322,20
GPR83,20,0,302,322,20
KDM2A,23,3,296,322,20
SH3BGR,38,18,266,322,20
RAB4B,24,4,294,322,20
GIPC2,20,0,302,322,20
BCL2A1,33,13,276,322,20
KHDC1L,38,18,266,322,20
TAGLN3,30,10,282,322,20
DRC7,27,7,288,322,20
KHDC4,21,1,300,322,20
SCYGR4,21,1,300,322,20
STX11,19,0,303,322,19
DLL3,26,7,289,322,19
HSD17B1,24,5,293,322,19
LYVE1,23,4,295,322,19
GPR25,21,2,299,322,19
DNAAF1,43,24,255,322,19
NACA2,23,4,295,322,19
RPS10-NUDT3,19,0,303,322,19
CFAP43,21,2,299,322,19
LST1,50,31,241,322,19
CKMT2,26,7,289,322,19
LY6G6F-LY6G6D,23,4,295,322,19
LRRC66,20,1,301,322,19
XCL2,26,7,289,322,19
SYN1,27,8,287,322,19
C9orf131,43,24,255,322,19
CHRNA10,23,4,295,322,19
SECISBP2,20,1,301,322,19
TMEM190,37,18,267,322,19
CD4,27,8,287,322,19
AANAT,31,12,279,322,19
KCNJ18,20,1,301,322,19
SOCS2,21,2,299,322,19
PREX1,27,8,287,322,19
JUNB,25,6,291,322,19
C16orf46,37,18,267,322,19
TUBB4A,28,9,285,322,19
MMP13,22,3,297,322,19
ANG,29,10,283,322,19
APOA1,27,8,287,322,19
ZFPL1,25,6,291,322,19
ADHFE1,27,8,287,322,19
TRIM74,32,13,277,322,19
CLK4,23,4,295,322,19
EPPK1,19,0,303,322,19
KLK14,22,3,297,322,19
PRDM6,22,3,297,322,19
P4HA2,20,1,301,322,19
KLF4,21,2,299,322,19
SOX8,20,1,301,322,19
TRAV5,23,4,295,322,19
IER5L,23,4,295,322,19
KIAA0895,21,2,299,322,19
NPIPB8,48,29,245,322,19
KIF27,19,0,303,322,19
ZSCAN10,26,7,289,322,19
P2RX5,23,4,295,322,19
PSORS1C2,30,11,281,322,19
CDKN2B,25,6,291,322,19
OVCH1,24,5,293,322,19
CATSPERB,38,19,265,322,19
OR2AE1,28,9,285,322,19
UBAP1L,27,8,287,322,19
USP17L7,23,4,295,322,19
CARD11,21,2,299,322,19
SMCO2,24,5,293,322,19
PDIA2,27,8,287,322,19
UQCRHL,19,0,303,322,19
OLFM1,25,6,291,322,19
EFNB3,20,1,301,322,19
RND2,20,1,301,322,19
DCDC2B,24,5,293,322,19
SPANXN5,27,8,287,322,19
HLA-DMB,25,6,291,322,19
CST1,25,6,291,322,19
IGKV2-40,22,3,297,322,19
OSCP1,27,8,287,322,19
RFX3,24,5,293,322,19
FBN2,19,1,302,322,18
OTP,18,0,304,322,18
PPP2CB,21,3,298,322,18
IGHG1,19,1,302,322,18
RND3,23,5,294,322,18
DHRS3,23,5,294,322,18
EIF4EBP3,41,23,258,322,18
ITIH3,19,1,302,322,18
FGF11,22,4,296,322,18
BNIP5,18,0,304,322,18
PLCD1,19,1,302,322,18
CDC42EP2,30,12,280,322,18
BOLL,21,3,298,322,18
MAP6,18,0,304,322,18
ZFYVE21,18,0,304,322,18
SYNE1,19,1,302,322,18
UBA7,22,4,296,322,18
IL20,21,3,298,322,18
RSRP1,21,3,298,322,18
SYCE2,24,6,292,322,18
GRIA3,20,2,300,322,18
EN2,18,0,304,322,18
RAB44,18,0,304,322,18
INPP5J,26,8,288,322,18
SLC22A14,21,3,298,322,18
SOHLH1,21,3,298,322,18
RAPSN,26,8,288,322,18
DCST2,24,6,292,322,18
TUBB3,21,3,298,322,18
RAB30,21,3,298,322,18
PRR35,19,1,302,322,18
RETN,23,5,294,322,18
THAP9,24,6,292,322,18
VWA5B2,18,0,304,322,18
RAB17,29,11,282,322,18
MADCAM1,20,2,300,322,18
SMAD1,22,4,296,322,18
ARHGDIG,22,4,296,322,18
BHLHA9,20,2,300,322,18
MCL1,19,1,302,322,18
KLHL26,21,3,298,322,18
PTGS2,27,9,286,322,18
NECAB2,25,7,290,322,18
NNAT,34,16,272,322,18
PURG,23,5,294,322,18
CNIH2,29,11,282,322,18
MTRNR2L1,21,3,298,322,18
TMEM217,30,12,280,322,18
FZD1,19,1,302,322,18
APOC2,25,7,290,322,18
RHEBL1,24,6,292,322,18
ERICH4,22,4,296,322,18
LAMA5,23,5,294,322,18
TNNI2,22,4,296,322,18
C1S,18,0,304,322,18
ADH1B,19,1,302,322,18
MSX1,21,3,298,322,18
PPP1R18,19,1,302,322,18
STON1-GTF2A1L,19,1,302,322,18
CCDC62,19,1,302,322,18
NEXN,21,3,298,322,18
CCN1,25,7,290,322,18
PCSK1N,23,5,294,322,18
PARVG,29,11,282,322,18
LPAR5,23,5,294,322,18
ANKRD60,19,1,302,322,18
CDH16,19,1,302,322,18
LY96,40,22,260,322,18
PGAM2,36,18,268,322,18
PTTG2,26,8,288,322,18
FOXA3,22,4,296,322,18
CCDC28B,25,7,290,322,18
CRABP2,25,7,290,322,18
MEF2B,35,17,270,322,18
SGK1,21,3,298,322,18
SMAD7,19,1,302,322,18
RAET1L,19,1,302,322,18
LLGL2,25,7,290,322,18
SPINDOC,22,4,296,322,18
TAS2R8,22,4,296,322,18
ESPNL,29,11,282,322,18
TMEM47,20,2,300,322,18
TBPL2,26,9,287,322,17
MFSD2B,23,6,293,322,17
PRKD1,20,3,299,322,17
MTMR11,17,0,305,322,17
TEX12,39,22,261,322,17
MSI1,20,3,299,322,17
TCEAL7,21,4,297,322,17
GFM2,19,2,301,322,17
MTRNR2L3,31,14,277,322,17
DACT1,19,2,301,322,17
CCDC198,23,6,293,322,17
ZBP1,24,7,291,322,17
FAM25C,37,20,265,322,17
MTRNR2L4,20,3,299,322,17
ZNF512,17,0,305,322,17
HOXC10,19,2,301,322,17
THOC6,23,6,293,322,17
IZUMO1,25,8,289,322,17
CD164L2,22,5,295,322,17
PYY,27,10,285,322,17
SPANXN3,28,11,283,322,17
PERM1,19,2,301,322,17
CCL25,23,6,293,322,17
FRZB,17,0,305,322,17
CD160,22,5,295,322,17
PLOD1,19,2,301,322,17
FAM149A,29,12,281,322,17
TRIM64,17,0,305,322,17
TRIM40,17,0,305,322,17
CRELD1,21,4,297,322,17
AOC2,19,2,301,322,17
TRIM16,19,2,301,322,17
TRBV7-3,41,24,257,322,17
CRIP3,28,11,283,322,17
PRR20G,19,2,301,322,17
PPIAL4H,43,26,253,322,17
FXR1,20,3,299,322,17
CRYBA2,29,12,281,322,17
KLRG1,20,3,299,322,17
SERPINF2,19,2,301,322,17
SERPINF1,22,5,295,322,17
CPEB2,19,2,301,322,17
ITGB7,23,6,293,322,17
TP63,29,12,281,322,17
RUNX1T1,22,5,295,322,17
SLFNL1,26,9,287,322,17
SLN,35,18,269,322,17
PDE1C,21,4,297,322,17
HLA-G,23,6,293,322,17
PARD6B,17,0,305,322,17
PAPOLA,18,1,303,322,17
HLA-B,20,3,299,322,17
IER2,25,8,289,322,17
OXTR,19,2,301,322,17
POLG2,20,3,299,322,17
FAAH,21,4,297,322,17
SNORC,44,27,251,322,17
EPB42,22,5,295,322,17
OSBPL3,21,4,297,322,17
UBE2H,18,1,303,322,17
RABL2A,20,3,299,322,17
UBE2B,19,2,301,322,17
INPP5K,19,2,301,322,17
INSL5,23,6,293,322,17
SLC4A5,22,5,295,322,17
PDLIM5,18,1,303,322,17
RAB31,21,4,297,322,17
RAB25,30,13,279,322,17
CRYBB3,25,8,289,322,17
SPR,20,3,299,322,17
TMEM79,20,3,299,322,17
NAT8,20,3,299,322,17
LIX1,18,1,303,322,17
PLEKHB1,22,5,295,322,17
SLC25A17,21,4,297,322,17
H2BC17,26,9,287,322,17
BAZ2A,18,1,303,322,17
CTRB1,25,8,289,322,17
LMTK3,23,6,293,322,17
XG,21,4,297,322,17
C8orf88,21,4,297,322,17
ZNF557,18,1,303,322,17
CEACAM16,20,3,299,322,17
DNAH12,22,5,295,322,17
GHRL,49,32,241,322,17
CUZD1,59,42,221,322,17
LRRC73,26,9,287,322,17
STRC,17,0,305,322,17
GIMD1,19,2,301,322,17
LRRIQ4,18,1,303,322,17
RIPPLY1,24,7,291,322,17
NAALADL1,38,21,263,322,17
GTSF1L,20,3,299,322,17
AQP1,18,1,303,322,17
MAP1LC3B2,33,16,273,322,17
CCDC154,23,6,293,322,17
APOH,28,11,283,322,17
SCTR,26,9,287,322,17
TLE1,21,4,297,322,17
SERPINE1,25,8,289,322,17
LEFTY2,19,2,301,322,17
TLE4,18,1,303,322,17
FAM166A,35,18,269,322,17
AQP10,19,2,301,322,17
RNF216,17,1,304,322,16
ZNF737,19,3,300,322,16
AXDND1,33,17,272,322,16
OLFML3,17,1,304,322,16
SLC5A5,19,3,300,322,16
PLSCR2,19,3,300,322,16
SNX3,19,3,300,322,16
SULT1A4,52,36,234,322,16
C1orf52,17,1,304,322,16
ZNF852,18,2,302,322,16
SIL1,19,3,300,322,16
PDE6D,19,3,300,322,16
SLC19A3,22,6,294,322,16
C9,17,1,304,322,16
ABCB1,18,2,302,322,16
C12orf73,16,0,306,322,16
PNPLA7,17,1,304,322,16
C18orf25,17,1,304,322,16
SLC13A3,25,9,288,322,16
FRS2,16,0,306,322,16
NXNL1,16,0,306,322,16
CRYGS,30,14,278,322,16
SLC2A14,28,12,282,322,16
CLEC1A,34,18,270,322,16
FXYD2,28,12,282,322,16
ST3GAL6,20,4,298,322,16
NOTCH3,26,10,286,322,16
GALR2,21,5,296,322,16
NPAS4,23,7,292,322,16
C7orf50,21,5,296,322,16
CFAP65,19,3,300,322,16
MSTN,17,1,304,322,16
NEDD8-MDP1,62,46,214,322,16
CREB5,18,2,302,322,16
AADACL3,16,0,306,322,16
STAP2,22,6,294,322,16
NR0B2,19,3,300,322,16
DAGLB,18,2,302,322,16
MRPS6,18,2,302,322,16
SERHL2,25,9,288,322,16
SPDYE2,34,18,270,322,16
CGB5,30,14,278,322,16
SLC2A5,21,5,296,322,16
NUDT9,19,3,300,322,16
NUTM2B,28,12,282,322,16
SIK1B,28,12,282,322,16
NLRP7,18,2,302,322,16
CALB1,20,4,298,322,16
EFNB1,19,3,300,322,16
AS3MT,27,11,284,322,16
KRT13,19,3,300,322,16
TPP1,16,0,306,322,16
HHLA2,23,7,292,322,16
THAP2,20,4,298,322,16
CCL2,39,23,260,322,16
ACER2,17,1,304,322,16
TRIM43,23,7,292,322,16
MARCHF5,16,0,306,322,16
VGF,26,10,286,322,16
FAM71E1,25,9,288,322,16
GUCA1ANB,23,7,292,322,16
GNB1L,19,3,300,322,16
GTF3C3,17,1,304,322,16
MC5R,18,2,302,322,16
CAPZA2,22,6,294,322,16
ANKRD34B,19,3,300,322,16
ACSBG2,24,8,290,322,16
AEBP1,23,7,292,322,16
ADSS1,24,8,290,322,16
INSL4,17,1,304,322,16
DSCAML1,19,3,300,322,16
SCGB2A1,24,8,290,322,16
WDR47,19,3,300,322,16
GIPC1,22,6,294,322,16
GIPC3,16,0,306,322,16
ZNF343,18,2,302,322,16
LTB,25,9,288,322,16
ARHGEF15,24,8,290,322,16
H2AC16,40,24,258,322,16
HAMP,33,17,272,322,16
ARMC12,24,8,290,322,16
ZDBF2,18,2,302,322,16
GPT,19,3,300,322,16
AR,17,1,304,322,16
TLR4,16,0,306,322,16
FCN3,19,3,300,322,16
DRAXIN,18,2,302,322,16
H2AC12,41,25,256,322,16
CDC42EP4,22,6,294,322,16
YIPF1,17,1,304,322,16
INSL3,32,16,274,322,16
CACNA1H,18,2,302,322,16
AMIGO3,50,34,238,322,16
FAM90A14P,19,3,300,322,16
CACNA1F,25,9,288,322,16
IL24,23,7,292,322,16
PRICKLE2,16,0,306,322,16
IL1R2,19,3,300,322,16
ALOX5AP,26,10,286,322,16
MKRN2OS,30,14,278,322,16
IGLV1-40,24,8,290,322,16
EPHA4,23,7,292,322,16
EPHX1,18,2,302,322,16
EPM2AIP1,17,1,304,322,16
AK5,20,4,298,322,16
FAP,24,8,290,322,16
ALDH3A1,17,1,304,322,16
CASP4,24,8,290,322,16
ALPK3,16,0,306,322,16
HSFX1,31,15,276,322,16
EVA1A,17,2,303,322,15
DPPA2,19,4,299,322,15
HAUS4,21,6,295,322,15
TMEM88,34,19,269,322,15
LGALS1,24,9,289,322,15
CD163,20,5,297,322,15
NEK10,17,2,303,322,15
C16orf92,24,9,289,322,15
LEFTY1,19,4,299,322,15
PCDHGA1,15,0,307,322,15
LDHAL6A,16,1,305,322,15
ACTBL2,15,0,307,322,15
ANKRD10,17,2,303,322,15
SLURP1,19,4,299,322,15
CBX4,18,3,301,322,15
LCAT,20,5,297,322,15
OR9A4,17,2,303,322,15
FOXO1,15,0,307,322,15
TNIP1,16,1,305,322,15
HCN2,19,4,299,322,15
PELI2,18,3,301,322,15
TMEM59L,23,8,291,322,15
HSD17B6,18,3,301,322,15
SLC39A4,21,6,295,322,15
DNAJC7,17,2,303,322,15
RSBN1,15,0,307,322,15
POU4F3,16,1,305,322,15
HTR3C,15,0,307,322,15
NAPSA,23,8,291,322,15
TMEM202,17,2,303,322,15
ZFP3,16,1,305,322,15
NBPF14,18,3,301,322,15
OTULIN,16,1,305,322,15
FAM83A,17,2,303,322,15
SCG2,24,9,289,322,15
SIX2,17,2,303,322,15
NCAN,16,1,305,322,15
IRGM,18,3,301,322,15
TTC9B,27,12,283,322,15
CALY,18,3,301,322,15
SIAH2,16,1,305,322,15
IST1,18,3,301,322,15
ADM5,18,3,301,322,15
LMAN2L,18,3,301,322,15
PLOD3,19,4,299,322,15
IGLV1-44,17,2,303,322,15
SRSF9,18,3,301,322,15
NRXN2,16,1,305,322,15
PCNP,18,3,301,322,15
RASL12,17,2,303,322,15
KIF1A,27,12,283,322,15
PYGM,17,2,303,322,15
TSPAN12,20,5,297,322,15
AMFR,15,0,307,322,15
FRMD1,19,4,299,322,15
RASL11B,20,5,297,322,15
ENO3,16,1,305,322,15
RAPGEF3,19,4,299,322,15
SPHK2,18,3,301,322,15
TRAV36DV7,23,8,291,322,15
SPEN,16,1,305,322,15
RNF151,31,16,275,322,15
CRAMP1,24,9,289,322,15
TXK,23,8,291,322,15
INA,17,2,303,322,15
TRMT10A,17,2,303,322,15
C11orf95,19,4,299,322,15
TRO,20,5,297,322,15
GPR35,15,0,307,322,15
PMAIP1,17,2,303,322,15
SAP25,20,5,297,322,15
SLC3A2,17,2,303,322,15
OOSP1,20,5,297,322,15
JAM3,18,3,301,322,15
HEATR4,28,13,281,322,15
KRTCAP3,29,14,279,322,15
HEPN1,15,0,307,322,15
KRTAP5-1,17,2,303,322,15
CDKL2,20,5,297,322,15
CHRNA4,17,2,303,322,15
IQCF5,18,3,301,322,15
FAM90A1,18,3,301,322,15
FOXR1,21,6,295,322,15
SPRED3,20,5,297,322,15
BEND4,20,5,297,322,15
HES3,17,2,303,322,15
AMY2B,21,6,295,322,15
SPX,25,10,287,322,15
PDILT,29,14,279,322,15
SERTAD1,19,4,299,322,15
KLK13,23,8,291,322,15
GMCL2,16,1,305,322,15
RHBDL1,25,10,287,322,15
ADGRV1,19,4,299,322,15
SLC39A5,20,5,297,322,15
FAM162B,17,2,303,322,15
PPP1R36,28,13,281,322,15
FAM180B,22,7,293,322,15
MINPP1,15,0,307,322,15
GGTA1,19,4,299,322,15
CIB2,22,7,293,322,15
TCF7L1,15,0,307,322,15
XKR8,19,4,299,322,15
MFNG,26,11,285,322,15
PLA2G4C,19,4,299,322,15
MYL7,29,14,279,322,15
SCUBE1,18,3,301,322,15
MSANTD1,16,1,305,322,15
CCDC106,19,4,299,322,15
H1-1,34,19,269,322,15
TMEFF1,34,19,269,322,15
CFAP221,17,2,303,322,15
AZGP1,20,5,297,322,15
SYBU,20,5,297,322,15
DHX58,24,9,289,322,15
GDF7,21,6,295,322,15
MUC2,15,0,307,322,15
GRAMD2A,23,8,291,322,15
ADAMTS9,19,4,299,322,15
MT1E,32,17,273,322,15
AURKC,23,8,291,322,15
SYTL1,23,8,291,322,15
ZNF425,18,3,301,322,15
B4GALNT4,22,7,293,322,15
PRKCG,20,5,297,322,15
SCYGR5,19,4,299,322,15
PPP4C,16,1,305,322,15
CWF19L2,16,1,305,322,15
BACH1,20,5,297,322,15
MMP15,27,12,283,322,15
GRIA2,24,9,289,322,15
FGF6,21,6,295,322,15
RPH3A,34,19,269,322,15
LVRN,16,1,305,322,15
DMTN,20,5,297,322,15
AHNAK,16,2,304,322,14
TSGA10IP,25,11,286,322,14
PLXDC1,18,4,300,322,14
HS3ST3A1,20,6,296,322,14
TSGA10,16,2,304,322,14
ETV7,16,2,304,322,14
MCIDAS,15,1,306,322,14
UCN,29,15,278,322,14
NTN5,20,6,296,322,14
UNC45B,14,0,308,322,14
YPEL3,16,2,304,322,14
NSG2,17,3,302,322,14
P2RX6,19,5,298,322,14
GNGT2,22,8,292,322,14
ZNF836,25,11,286,322,14
EIF2B5,15,1,306,322,14
DAAM1,14,0,308,322,14
FAM221B,27,13,282,322,14
ERBB3,18,4,300,322,14
IZUMO1R,18,4,300,322,14
IVNS1ABP,15,1,306,322,14
TSEN34,16,2,304,322,14
C20orf141,26,12,284,322,14
SLFN12,15,1,306,322,14
MBD3L3,14,0,308,322,14
RPS4Y1,15,1,306,322,14
POGZ,14,0,308,322,14
H4C11,48,34,240,322,14
SALL3,14,0,308,322,14
TRIM64B,16,2,304,322,14
MBD3L2B,17,3,302,322,14
CREB1,14,0,308,322,14
TRIM64C,15,1,306,322,14
C5orf49,16,2,304,322,14
CFAP206,32,18,272,322,14
CYP3A4,16,2,304,322,14
AGR3,22,8,292,322,14
PDCD1,21,7,294,322,14
ASIC3,21,7,294,322,14
SDCBP2,17,3,302,322,14
ANO1,19,5,298,322,14
SECTM1,20,6,296,322,14
ZNF10,16,2,304,322,14
PVRIG,30,16,276,322,14
PITPNC1,15,1,306,322,14
S100Z,21,7,294,322,14
BTLA,21,7,294,322,14
ZNF705A,27,13,282,322,14
YWHAG,15,1,306,322,14
UCHL1,20,6,296,322,14
PRCP,14,0,308,322,14
SLX1B,26,12,284,322,14
GOLGA6L6,23,9,290,322,14
CAB39,14,0,308,322,14
CA2,21,7,294,322,14
GPR137C,14,0,308,322,14
ZNF487,33,19,270,322,14
IGF2,15,1,306,322,14
SLC10A5,25,11,286,322,14
ABAT,20,6,296,322,14
USP44,19,5,298,322,14
IL1RL1,16,2,304,322,14
REP15,21,7,294,322,14
COPS6,17,3,302,322,14
SKIV2L,22,8,292,322,14
RXFP4,16,2,304,322,14
ACTR3C,17,3,302,322,14
CCDC187,16,2,304,322,14
C1QTNF12,24,10,288,322,14
SKIL,14,0,308,322,14
FAM43A,19,5,298,322,14
C1QTNF3-AMACR,38,24,260,322,14
MLC1,15,1,306,322,14
PRDM1,21,7,294,322,14
CHCHD6,18,4,300,322,14
UBFD1,15,1,306,322,14
IGKV1-27,46,32,244,322,14
ACSM1,17,3,302,322,14
CHD7,20,6,296,322,14
ZSWIM8,14,0,308,322,14
GCHFR,21,7,294,322,14
TERB2,18,4,300,322,14
MMP14,20,6,296,322,14
UBXN8,16,2,304,322,14
IFI27L2,24,10,288,322,14
MED30,17,3,302,322,14
SOX6,15,1,306,322,14
ISM2,20,6,296,322,14
ANKH,17,3,302,322,14
TENT4A,15,1,306,322,14
GSTT4,16,2,304,322,14
IRF5,19,5,298,322,14
COX6A2,22,8,292,322,14
GCKR,26,12,284,322,14
PCNX3,14,0,308,322,14
ELOVL5,17,3,302,322,14
PDE4DIP,14,0,308,322,14
ABHD17B,15,1,306,322,14
PLXNC1,18,4,300,322,14
CATSPERZ,27,13,282,322,14
HTR2B,25,11,286,322,14
POU3F2,14,0,308,322,14
MS4A4E,15,1,306,322,14
TDRD6,18,4,300,322,14
BTBD2,17,3,302,322,14
ANXA1,19,5,298,322,14
SLC6A8,24,10,288,322,14
DLX5,18,4,300,322,14
HBM,18,4,300,322,14
XKR3,14,0,308,322,14
CDKN2AIP,14,0,308,322,14
GLDC,26,12,284,322,14
SSUH2,15,1,306,322,14
CFAP69,24,10,288,322,14
TNFAIP1,17,3,302,322,14
PRR36,14,0,308,322,14
APTX,15,1,306,322,14
MANBA,15,1,306,322,14
CFAP70,19,5,298,322,14
WAS,19,5,298,322,14
TIAM2,17,3,302,322,14
TRIM22,17,3,302,322,14
PEG10,14,0,308,322,14
PPM1N,18,4,300,322,14
CYP11A1,20,6,296,322,14
RNF10,17,3,302,322,14
CDKL3,21,7,294,322,14
FBXO32,17,3,302,322,14
CD163L1,23,9,290,322,14
TOB2,16,2,304,322,14
MUC5AC,15,1,306,322,14
ZNF646,15,1,306,322,14
MAP1LC3C,19,5,298,322,14
TM7SF2,15,1,306,322,14
TMPRSS6,18,4,300,322,14
SRP14,16,2,304,322,14
LYPD1,18,4,300,322,14
TMEM198,18,4,300,322,14
ZNF324B,15,1,306,322,14
AADAC,15,1,306,322,14
CCSER1,17,3,302,322,14
TMEM132A,15,1,306,322,14
BAALC,24,10,288,322,14
ARHGEF16,19,5,298,322,14
LPAR6,16,2,304,322,14
TMEM232,24,10,288,322,14
SCARA3,15,1,306,322,14
FAM151B,24,10,288,322,14
NCSTN,17,3,302,322,14
SEPTIN4,21,7,294,322,14
FCGR2C,22,8,292,322,14
HAL,21,7,294,322,14
SLC35B2,15,1,306,322,14
NDUFA4L2,26,12,284,322,14
DOCK10,17,3,302,322,14
SIK1,40,26,256,322,14
STARD3,15,1,306,322,14
LGMN,16,2,304,322,14
SULT1A2,16,2,304,322,14
TMEM92,17,3,302,322,14
RILPL1,14,0,308,322,14
PLPP3,15,1,306,322,14
CRYM,23,9,290,322,14
NFKBIZ,21,7,294,322,14
SRMS,16,2,304,322,14
MTTP,19,5,298,322,14
ECH1,18,4,300,322,14
HIGD1C,30,16,276,322,14
CAP2,14,0,308,322,14
HIGD2B,17,3,302,322,14
F11,17,3,302,322,14
CRLF2,15,1,306,322,14
ZNF862,20,6,296,322,14
APC2,20,6,296,322,14
TPRX1,18,4,300,322,14
RPS27AP5,62,48,212,322,14
PPIAL4E,55,41,226,322,14
PPID,16,2,304,322,14
TPSB2,20,6,296,322,14
AVIL,16,2,304,322,14
SLC5A11,18,4,300,322,14
ASB5,20,6,296,322,14
BEST3,17,3,302,322,14
KLC4,21,7,294,322,14
ZNF423,14,0,308,322,14
PTGER2,18,4,300,322,14
CHST7,16,2,304,322,14
MTRNR2L8,18,4,300,322,14
NMB,22,8,292,322,14
KRT12,17,3,302,322,14
FKBP1B,22,8,292,322,14
NODAL,20,6,296,322,14
RNF224,18,4,300,322,14
CFAP20DC,16,2,304,322,14
MTRNR2L6,18,4,300,322,14
HIGD1B,30,16,276,322,14
PHF2,13,0,309,322,13
WNK4,26,13,283,322,13
GPR82,15,2,305,322,13
USP34,15,2,305,322,13
RBAK,14,1,307,322,13
FAM13A,17,4,301,322,13
FOXA1,18,5,299,322,13
CNTFR,15,2,305,322,13
GPR17,16,3,303,322,13
HTR3E,13,0,309,322,13
ADGRG6,19,6,297,322,13
FAM161A,14,1,307,322,13
SIDT2,14,1,307,322,13
AKT1,14,1,307,322,13
PAK3,16,3,303,322,13
SLC26A11,20,7,295,322,13
PLCZ1,21,8,293,322,13
WNK1,18,5,299,322,13
AGPAT1,15,2,305,322,13
H2BE1,44,31,247,322,13
PGM1,13,0,309,322,13
ADAM30,13,0,309,322,13
HOPX,19,6,297,322,13
C1orf162,28,15,279,322,13
SLC35D3,16,3,303,322,13
PCDHGC4,17,4,301,322,13
FNBP1,15,2,305,322,13
CLRN3,18,5,299,322,13
GPX3,24,11,287,322,13
PADI4,21,8,293,322,13
SLC23A1,24,11,287,322,13
SLC1A2,17,4,301,322,13
PCP4L1,17,4,301,322,13
ZSCAN18,23,10,289,322,13
HEXIM1,14,1,307,322,13
PKD2L1,24,11,287,322,13
GPR173,19,6,297,322,13
HSD17B7,18,5,299,322,13
AIF1,30,17,275,322,13
CMTM2,27,14,281,322,13
SHC4,15,2,305,322,13
YTHDC1,16,3,303,322,13
PLD3,16,3,303,322,13
PDZD4,17,4,301,322,13
GYS1,16,3,303,322,13
FAM184A,25,12,285,322,13
SIPA1L1,13,0,309,322,13
XPNPEP3,18,5,299,322,13
SLC22A13,15,2,305,322,13
RASGRP2,33,20,269,322,13
C19orf84,18,5,299,322,13
AFF1,14,1,307,322,13
FAM71D,27,14,281,322,13
FAM181B,13,0,309,322,13
HOXC13,15,2,305,322,13
ADPRHL1,15,2,305,322,13
CKB,24,11,287,322,13
FNDC7,15,2,305,322,13
GRM2,31,18,273,322,13
PIP4K2B,14,1,307,322,13
HSP90B1,18,5,299,322,13
CIDEC,16,3,303,322,13
GSDMB,15,2,305,322,13
ID1,34,21,267,322,13
SIX4,15,2,305,322,13
UGGT1,14,1,307,322,13
ARID3C,16,3,303,322,13
TMEM249,45,32,245,322,13
CTNS,13,0,309,322,13
DNAJC5G,32,19,271,322,13
DNAJC4,18,5,299,322,13
LRP4,13,0,309,322,13
PSG9,15,2,305,322,13
BAHD1,13,0,309,322,13
PSAP,14,1,307,322,13
TMEM156,15,2,305,322,13
CEL,16,3,303,322,13
NANOS3,36,23,263,322,13
NANOGP8,20,7,295,322,13
CWH43,14,1,307,322,13
CALHM6,28,15,279,322,13
TMEM145,19,6,297,322,13
LRWD1,17,4,301,322,13
TMEM101,14,1,307,322,13
TMEFF2,14,1,307,322,13
TMEM25,15,2,305,322,13
LMNTD2,22,9,291,322,13
TMEM266,15,2,305,322,13
STC2,22,9,291,322,13
NKAIN1,20,7,295,322,13
KYAT1,20,7,295,322,13
APOC4,34,21,267,322,13
LAMTOR4,14,1,307,322,13
SAT1,16,3,303,322,13
NFIL3,17,4,301,322,13
TNNC1,20,7,295,322,13
NFIB,13,0,309,322,13
NFATC3,14,1,307,322,13
SGSM3,18,5,299,322,13
CCIN,24,11,287,322,13
TMSB4X,15,2,305,322,13
DPM2,15,2,305,322,13
CCHCR1,13,0,309,322,13
NEIL1,20,7,295,322,13
TMPPE,15,2,305,322,13
RPL17-C18orf32,22,9,291,322,13
MYOM2,13,0,309,322,13
LYL1,21,8,293,322,13
CDK5R1,13,0,309,322,13
GALR3,22,9,291,322,13
ASPG,16,3,303,322,13
CYTIP,17,4,301,322,13
TEX45,23,10,289,322,13
TEX14,16,3,303,322,13
MED12,14,1,307,322,13
MSGN1,13,0,309,322,13
TEN1-CDK3,31,18,273,322,13
MSANTD4,15,2,305,322,13
ABRA,16,3,303,322,13
MYMK,14,1,307,322,13
ATP6V0D2,19,6,297,322,13
MRPS14,15,2,305,322,13
GBA3,15,2,305,322,13
DDX47,17,4,301,322,13
MRI1,14,1,307,322,13
MICOS13,15,2,305,322,13
PPP2R3C,16,3,303,322,13
MMP16,14,1,307,322,13
FEM1C,16,3,303,322,13
MTARC1,14,1,307,322,13
ATPSCKMT,16,3,303,322,13
MTF1,13,0,309,322,13
LZTR1,15,2,305,322,13
MYG1,13,0,309,322,13
CELSR1,17,4,301,322,13
FGFR1,19,6,297,322,13
CADM1,14,1,307,322,13
SUSD2,14,1,307,322,13
AZIN1,14,1,307,322,13
MAP2K3,18,5,299,322,13
MAP2K5,14,1,307,322,13
MAP3K11,16,3,303,322,13
MAP3K12,19,6,297,322,13
RNASE10,15,2,305,322,13
ASB10,13,0,309,322,13
GFRA2,15,2,305,322,13
ASCC2,20,7,295,322,13
ASGR1,22,9,291,322,13
MBP,27,14,281,322,13
KRT28,14,1,307,322,13
DRC3,26,13,283,322,13
CRYGD,16,3,303,322,13
GNB2,15,2,305,322,13
RAB3A,17,4,301,322,13
RPL36A-HNRNPH2,36,23,263,322,13
ANKAR,13,0,309,322,13
NUFIP2,14,1,307,322,13
TSPYL4,13,0,309,322,13
TSPAN9,17,4,301,322,13
DUSP10,17,4,301,322,13
EIF1AD,19,6,297,322,13
PYDC2,24,11,287,322,13
SPARCL1,18,5,299,322,13
CPN2,15,2,305,322,13
SPATA22,16,3,303,322,13
ANKRD42,14,1,307,322,13
GNG3,25,12,285,322,13
ZNF703,15,2,305,322,13
OAT,15,2,305,322,13
ING4,15,2,305,322,13
ENC1,14,1,307,322,13
CD52,49,36,237,322,13
CHI3L2,26,13,283,322,13
BTBD9,15,2,305,322,13
C4A,23,10,289,322,13
ALDOB,18,5,299,322,13
BSX,17,4,301,322,13
UBR1,15,2,305,322,13
BSG,16,3,303,322,13
IL32,19,6,297,322,13
GOSR2,13,0,309,322,13
ZFR2,19,6,297,322,13
ALPG,13,0,309,322,13
ENPP3,21,8,293,322,13
U2AF1,24,11,287,322,13
CD79B,20,7,295,322,13
KCNN1,18,5,299,322,13
JPH4,16,3,303,322,13
FBXL19,14,1,307,322,13
FXYD6,16,3,303,322,13
SPON2,22,9,291,322,13
KISS1,22,9,291,322,13
TPT1,16,3,303,322,13
NME5,20,7,295,322,13
CDK2AP2,17,4,301,322,13
CDK11B,14,1,307,322,13
BICDL2,19,6,297,322,13
TRBV5-4,21,8,293,322,13
TRBV7-4,16,3,303,322,13
PTH2,26,13,283,322,13
NPNT,20,7,295,322,13
NPPB,26,13,283,322,13
AP1S1,13,0,309,322,13
SETD1B,14,1,307,322,13
EFCAB10,28,15,279,322,13
SPINK2,19,6,297,322,13
SARAF,15,2,305,322,13
EEF1A2,17,4,301,322,13
CREB3L3,14,1,307,322,13
PNMT,23,11,288,322,12
RAPGEF1,12,0,310,322,12
PPP2R5D,12,0,310,322,12
CHD3,13,1,308,322,12
PRM3,21,9,292,322,12
RAG1,12,0,310,322,12
CCDC151,18,6,298,322,12
CBL,12,0,310,322,12
PPP2R2B,22,10,290,322,12
CCND2,12,0,310,322,12
CA7,13,1,308,322,12
CHI3L1,13,1,308,322,12
CDKL4,42,30,250,322,12
FNIP2,13,1,308,322,12
CHMP2A,14,2,306,322,12
RBFOX2,13,1,308,322,12
RAET1G,18,6,298,322,12
RNF167,14,2,306,322,12
RENBP,21,9,292,322,12
C3orf38,12,0,310,322,12
CCDC173,19,7,296,322,12
CEP19,12,0,310,322,12
PRODH2,15,3,304,322,12
RCC1,13,1,308,322,12
CD68,13,1,308,322,12
RYBP,13,1,308,322,12
RGSL1,15,3,304,322,12
S1PR1,17,5,300,322,12
CCT5,17,5,300,322,12
CGB3,33,21,268,322,12
SF1,13,1,308,322,12
PRRT2,22,10,290,322,12
SH3PXD2A,14,2,306,322,12
CALD1,13,1,308,322,12
PLIN1,12,0,310,322,12
CBS,23,11,288,322,12
CELA2B,21,9,292,322,12
PTPA,13,1,308,322,12
CDC26,15,3,304,322,12
CDKN1A,14,2,306,322,12
PSME3IP1,12,0,310,322,12
SERINC5,15,3,304,322,12
SERP1,15,3,304,322,12
SF3B1,14,2,306,322,12
SIRPA,14,2,306,322,12
RABEPK,14,2,306,322,12
CCDC70,16,4,302,322,12
PTOV1,15,3,304,322,12
SEMA7A,17,5,300,322,12
CCT4,13,1,308,322,12
PRPF8,13,1,308,322,12
RORA,15,3,304,322,12
CABLES1,17,5,300,322,12
CCDC200,19,7,296,322,12
TTR,17,5,300,322,12
GSN,13,1,308,322,12
MRPL23,15,3,304,322,12
KLHL12,14,2,306,322,12
ATP5MGL,28,16,278,322,12
DCAF11,13,1,308,322,12
MPP5,12,0,310,322,12
DYRK1A,13,1,308,322,12
DCK,13,1,308,322,12
ATP5F1B,15,3,304,322,12
TBC1D17,14,2,306,322,12
WDR37,12,0,310,322,12
H4C3,31,19,272,322,12
H4C5,21,9,292,322,12
MN1,14,2,306,322,12
UBAP1,12,0,310,322,12
HAPLN3,14,2,306,322,12
ATP1B1,13,1,308,322,12
ATP1A1,13,1,308,322,12
KLK2,37,25,260,322,12
DDAH1,13,1,308,322,12
MLNR,16,4,302,322,12
TBXAS1,22,10,290,322,12
ADRA2C,16,4,302,322,12
MIDN,14,2,306,322,12
DDX4,19,7,296,322,12
MIB2,16,4,302,322,12
TCP11L2,20,8,294,322,12
MFAP3,12,0,310,322,12
H2BC6,22,10,290,322,12
MRPL33,15,3,304,322,12
MRPL53,18,6,298,322,12
YWHAE,13,1,308,322,12
NDNF,19,7,296,322,12
NDEL1,12,0,310,322,12
STK36,14,2,306,322,12
NBPF6,15,3,304,322,12
STOX1,14,2,306,322,12
BAIAP2,18,6,298,322,12
CUL9,15,3,304,322,12
STX1A,12,0,310,322,12
KDM7A,13,1,308,322,12
SUGT1,13,1,308,322,12
MYO7A,15,3,304,322,12
MYO5B,16,4,302,322,12
MYCBPAP,18,6,298,322,12
TRAPPC4,15,3,304,322,12
MYC,20,8,294,322,12
FAM210A,12,0,310,322,12
AZU1,18,6,298,322,12
TYW3,13,1,308,322,12
KIF7,16,4,302,322,12
MTRNR2L12,17,5,300,322,12
H2AC15,41,29,252,322,12
MTIF3,12,0,310,322,12
TAF1C,15,3,304,322,12
TAF7,14,2,306,322,12
MS4A4A,15,3,304,322,12
TARDBP,13,1,308,322,12
KLRC4,17,5,300,322,12
TEK,12,0,310,322,12
MED26,14,2,306,322,12
LAGE3,14,2,306,322,12
TP53AIP1,25,13,284,322,12
DLX6,13,1,308,322,12
UBE2L5,22,10,290,322,12
LY6G6D,33,21,268,322,12
LURAP1L,13,1,308,322,12
USP4,13,1,308,322,12
USP30,15,3,304,322,12
DNAH7,30,18,274,322,12
TMEM150A,19,7,296,322,12
ERMN,30,18,274,322,12
AKR1B15,15,3,304,322,12
IGHV2OR16-5,16,4,302,322,12
LRP5,16,4,302,322,12
VAV3,21,9,292,322,12
ERICH2,27,15,280,322,12
PLAAT3,20,8,294,322,12
TMEM234,13,1,308,322,12
ARHGAP5,13,1,308,322,12
UBTF,16,4,302,322,12
TNFRSF17,31,19,272,322,12
TNFRSF14,20,8,294,322,12
LIPJ,15,3,304,322,12
IFTAP,15,3,304,322,12
IGF1R,14,2,306,322,12
ARG2,17,5,300,322,12
LEUTX,14,2,306,322,12
HPCA,16,4,302,322,12
DLG4,14,2,306,322,12
MED20,15,3,304,322,12
HNMT,16,4,302,322,12
DEFB134,18,6,298,322,12
AFAP1L1,12,0,310,322,12
MDP1,24,12,286,322,12
AFF4,14,2,306,322,12
FABP4,19,7,296,322,12
TEX53,15,3,304,322,12
ASMTL,14,2,306,322,12
TFDP1,12,0,310,322,12
MC1R,14,2,306,322,12
MAST3,15,3,304,322,12
UBE2D3,13,1,308,322,12
IGSF11,14,2,306,322,12
ASB3,14,2,306,322,12
DLG2,16,4,302,322,12
THBS1,25,13,284,322,12
VIM,14,2,306,322,12
MAP4K4,12,0,310,322,12
DUSP16,13,1,308,322,12
ASAP1,13,1,308,322,12
KRT16,25,13,284,322,12
MAN2A2,14,2,306,322,12
EXOC3,12,0,310,322,12
VEGFD,14,2,306,322,12
TIPARP,12,0,310,322,12
AGT,18,6,298,322,12
HOXB1,15,3,304,322,12
STIM1,12,0,310,322,12
NCOR2,14,2,306,322,12
EED,16,4,302,322,12
SMARCD3,15,3,304,322,12
ZNF530,15,3,304,322,12
FGF9,12,0,310,322,12
SLC6A3,12,0,310,322,12
ZNF521,17,5,300,322,12
SLC9B1,26,14,282,322,12
GAPT,12,0,310,322,12
C11orf58,15,3,304,322,12
GFRA3,15,3,304,322,12
PCNX2,12,0,310,322,12
PCGF2,13,1,308,322,12
PCED1A,15,3,304,322,12
ACAP1,16,4,302,322,12
ZNF384,12,0,310,322,12
PDZD7,15,3,304,322,12
PBX3,14,2,306,322,12
GHRH,26,14,282,322,12
JUND,14,2,306,322,12
ZNF324,15,3,304,322,12
PAQR3,13,1,308,322,12
IMMP1L,16,4,302,322,12
PAEP,26,14,282,322,12
BTG2,21,9,292,322,12
CTAG1A,21,9,292,322,12
ZNF281,12,0,310,322,12
ACO2,12,0,310,322,12
TSKS,19,7,296,322,12
ZNF540,14,2,306,322,12
TSSK2,17,5,300,322,12
SMPD3,19,7,296,322,12
ZNF808,17,5,300,322,12
SKP1,14,2,306,322,12
IRGC,16,4,302,322,12
CIBAR2,13,1,308,322,12
ZNHIT1,16,4,302,322,12
C1orf226,15,3,304,322,12
SLC22A16,14,2,306,322,12
SLC22A17,14,2,306,322,12
ZNF853,13,1,308,322,12
IRS2,12,0,310,322,12
FOXE3,19,7,296,322,12
CLCN1,14,2,306,322,12
PIANP,14,2,306,322,12
ELK3,13,1,308,322,12
ELOVL3,14,2,306,322,12
PHPT1,14,2,306,322,12
ITGA2B,21,9,292,322,12
C19orf73,26,14,282,322,12
FSCN1,14,2,306,322,12
C18orf32,16,4,302,322,12
SLC30A1,15,3,304,322,12
TTC36,27,15,280,322,12
EIF5,15,3,304,322,12
PFN1,15,3,304,322,12
ITGA7,20,8,294,322,12
PFDN2,13,1,308,322,12
TUBA4A,15,3,304,322,12
OVOL3,39,27,256,322,12
SMIM32,18,6,298,322,12
ZNF233,17,5,300,322,12
CPT1B,15,3,304,322,12
ACTG2,20,8,294,322,12
SPI1,24,12,286,322,12
FANK1,25,13,284,322,12
NPAS3,28,16,278,322,12
SPRING1,12,0,310,322,12
NOTCH2,15,3,304,322,12
NOTCH1,13,1,308,322,12
AMHR2,15,3,304,322,12
ZFAND5,13,1,308,322,12
SPTSSB,21,9,292,322,12
CRYBB1,17,5,300,322,12
EFHD1,24,12,286,322,12
ZDHHC19,18,6,298,322,12
AMH,21,9,292,322,12
ZBTB5,12,0,310,322,12
NISCH,12,0,310,322,12
CSGALNACT2,15,3,304,322,12
TRIM46,17,5,300,322,12
NID1,12,0,310,322,12
CSKMT,15,3,304,322,12
GRIPAP1,14,2,306,322,12
ZBTB10,14,2,306,322,12
ANTXR2,12,0,310,322,12
FAM241B,17,5,300,322,12
NECTIN3,16,4,302,322,12
TRPV6,16,4,302,322,12
ANKRD61,22,10,290,322,12
BPTF,15,3,304,322,12
GNB3,18,6,298,322,12
COL5A1,15,3,304,322,12
GLRB,16,4,302,322,12
GLYR1,14,2,306,322,12
FBXO24,26,14,282,322,12
EGLN3,14,2,306,322,12
EGLN1,14,2,306,322,12
OLFM2,18,6,298,322,12
FBXO10,13,1,308,322,12
SNX29,13,1,308,322,12
OLAH,15,3,304,322,12
GMPR2,14,2,306,322,12
ZNF106,14,2,306,322,12
AREL1,13,1,308,322,12
GNRH1,23,11,288,322,12
ENDOU,14,2,306,322,12
GOLGB1,14,2,306,322,12
NUDT21,13,1,308,322,12
SPANXD,20,8,294,322,12
GOLGA6A,14,2,306,322,12
IQCE,11,0,311,322,11
EP400,12,1,309,322,11
RAD52,12,1,309,322,11
CD83,15,4,303,322,11
ENTPD3,24,13,285,322,11
EMX2,13,2,307,322,11
EMP3,19,8,295,322,11
IGF2BP2,12,1,309,322,11
IL18,16,5,301,322,11
ELOA2,12,1,309,322,11
IGF2R,13,2,307,322,11
IL20RB,14,3,305,322,11
EPHB3,11,0,311,322,11
ENDOG,13,2,307,322,11
IQCG,14,3,305,322,11
RAB6A,12,1,309,322,11
INSR,13,2,307,322,11
ENPP2,14,3,305,322,11
IGKV2D-40,13,2,307,322,11
IP6K1,11,0,311,322,11
CIAO2B,13,2,307,322,11
IFITM1,27,16,279,322,11
FCGRT,22,11,289,322,11
GPR137B,12,1,309,322,11
GPD1,20,9,293,322,11
GORASP1,14,3,305,322,11
FASLG,14,3,305,322,11
GOLT1A,21,10,291,322,11
FBLN5,12,1,309,322,11
RHBDD2,12,1,309,322,11
RHBDD3,15,4,303,322,11
GLIS3,12,1,309,322,11
GLCCI1,12,1,309,322,11
GJA8,11,0,311,322,11
CCDC96,14,3,305,322,11
CCDC9,17,6,299,322,11
GANAB,13,2,307,322,11
GRB10,16,5,301,322,11
GAL3ST2,14,3,305,322,11
GAGE12J,17,6,299,322,11
GAA,14,3,305,322,11
FUT7,14,3,305,322,11
FUT5,12,1,309,322,11
FKBP8,15,4,303,322,11
CCDC6,11,0,311,322,11
FTH1,12,1,309,322,11
FRYL,11,0,311,322,11
FOXP3,19,8,295,322,11
RNF157,12,1,309,322,11
FNBP1L,12,1,309,322,11
FOXC1,12,1,309,322,11
GPR75,11,0,311,322,11
GRIK5,14,3,305,322,11
CD44,15,4,303,322,11
HDAC7,12,1,309,322,11
IDI2,14,3,305,322,11
RAF1,12,1,309,322,11
ERICH3,11,0,311,322,11
HUWE1,12,1,309,322,11
HUS1B,25,14,283,322,11
HSPG2,15,4,303,322,11
HSBP1,13,2,307,322,11
HPX,15,4,303,322,11
RASL10A,21,10,291,322,11
HNRNPM,14,3,305,322,11
EXOG,19,8,295,322,11
HIPK1,13,2,307,322,11
HINFP,11,0,311,322,11
FAM120AOS,12,1,309,322,11
REST,11,0,311,322,11
HAVCR1,14,3,305,322,11
CD151,13,2,307,322,11
H4C2,37,26,259,322,11
CCT3,14,3,305,322,11
RAB1B,12,1,309,322,11
RBM48,11,0,311,322,11
RC3H1,11,0,311,322,11
GYG2,14,3,305,322,11
RCC2,12,1,309,322,11
GSTP1,16,5,301,322,11
GSTM2,18,7,297,322,11
REM2,16,5,301,322,11
GRK7,12,1,309,322,11
H3C14,16,5,301,322,11
PSMC6,11,0,311,322,11
R3HDM4,19,8,295,322,11
MTRF1,15,4,303,322,11
NPDC1,15,4,303,322,11
NPRL3,13,2,307,322,11
PPFIA3,16,5,301,322,11
NR1H4,13,2,307,322,11
NR2F1,11,0,311,322,11
PPFIA1,12,1,309,322,11
NSD2,13,2,307,322,11
CPSF1,13,2,307,322,11
CPO,14,3,305,322,11
COX7A2L,14,3,305,322,11
COX7A1,28,17,277,322,11
OBSL1,12,1,309,322,11
COTL1,13,2,307,322,11
COQ5,13,2,307,322,11
COPS2,12,1,309,322,11
CHCHD2,12,1,309,322,11
PON3,15,4,303,322,11
NOC2L,12,1,309,322,11
CRTC2,12,1,309,322,11
NME1-NME2,36,25,261,322,11
NDUFB1,15,4,303,322,11
CYP26B1,12,1,309,322,11
CYP17A1,13,2,307,322,11
MYBPH,12,1,309,322,11
MYLIP,15,4,303,322,11
CFAP300,12,1,309,322,11
NAA16,12,1,309,322,11
NDUFAF2,12,1,309,322,11
CT45A7,17,6,299,322,11
CFDP1,12,1,309,322,11
NELFCD,13,2,307,322,11
CST3,13,2,307,322,11
CST2,14,3,305,322,11
NFE2L2,12,1,309,322,11
NIM1K,18,7,297,322,11
PPM1K,13,2,307,322,11
NKX3-1,16,5,301,322,11
COL7A1,12,1,309,322,11
POMT2,15,4,303,322,11
COL28A1,18,7,297,322,11
PHOSPHO1,19,8,295,322,11
PEX6,11,0,311,322,11
PLS3,16,5,301,322,11
PFKFB3,16,5,301,322,11
PGAP6,12,1,309,322,11
CLEC2B,17,6,299,322,11
PGD,12,1,309,322,11
PHC3,12,1,309,322,11
CLDN11,12,1,309,322,11
PEA15,12,1,309,322,11
PLEKHM2,12,1,309,322,11
PI4KB,12,1,309,322,11
CLASP1,12,1,309,322,11
CKS2,13,2,307,322,11
CKM,14,3,305,322,11
PKD1,11,0,311,322,11
PLA2G6,20,9,293,322,11
CLIP2,14,3,305,322,11
CLPP,11,0,311,322,11
POLR2J2,18,7,297,322,11
PBOV1,13,2,307,322,11
OXER1,12,1,309,322,11
P3R3URF-PIK3R3,23,12,287,322,11
COL11A2,16,5,301,322,11
PALLD,13,2,307,322,11
PNPLA6,15,4,303,322,11
PAQR9,14,3,305,322,11
CNTD1,34,23,265,322,11
PCBP1,13,2,307,322,11
CLTC,12,1,309,322,11
PCDHGA2,11,0,311,322,11
CHP1,13,2,307,322,11
CMTM1,15,4,303,322,11
PDAP1,17,6,299,322,11
PDCD6,12,1,309,322,11
CLVS1,26,15,281,322,11
PDIA4,17,6,299,322,11
CYP2C19,11,0,311,322,11
MRPS34,13,2,307,322,11
CDC42BPB,11,0,311,322,11
PPP1R7,11,0,311,322,11
KLRC1,34,23,265,322,11
CDK3,17,6,299,322,11
KMT2E,13,2,307,322,11
KRT222,19,8,295,322,11
KRT78,14,3,305,322,11
PSPN,12,1,309,322,11
KRTAP19-8,17,6,299,322,11
LAMTOR3,13,2,307,322,11
LARP4,13,2,307,322,11
DPYSL4,11,0,311,322,11
CDKN2A,13,2,307,322,11
DPCD,16,5,301,322,11
LIFR,14,3,305,322,11
PSMD13,12,1,309,322,11
PSMD11,12,1,309,322,11
PSMD10,11,0,311,322,11
LMO4,12,1,309,322,11
KLHL32,18,7,297,322,11
DYNLRB1,14,3,305,322,11
EARS2,13,2,307,322,11
KANSL1,12,1,309,322,11
EIF5A,12,1,309,322,11
EIF4G2,14,3,305,322,11
QRFP,18,7,297,322,11
ITM2B,12,1,309,322,11
QKI,13,2,307,322,11
JAML,13,2,307,322,11
EIF1,12,1,309,322,11
EHMT2,13,2,307,322,11
KIDINS220,11,0,311,322,11
KBTBD2,11,0,311,322,11
KBTBD8,19,8,295,322,11
PURA,15,4,303,322,11
KCNJ10,19,8,295,322,11
PTPRF,11,0,311,322,11
EEF2,13,2,307,322,11
KHDC3L,16,5,301,322,11
PSMB3,16,5,301,322,11
DNASE1,12,1,309,322,11
LRP2BP,13,2,307,322,11
PRDM14,12,1,309,322,11
MAST1,19,8,295,322,11
DENND5B,11,0,311,322,11
DENND2A,12,1,309,322,11
PRKN,22,11,289,322,11
METRN,18,7,297,322,11
MIXL1,14,3,305,322,11
MLXIP,12,1,309,322,11
PRAG1,12,1,309,322,11
MAPK8IP1,14,3,305,322,11
MMP3,17,6,299,322,11
PRAC2,21,10,291,322,11
MOGAT3,15,4,303,322,11
MON1A,15,4,303,322,11
CERS4,19,8,295,322,11
DCAF8,13,2,307,322,11
MRGPRX3,17,6,299,322,11
MAPKAPK2,12,1,309,322,11
DHRS7,12,1,309,322,11
LRRC15,11,0,311,322,11
DLX1,14,3,305,322,11
LRRC36,15,4,303,322,11
LRRC6,18,7,297,322,11
DNAJB5,14,3,305,322,11
LSAMP,18,7,297,322,11
PRSS27,14,3,305,322,11
LTK,15,4,303,322,11
DMD,15,4,303,322,11
PRRC2A,12,1,309,322,11
MAP3K2,12,1,309,322,11
DLG5,11,0,311,322,11
MAF1,12,1,309,322,11
DKK2,12,1,309,322,11
MAFK,13,2,307,322,11
MAGED4B,15,4,303,322,11
MAGIX,13,2,307,322,11
MAP1B,11,0,311,322,11
DEFB116,12,1,309,322,11
PPP2R1A,13,2,307,322,11
ACTC1,18,7,297,322,11
SCD,12,1,309,322,11
ZNF443,17,6,299,322,11
ATP5PD,14,3,305,322,11
SFMBT1,13,2,307,322,11
BICDL1,12,1,309,322,11
BUD23,12,1,309,322,11
ZNF599,12,1,309,322,11
SHKBP1,13,2,307,322,11
TGFB1I1,16,5,301,322,11
ACOX1,12,1,309,322,11
TMEM223,12,1,309,322,11
TGM4,15,4,303,322,11
SHISAL2B,21,10,291,322,11
C2orf49,13,2,307,322,11
ARHGAP21,13,2,307,322,11
AKT3,12,1,309,322,11
TRIM17,18,7,297,322,11
VCX,27,16,279,322,11
AKT2,13,2,307,322,11
RPS14,13,2,307,322,11
SPON1,17,6,299,322,11
TTLL10,15,4,303,322,11
SHMT2,12,1,309,322,11
BHLHE40,13,2,307,322,11
BLID,18,7,297,322,11
BTN1A1,11,0,311,322,11
ATP1B2,16,5,301,322,11
SLC27A5,21,10,291,322,11
SPG21,12,1,309,322,11
ZNF677,15,4,303,322,11
UBXN4,11,0,311,322,11
SETD5,11,0,311,322,11
SETSIP,30,19,273,322,11
ANK2,21,10,291,322,11
SIAE,18,7,297,322,11
STMN1,12,1,309,322,11
RPLP2,14,3,305,322,11
SULT4A1,15,4,303,322,11
RPN1,14,3,305,322,11
ACTB,12,1,309,322,11
TTLL13P,19,8,295,322,11
SCGB1D2,21,10,291,322,11
BIRC3,11,0,311,322,11
BIN2,24,13,285,322,11
ACAD10,15,4,303,322,11
STX8,14,3,305,322,11
RPS16,13,2,307,322,11
ARIH1,13,2,307,322,11
BANF1,14,3,305,322,11
ARHGAP9,18,7,297,322,11
SLC7A8,12,1,309,322,11
ACOX3,12,1,309,322,11
ANKRD12,12,1,309,322,11
ZNF462,14,3,305,322,11
SRGAP2,12,1,309,322,11
TEF,13,2,307,322,11
APOD,19,8,295,322,11
TMEM260,12,1,309,322,11
TMEM269,12,1,309,322,11
SLC9A3R2,16,5,301,322,11
SH3BGRL3,12,1,309,322,11
SLC43A3,15,4,303,322,11
ADM,14,3,305,322,11
SLC4A1AP,11,0,311,322,11
ZMYND10,21,10,291,322,11
C15orf48,36,25,261,322,11
ZNF114,14,3,305,322,11
TERB1,26,15,281,322,11
C2orf88,25,14,283,322,11
CATSPERG,14,3,305,322,11
ANKRD20A3P,22,11,289,322,11
TEAD1,11,0,311,322,11
ZNF532,18,7,297,322,11
WNT8B,13,2,307,322,11
SPRED2,13,2,307,322,11
URGCP-MRPS24,33,22,267,322,11
ZHX3,14,3,305,322,11
AKAP8L,12,1,309,322,11
TTC7B,12,1,309,322,11
SPRY1,19,8,295,322,11
SPRY2,15,4,303,322,11
RPS18,14,3,305,322,11
ANKHD1-EIF4EBP3,16,5,301,322,11
ANKLE2,12,1,309,322,11
ASPN,23,12,287,322,11
AKAP17A,13,2,307,322,11
STX6,12,1,309,322,11
ZNF528,16,5,301,322,11
ARHGDIA,12,1,309,322,11
TRIM25,11,0,311,322,11
ACSM2B,16,5,301,322,11
SLC39A10,12,1,309,322,11
USP21,12,1,309,322,11
SAMD1,15,4,303,322,11
BDH1,16,5,301,322,11
YLPM1,11,0,311,322,11
ZNF778,13,2,307,322,11
TLE2,25,14,283,322,11
ARF1,13,2,307,322,11
UBE2L6,13,2,307,322,11
TMEM159,14,3,305,322,11
ZFHX2,11,0,311,322,11
ZBTB4,11,0,311,322,11
BRPF3,17,6,299,322,11
UBE2O,13,2,307,322,11
TAP1,14,3,305,322,11
ABCB11,22,11,289,322,11
SNF8,12,1,309,322,11
SYNGAP1,15,4,303,322,11
SEPTIN2,12,1,309,322,11
YWHAQ,12,1,309,322,11
TIMP2,12,1,309,322,11
SERBP1,12,1,309,322,11
CCDC163,12,1,309,322,11
SLC16A4,15,4,303,322,11
ATXN7L3,11,0,311,322,11
ZNF79,11,0,311,322,11
SNRPC,11,0,311,322,11
SYT15,16,5,301,322,11
ARPC3,15,4,303,322,11
TRA2B,12,1,309,322,11
SLC22A23,15,4,303,322,11
CAPZB,12,1,309,322,11
TWF2,14,3,305,322,11
SOX30,12,1,309,322,11
TM2D1,13,2,307,322,11
TAC1,16,5,301,322,11
APBA2,16,5,301,322,11
TSC22D3,14,3,305,322,11
UBE2D1,14,3,305,322,11
TM4SF20,11,0,311,322,11
SDHB,13,2,307,322,11
TRPC3,13,2,307,322,11
SKAP1,29,18,275,322,11
SYT8,13,2,307,322,11
CARS1,12,1,309,322,11
SEC11C,11,0,311,322,11
TBX1,18,7,297,322,11
SMIM34A,18,7,297,322,11
TMC8,13,2,307,322,11
SERPINB6,12,1,309,322,11
TMEM150B,17,6,299,322,11
RPL18A,15,4,303,322,11
TMEM151B,17,6,299,322,11
SUPT6H,11,0,311,322,11
ZNF24,11,0,311,322,11
STK11IP,16,5,301,322,11
AMPD1,12,1,309,322,11
VIP,13,2,307,322,11
TRDC,16,5,301,322,11
CALCOCO1,14,3,305,322,11
ZSWIM6,13,2,307,322,11
AMOTL2,14,3,305,322,11
SLC25A47,13,2,307,322,11
ATP6V0D1,13,2,307,322,11
A2ML1,13,2,307,322,11
TXLNB,15,4,303,322,11
RNF40,12,1,309,322,11
STK11,12,1,309,322,11
BTBD1,11,0,311,322,11
SDC2,15,4,303,322,11
BMP7,12,1,309,322,11
SON,11,0,311,322,11
SYF2,12,1,309,322,11
TXNDC16,13,2,307,322,11
RPL21,12,1,309,322,11
SLC25A41,17,6,299,322,11
TNFRSF11A,11,0,311,322,11
SIRT6,15,4,303,322,11
TMCO1,12,1,309,322,11
TMEM14B,13,2,307,322,11
SV2A,12,1,309,322,11
PMF1-BGLAP,18,8,296,322,10
PLSCR4,18,8,296,322,10
VWCE,16,6,300,322,10
SLC12A7,14,4,304,322,10
STMP1,11,1,310,322,10
VWA1,16,6,300,322,10
HADHB,13,3,306,322,10
TRIM39,13,3,306,322,10
WBP2,11,1,310,322,10
KCTD7,12,2,308,322,10
TRMT112,11,1,310,322,10
CIC,12,2,308,322,10
NCAPH2,13,3,306,322,10
EFEMP2,16,6,300,322,10
SIPA1L2,11,1,310,322,10
STK16,11,1,310,322,10
NCKAP1,10,0,312,322,10
TRIM8,11,1,310,322,10
KCTD12,13,3,306,322,10
TRIM36,13,3,306,322,10
KCTD13,14,4,304,322,10
ADRA1B,11,1,310,322,10
PLGLB2,35,25,262,322,10
TRIM49D1,13,3,306,322,10
KCNMB4,12,2,308,322,10
EEF1G,14,4,304,322,10
FAM131B,14,4,304,322,10
NCAM1,14,4,304,322,10
PLCG1,12,2,308,322,10
SIT1,12,2,308,322,10
PLCB3,11,1,310,322,10
HDLBP,11,1,310,322,10
NBPF20,12,2,308,322,10
BAZ1B,11,1,310,322,10
HEMGN,12,2,308,322,10
KCNJ14,14,4,304,322,10
SLBP,13,3,306,322,10
C1QL1,13,3,306,322,10
SLC10A1,19,9,294,322,10
SVOPL,15,5,302,322,10
ECSIT,16,6,300,322,10
EEF1A1,12,2,308,322,10
KIF21A,14,4,304,322,10
EAF1,12,2,308,322,10
C8orf74,10,0,312,322,10
EBF4,25,15,282,322,10
PPP1R14B,13,3,306,322,10
SYMPK,13,3,306,322,10
SERGEF,12,2,308,322,10
PPP1R12A,11,1,310,322,10
SERP2,18,8,296,322,10
EBLN1,14,4,304,322,10
B2M,13,3,306,322,10
C6orf62,11,1,310,322,10
ADAMTSL4,13,3,306,322,10
C6orf52,32,22,268,322,10
CYFIP2,13,3,306,322,10
PPIH,11,1,310,322,10
MYCN,13,3,306,322,10
TREML1,12,2,308,322,10
FAM234A,12,2,308,322,10
AP3D1,11,1,310,322,10
GRSF1,11,1,310,322,10
PPP4R2,13,3,306,322,10
ZC3H11A,12,2,308,322,10
PRDX5,14,4,304,322,10
GRB14,15,5,302,322,10
APBB1,11,1,310,322,10
PRAP1,30,20,272,322,10
TAC4,43,33,246,322,10
PPP4R3B,10,0,312,322,10
MTERF1,12,2,308,322,10
GRK6,11,1,310,322,10
GRIN2B,12,2,308,322,10
SELENON,10,0,312,322,10
ZBTB12,10,0,312,322,10
ATXN1,10,0,312,322,10
ZBTB1,11,1,310,322,10
DYRK1B,14,4,304,322,10
SELENOW,16,6,300,322,10
PPIB,12,2,308,322,10
ECHS1,12,2,308,322,10
C3,13,3,306,322,10
MYL6,13,3,306,322,10
POMT1,11,1,310,322,10
C3orf84,12,2,308,322,10
FAM168A,11,1,310,322,10
POLDIP3,12,2,308,322,10
WFDC10B,26,16,280,322,10
ADGRL1,13,3,306,322,10
WEE1,14,4,304,322,10
WDTC1,11,1,310,322,10
KDM6B,10,0,312,322,10
POGLUT1,10,0,312,322,10
CHKA,12,2,308,322,10
NAP1L4,11,1,310,322,10
EDNRB,12,2,308,322,10
CUX1,12,2,308,322,10
PNMA1,12,2,308,322,10
FAM160A1,13,3,306,322,10
CUL7,11,1,310,322,10
MZT2B,14,4,304,322,10
SFTPB,11,1,310,322,10
CHCHD10,20,10,292,322,10
PPARGC1A,12,2,308,322,10
B3GLCT,12,2,308,322,10
KIF12,15,5,302,322,10
MYLPF,35,25,262,322,10
SUMO1,13,3,306,322,10
MYO18A,10,0,312,322,10
YARS1,11,1,310,322,10
MYO1G,12,2,308,322,10
YAF2,12,2,308,322,10
PKN1,13,3,306,322,10
ADCY7,15,5,302,322,10
SF3B4,12,2,308,322,10
SF3B5,13,3,306,322,10
SF3B6,14,4,304,322,10
SULT1A3,29,19,274,322,10
WWTR1,13,3,306,322,10
POR,14,4,304,322,10
SLC13A4,16,6,300,322,10
PGA3,20,10,292,322,10
PKM,12,2,308,322,10
TMBIM6,11,1,310,322,10
PAIP1,11,1,310,322,10
NR1H3,16,6,300,322,10
IFITM5,14,4,304,322,10
SPG11,13,3,306,322,10
BLOC1S5-TXNDC5,33,23,266,322,10
IFRD1,14,4,304,322,10
SPDYE6,17,7,298,322,10
IFT57,11,1,310,322,10
NR3C1,10,0,312,322,10
PABPC1,12,2,308,322,10
SMIM36,13,3,306,322,10
SPDYE5,23,13,286,322,10
P4HTM,15,5,302,322,10
COG7,11,1,310,322,10
IGDCC4,10,0,312,322,10
TUBA1B,12,2,308,322,10
P4HA1,11,1,310,322,10
ELOA,10,0,312,322,10
TUBA8,11,1,310,322,10
P3H3,13,3,306,322,10
TTYH1,12,2,308,322,10
ERAS,14,4,304,322,10
PAN2,11,1,310,322,10
TTLL9,14,4,304,322,10
BICD2,10,0,312,322,10
PCDH10,10,0,312,322,10
PCBP4,14,4,304,322,10
PCBP2,12,2,308,322,10
SPNS1,16,6,300,322,10
ISCU,12,2,308,322,10
CNOT4,11,1,310,322,10
CNOT6L,11,1,310,322,10
ID3,23,13,286,322,10
SPINK7,16,6,300,322,10
CNP,10,0,312,322,10
NPR2,15,5,302,322,10
PARK7,11,1,310,322,10
SPIN1,11,1,310,322,10
SMG1,11,1,310,322,10
SPIDR,12,2,308,322,10
PARD3,11,1,310,322,10
SMG6,13,3,306,322,10
SMIM18,19,9,294,322,10
SMIM34B,15,5,302,322,10
TUBB1,16,6,300,322,10
PCDH19,12,2,308,322,10
NUP205,11,1,310,322,10
SPAG9,12,2,308,322,10
SPAG5,15,5,302,322,10
UBE2C,12,2,308,322,10
SPACA3,18,8,296,322,10
COPA,12,2,308,322,10
NUDT4,12,2,308,322,10
SOX9,19,9,294,322,10
BORCS8-MEF2B,27,17,278,322,10
ILRUN,11,1,310,322,10
SNX1,11,1,310,322,10
EPHB6,12,2,308,322,10
IL22,10,0,312,322,10
SOX10,17,7,298,322,10
COX6B2,12,2,308,322,10
SOS 1,10,0,312,322,10
BRD7,11,1,310,322,10
ENHO,15,5,302,322,10
TXNL4B,12,2,308,322,10
CORO1C,12,2,308,322,10
TXNDC5,12,2,308,322,10
OR2V1,11,1,310,322,10
ENTR1,11,1,310,322,10
COMMD3-BMI1,43,33,246,322,10
TUFM,11,1,310,322,10
UBL3,10,0,312,322,10
IGHE,12,2,308,322,10
SMO,10,0,312,322,10
TUBB8B,11,1,310,322,10
SMPX,16,6,300,322,10
INTU,15,5,302,322,10
SPATA32,15,5,302,322,10
OTUB1,11,1,310,322,10
IGHMBP2,14,4,304,322,10
CPNE6,15,5,302,322,10
EPDR1,12,2,308,322,10
ALKBH3,15,5,302,322,10
ALKBH5,11,1,310,322,10
EPB41L4B,11,1,310,322,10
SPATA2,13,3,306,322,10
OSBPL1A,13,3,306,322,10
SNRPA1,11,1,310,322,10
NTRK3,14,4,304,322,10
COLGALT2,12,2,308,322,10
IAPP,19,9,294,322,10
NPC1,12,2,308,322,10
TRPV1,11,1,310,322,10
PGM3,17,7,298,322,10
AGO2,14,4,304,322,10
HNRNPA1,15,5,302,322,10
HNRNPA2B1,12,2,308,322,10
HNRNPC,11,1,310,322,10
CSRNP2,13,3,306,322,10
EIF2A,10,0,312,322,10
EXOC7,11,1,310,322,10
CLEC16A,11,1,310,322,10
SSBP4,17,7,298,322,10
EIF2AK4,12,2,308,322,10
JAK1,11,1,310,322,10
C17orf80,10,0,312,322,10
SLC34A3,14,4,304,322,10
VEZF1,10,0,312,322,10
SRSF4,14,4,304,322,10
SLC35F1,12,2,308,322,10
CLEC4C,17,7,298,322,10
PGA4,17,7,298,322,10
FAM71F1,17,7,298,322,10
HOXB5,14,4,304,322,10
NFASC,14,4,304,322,10
TSPAN3,11,1,310,322,10
CSRP3,14,4,304,322,10
TSPAN13,14,4,304,322,10
KCNG1,14,4,304,322,10
TRPV3,10,0,312,322,10
TRRAP,10,0,312,322,10
C1orf198,11,1,310,322,10
C1orf159,13,3,306,322,10
ANKRD52,11,1,310,322,10
PIK3CB,14,4,304,322,10
STAG2,12,2,308,322,10
VPS25,11,1,310,322,10
PIGN,11,1,310,322,10
EZR,11,1,310,322,10
EHD1,12,2,308,322,10
VIRMA,12,2,308,322,10
CLCN6,12,2,308,322,10
ST8SIA5,13,3,306,322,10
PHLPP1,12,2,308,322,10
PHLDA3,13,3,306,322,10
C1D,11,1,310,322,10
ANKRD33B,10,0,312,322,10
SRSF3,11,1,310,322,10
VDAC1,11,1,310,322,10
PCDHB14,10,0,312,322,10
AJM1,15,5,302,322,10
PDIA6,13,3,306,322,10
HSD3B1,18,8,296,322,10
TTC17,11,1,310,322,10
SLC6A11,12,2,308,322,10
HSF1,11,1,310,322,10
UTS2R,11,1,310,322,10
NME2,12,2,308,322,10
TTC3,11,1,310,322,10
HSPA2,11,1,310,322,10
BEX4,12,2,308,322,10
EIF3A,10,0,312,322,10
USP19,13,3,306,322,10
PCSK7,14,4,304,322,10
SPTBN1,10,0,312,322,10
ERVW-1,10,0,312,322,10
ERP29,11,1,310,322,10
NOTUM,13,3,306,322,10
HTT,19,9,294,322,10
UNCX,10,0,312,322,10
HYAL4,16,6,300,322,10
NLRP6,10,0,312,322,10
SLC51A,27,17,278,322,10
CLSTN1,10,0,312,322,10
EIF4A3,12,2,308,322,10
SRRM2,12,2,308,322,10
CSF1R,19,9,294,322,10
CLIP3,16,6,300,322,10
AHCYL2,11,1,310,322,10
EIF3F,12,2,308,322,10
VAT1,14,4,304,322,10
HRG,10,0,312,322,10
ETV4,18,8,296,322,10
PEBP4,27,17,278,322,10
PDZRN3,13,3,306,322,10
NKIRAS2,11,1,310,322,10
SLC44A3,16,6,300,322,10
CS,11,1,310,322,10
CRYZ,12,2,308,322,10
HSD17B14,25,15,282,322,10
CLPTM1,13,3,306,322,10
VANGL2,11,1,310,322,10
AIDA,10,0,312,322,10
EIF4A2,13,3,306,322,10
KLK9,13,3,306,322,10
OCIAD1,12,2,308,322,10
ARID4B,10,0,312,322,10
MAPRE2,12,2,308,322,10
RETSAT,10,0,312,322,10
GJC1,10,0,312,322,10
DDIT3,19,9,294,322,10
MLLT1,12,2,308,322,10
CDH17,11,1,310,322,10
ACKR4,18,8,296,322,10
AQP12B,11,1,310,322,10
PTX4,14,4,304,322,10
CAPNS2,16,6,300,322,10
CCDC117,11,1,310,322,10
FBXO44,11,1,310,322,10
CAPNS1,13,3,306,322,10
TBC1D9B,11,1,310,322,10
TNIK,17,7,298,322,10
MAPK11,11,1,310,322,10
DPYSL5,12,2,308,322,10
ZNF33B,12,2,308,322,10
THAP3,13,3,306,322,10
TGM7,10,0,312,322,10
ZNF367,11,1,310,322,10
GAB1,12,2,308,322,10
MARK3,12,2,308,322,10
MARCKSL1,11,1,310,322,10
RDH8,13,3,306,322,10
DPY30,12,2,308,322,10
MARCHF6,12,2,308,322,10
PYGO2,10,0,312,322,10
DPYSL2,12,2,308,322,10
TMEM200C,10,0,312,322,10
ATOX1,17,7,298,322,10
S100PBP,11,1,310,322,10
MKS1,11,1,310,322,10
LRRC14,11,1,310,322,10
RPRD1A,12,2,308,322,10
CCDC124,13,3,306,322,10
DCUN1D3,13,3,306,322,10
SBK1,19,9,294,322,10
LAMTOR2,13,3,306,322,10
RGS22,36,26,260,322,10
THYN1,11,1,310,322,10
DHX8,12,2,308,322,10
PTCH2,16,6,300,322,10
LRRD1,13,3,306,322,10
MAP1LC3A,20,10,292,322,10
DIDO1,13,3,306,322,10
TIMELESS,10,0,312,322,10
LAIR2,21,11,290,322,10
MOSMO,12,2,308,322,10
MOXD1,11,1,310,322,10
APOF,12,2,308,322,10
SAV1,11,1,310,322,10
LRRFIP2,12,2,308,322,10
RHOA,11,1,310,322,10
GNB1,12,2,308,322,10
SARM1,15,5,302,322,10
ATP1B3,11,1,310,322,10
MON1B,11,1,310,322,10
APP,11,1,310,322,10
TNNI3,39,29,254,322,10
DCTN6,12,2,308,322,10
CDIP1,15,5,302,322,10
TBC1D3F,13,3,306,322,10
FBXO27,15,5,302,322,10
MAPK1,12,2,308,322,10
LRRC69,18,8,296,322,10
GMIP,13,3,306,322,10
TBC1D30,10,0,312,322,10
SAP18,12,2,308,322,10
RGS11,11,1,310,322,10
RPL39L,14,4,304,322,10
MOK,12,2,308,322,10
MAP2K2,15,5,302,322,10
ATN1,11,1,310,322,10
GAB2,11,1,310,322,10
GH2,14,4,304,322,10
RPS9,13,3,306,322,10
ABITRAM,11,1,310,322,10
TMEM253,21,11,290,322,10
RPS6KB1,11,1,310,322,10
RASL10B,14,4,304,322,10
MERTK,11,1,310,322,10
RAC3,13,3,306,322,10
LGALS9C,20,10,292,322,10
ABI3,13,3,306,322,10
ASTN2,12,2,308,322,10
METTL26,16,6,300,322,10
METTL3,12,2,308,322,10
TMEM8B,11,1,310,322,10
CD81,13,3,306,322,10
LMOD2,10,0,312,322,10
TMEM98,12,2,308,322,10
MEIS3,13,3,306,322,10
DNMT1,14,4,304,322,10
GABARAP,14,4,304,322,10
RAD9A,13,3,306,322,10
FGF1,14,4,304,322,10
LITAF,16,6,300,322,10
RANGRF,12,2,308,322,10
FGD4,10,0,312,322,10
RAP2A,10,0,312,322,10
GBA,11,1,310,322,10
TERF2IP,11,1,310,322,10
GBF1,15,5,302,322,10
RANBP10,11,1,310,322,10
TEPSIN,14,4,304,322,10
ZNF490,11,1,310,322,10
ABL1,11,1,310,322,10
RSKR,11,1,310,322,10
RPSA,12,2,308,322,10
TECR,11,1,310,322,10
DEF8,16,6,300,322,10
GAREM2,13,3,306,322,10
GFI1B,12,2,308,322,10
MCOLN1,12,2,308,322,10
LDHAL6B,16,6,300,322,10
LRCH4,14,4,304,322,10
MBD3L2,13,3,306,322,10
MBD3,12,2,308,322,10
FCMR,14,4,304,322,10
ATM,15,5,302,322,10
GGT7,18,8,296,322,10
CCAR1,11,1,310,322,10
ZNF385C,18,8,296,322,10
MINK1,11,1,310,322,10
LCNL1,14,4,304,322,10
CDC42EP3,14,4,304,322,10
RPS13,14,4,304,322,10
TGM2,12,2,308,322,10
GABARAPL1,11,1,310,322,10
ABHD14A,19,9,294,322,10
ZNF408,12,2,308,322,10
RUNX3,14,4,304,322,10
MGAT1,11,1,310,322,10
CBX5,10,0,312,322,10
DDX6,10,0,312,322,10
TFAM,10,0,312,322,10
RAB5B,12,2,308,322,10
GALNT8,16,6,300,322,10
ARHGEF11,10,0,312,322,10
TMPRSS11B,11,1,310,322,10
ARF4,11,1,310,322,10
ASMT,15,5,302,322,10
KLRC2,24,14,284,322,10
ATG4A,14,4,304,322,10
TMTC2,10,0,312,322,10
ASIC4,13,3,306,322,10
LDLRAD3,11,1,310,322,10
DIP2B,10,0,312,322,10
FGD6,11,1,310,322,10
RP9,14,4,304,322,10
TMEM123,10,0,312,322,10
ACTN2,12,2,308,322,10
ARL6,16,6,300,322,10
SDHD,13,3,306,322,10
TMEM120A,11,1,310,322,10
ZDHHC3,10,0,312,322,10
CALM2,11,1,310,322,10
TPM2,11,1,310,322,10
PSAT1,12,2,308,322,10
ZDHHC11B,12,2,308,322,10
RNF122,11,1,310,322,10
APOBEC3A,20,10,292,322,10
PSG4,21,11,290,322,10
ZCCHC14,12,2,308,322,10
DLL4,21,11,290,322,10
DNAAF4,12,2,308,322,10
CDYL,10,0,312,322,10
MRPS24,14,4,304,322,10
DUSP8,10,0,312,322,10
SCGB1C1,15,5,302,322,10
KRT86,12,2,308,322,10
GOLPH3L,11,1,310,322,10
FOXP2,15,5,302,322,10
CEMIP2,11,1,310,322,10
CCDC169-SOHLH2,14,4,304,322,10
MRPL19,15,5,302,322,10
AATF,10,0,312,322,10
SCGN,12,2,308,322,10
SDHC,12,2,308,322,10
MRPL52,13,3,306,322,10
ATP6V0C,12,2,308,322,10
ATP6V0B,12,2,308,322,10
ARL17B,13,3,306,322,10
SCRN1,13,3,306,322,10
PRRG2,14,4,304,322,10
KREMEN2,11,1,310,322,10
FOXM1,12,2,308,322,10
CCDC73,13,3,306,322,10
DUSP13,20,10,292,322,10
RNASEK-C17orf49,35,25,262,322,10
GPAA1,12,2,308,322,10
PRRG4,11,1,310,322,10
ZNF799,16,6,300,322,10
MACF1,11,1,310,322,10
ATP6V1G2-DDX39B,35,25,262,322,10
PRRT1,16,6,300,322,10
APLP2,11,1,310,322,10
ARPC2,12,2,308,322,10
RNPS1,12,2,308,322,10
TAF7L,11,1,310,322,10
PRRT4,13,3,306,322,10
ROBO1,12,2,308,322,10
TPD52L2,14,4,304,322,10
PSMB1,11,1,310,322,10
TM7SF3,11,1,310,322,10
ZFHX4,10,0,312,322,10
KPNA1,10,0,312,322,10
SDCBP,10,0,312,322,10
ZNF724,14,4,304,322,10
PROX2,21,11,290,322,10
RNF213,10,0,312,322,10
ZIC2,14,4,304,322,10
DCAF5,11,1,310,322,10
CCDC97,13,3,306,322,10
SEC14L1,11,1,310,322,10
GPR162,17,7,298,322,10
TMCC2,10,0,312,322,10
RPL18,12,2,308,322,10
GPX1,16,6,300,322,10
ZNF707,14,4,304,322,10
LRRTM4,14,4,304,322,10
RNF8,15,5,302,322,10
ZSCAN5B,14,4,304,322,10
MAIP1,13,3,306,322,10
ACSF2,14,4,304,322,10
ZFHX3,10,0,312,322,10
RNF44,11,1,310,322,10
MSX2,12,2,308,322,10
PRG3,12,2,308,322,10
ABCB8,16,6,300,322,10
FOXC2,19,9,294,322,10
PRRC2C,11,1,310,322,10
ZC3H7B,11,1,310,322,10
ZSCAN29,11,1,310,322,10
FAT1,12,2,308,322,10
APOBEC3D,12,2,308,322,10
MRE11,11,1,310,322,10
TARM1,17,7,298,322,10
LZTFL1,13,3,306,322,10
FAM98A,15,5,302,322,10
PRKCSH,12,2,308,322,10
MSRA,13,3,306,322,10
TOMM6,13,3,306,322,10
ATP5MC2,12,2,308,322,10
KMT2C,11,1,310,322,10
LYPLA2,13,3,306,322,10
KRTAP5-8,11,1,310,322,10
CCDC65,25,15,282,322,10
ARL4C,11,1,310,322,10
SCARB1,11,1,310,322,10
TMEM127,11,1,310,322,10
TJAP1,12,2,308,322,10
TPPP2,15,5,302,322,10
TFCP2,10,1,311,322,9
ILF2,11,2,309,322,9
ASPHD1,13,4,305,322,9
NUP93,13,4,305,322,9
SOX3,10,1,311,322,9
LYZL6,12,3,307,322,9
MCF2L,12,3,307,322,9
DLGAP4,12,3,307,322,9
ASIP,27,18,277,322,9
MAML1,10,1,311,322,9
DENND6B,12,3,307,322,9
NOS1AP,13,4,305,322,9
COX5A,12,3,307,322,9
ANKMY2,16,7,299,322,9
IL4I1,26,17,279,322,9
BET1,15,6,301,322,9
COX4I1,10,1,311,322,9
LMNB2,11,2,309,322,9
NXPH4,10,1,311,322,9
DMRT1,10,1,311,322,9
LMLN,9,0,313,322,9
TMEM259,11,2,309,322,9
ARHGAP35,10,1,311,322,9
SOD1,12,3,307,322,9
NLK,11,2,309,322,9
TMEM33,10,1,311,322,9
SOCS7,9,0,313,322,9
TMED3,9,0,313,322,9
MDFI,19,10,293,322,9
NUTM2D,17,8,297,322,9
TTC39A,11,2,309,322,9
DNER,10,1,311,322,9
BPGM,11,2,309,322,9
DENND5A,11,2,309,322,9
EIF5B,10,1,311,322,9
IL7R,20,11,291,322,9
SPTBN2,11,2,309,322,9
MCOLN2,10,1,311,322,9
NMNAT3,12,3,307,322,9
IL6,25,16,281,322,9
LMTK2,9,0,313,322,9
TTC33,9,0,313,322,9
MDC1,10,1,311,322,9
NPAS2,15,6,301,322,9
NMRK1,10,1,311,322,9
BEX2,18,9,295,322,9
MARS1,16,7,299,322,9
TLX2,13,4,305,322,9
DIS3L2,11,2,309,322,9
THUMPD3,13,4,305,322,9
DHX34,15,6,301,322,9
ASAP2,9,0,313,322,9
MED13,9,0,313,322,9
ASB1,11,2,309,322,9
NR2F2,10,1,311,322,9
TJP2,11,2,309,322,9
ARID2,11,2,309,322,9
TUBA1A,15,6,301,322,9
IQCN,27,18,277,322,9
TUBD1,10,1,311,322,9
ASB6,11,2,309,322,9
TKTL1,16,7,299,322,9
DHRS4,10,1,311,322,9
THAP11,10,1,311,322,9
IRF2BP2,9,0,313,322,9
TLE3,12,3,307,322,9
BMERB1,22,13,287,322,9
DHX40,11,2,309,322,9
ARHGEF12,9,0,313,322,9
LSM4,12,3,307,322,9
TUBB8,15,6,301,322,9
CPSF4L,20,11,291,322,9
IPO13,11,2,309,322,9
TMEM14A,11,2,309,322,9
NSG1,12,3,307,322,9
SPCS2,12,3,307,322,9
NRSN1,13,4,305,322,9
SPATA45,51,42,229,322,9
TUBB,10,1,311,322,9
CPOX,10,1,311,322,9
MAGI3,9,0,313,322,9
BMP1,9,0,313,322,9
INTS3,11,2,309,322,9
MAP2,13,4,305,322,9
INTS1,12,3,307,322,9
MAGEH1,12,3,307,322,9
SPDYE4,32,23,267,322,9
CPNE3,13,4,305,322,9
NQO1,11,2,309,322,9
MAPK1IP1L,10,1,311,322,9
SPG7,10,1,311,322,9
SPIRE1,12,3,307,322,9
SPO11,11,2,309,322,9
NPEPPS,11,2,309,322,9
NUDT1,12,3,307,322,9
TMEM108,9,0,313,322,9
CPE,13,4,305,322,9
LUZP1,9,0,313,322,9
TMEM219,11,2,309,322,9
NPC2,13,4,305,322,9
MATR3,11,2,309,322,9
SP9,13,4,305,322,9
MBD5,10,1,311,322,9
ASIC1,11,2,309,322,9
TFE3,11,2,309,322,9
DERPC,17,8,297,322,9
DERL3,15,6,301,322,9
NPB,17,8,297,322,9
ANKDD1A,13,4,305,322,9
MARK2,10,1,311,322,9
ARPP19,9,0,313,322,9
ARID1B,11,2,309,322,9
ASCC1,15,6,301,322,9
TLN1,10,1,311,322,9
TUG1,10,1,311,322,9
TTLL5,11,2,309,322,9
LRRC43,11,2,309,322,9
MAPKAP1,12,3,307,322,9
THAP10,10,1,311,322,9
SPIC,10,1,311,322,9
SPINK4,27,18,277,322,9
AMZ2,10,1,311,322,9
EMC10,11,2,309,322,9
MARCHF2,12,3,307,322,9
CPHXL,9,0,313,322,9
SPIN3,11,2,309,322,9
SPANXA2,22,13,287,322,9
SPINK1,27,18,277,322,9
DVL2,10,1,311,322,9
MGST3,11,2,309,322,9
SRM,10,1,311,322,9
NAB1,11,2,309,322,9
MPIG6B,11,2,309,322,9
MPP4,11,2,309,322,9
NADK,10,1,311,322,9
NACC2,12,3,307,322,9
ATP5F1E,10,1,311,322,9
LACTBL1,9,0,313,322,9
ANXA6,13,4,305,322,9
TOGARAM1,10,1,311,322,9
NACC1,11,2,309,322,9
CXCL13,11,2,309,322,9
BABAM1,14,5,303,322,9
DCAF4L2,9,0,313,322,9
STX12,11,2,309,322,9
SULT2B1,9,0,313,322,9
MPRIP,10,1,311,322,9
NAA50,9,0,313,322,9
CXCL6,11,2,309,322,9
EDC4,11,2,309,322,9
TOMM20L,47,38,237,322,9
MPV17,10,1,311,322,9
STYXL1,11,2,309,322,9
KIAA0895L,13,4,305,322,9
KIAA0930,13,4,305,322,9
TOP1,10,1,311,322,9
TOP1MT,10,1,311,322,9
KIAA1522,11,2,309,322,9
DSTN,10,1,311,322,9
ANXA5,11,2,309,322,9
NAIP,11,2,309,322,9
STRN3,10,1,311,322,9
NBPF9,10,1,311,322,9
DRG2,12,3,307,322,9
KCTD2,10,1,311,322,9
DRICH1,18,9,295,322,9
LAPTM4B,10,1,311,322,9
ATP2B4,13,4,305,322,9
NBPF12,11,2,309,322,9
TNRC6B,12,3,307,322,9
KDM1A,10,1,311,322,9
NASP,11,2,309,322,9
DCLK1,10,1,311,322,9
KDM3A,13,4,305,322,9
NARF,10,1,311,322,9
MON2,10,1,311,322,9
MORC4,13,4,305,322,9
LAMA1,11,2,309,322,9
LALBA,12,3,307,322,9
BAG6,10,1,311,322,9
CUTA,13,4,305,322,9
KDM3B,10,1,311,322,9
DCDC1,14,5,303,322,9
EDRF1,11,2,309,322,9
STRAP,10,1,311,322,9
BAG1,11,2,309,322,9
CWC27,10,1,311,322,9
SULT2A1,11,2,309,322,9
KRT85,9,0,313,322,9
MED13L,9,0,313,322,9
MSN,10,1,311,322,9
ATP6V1G1,11,2,309,322,9
ATXN7L1,11,2,309,322,9
TRAPPC3,11,2,309,322,9
KLHDC3,10,1,311,322,9
KLHL18,11,2,309,322,9
MTPN,10,1,311,322,9
MSI2,11,2,309,322,9
TPM3,11,2,309,322,9
ATP6V1H,11,2,309,322,9
DYNLL1,14,5,303,322,9
MTCH1,10,1,311,322,9
TRAF2,14,5,303,322,9
TAF13,11,2,309,322,9
TRIM10,9,0,313,322,9
MTA2,10,1,311,322,9
KLHL33,10,1,311,322,9
MT4,10,1,311,322,9
DYNC1H1,11,2,309,322,9
CYP7A1,10,1,311,322,9
APBA3,15,6,301,322,9
ATP9A,10,1,311,322,9
TADA2B,11,2,309,322,9
MT-ND4L,15,6,301,322,9
MT-ND4,15,6,301,322,9
TAF1,9,0,313,322,9
MT-ND3,14,5,303,322,9
ATP6V1F,11,2,309,322,9
DACT3,11,2,309,322,9
SYT11,9,0,313,322,9
MS4A5,29,20,273,322,9
MRPL13,11,2,309,322,9
KRT33A,9,0,313,322,9
TP53BP1,13,4,305,322,9
ATP6V0A1,10,1,311,322,9
TRIB2,14,5,303,322,9
TP53INP2,11,2,309,322,9
ECHDC1,12,3,307,322,9
APLP1,12,3,307,322,9
CYBRD1,11,2,309,322,9
ECE2,12,3,307,322,9
SUPT7L,10,1,311,322,9
MRPS11,11,2,309,322,9
MVP,20,11,291,322,9
DUSP22,13,4,305,322,9
DAPK1,10,1,311,322,9
MUSK,10,1,311,322,9
KIF5C,10,1,311,322,9
ENAH,9,0,313,322,9
SWT1,16,7,299,322,9
ATP6V0E2,10,1,311,322,9
AVPI1,17,8,297,322,9
AP2M1,11,2,309,322,9
AUTS2,12,3,307,322,9
MTURN,11,2,309,322,9
KIRREL2,11,2,309,322,9
MMS22L,11,2,309,322,9
NBR1,11,2,309,322,9
LARP7,11,2,309,322,9
NFATC2,14,5,303,322,9
CSNK1G1,9,0,313,322,9
TDGF1,11,2,309,322,9
JOSD1,12,3,307,322,9
DPF2,10,1,311,322,9
TSPAN5,10,1,311,322,9
TMIGD3,21,12,289,322,9
LETM2,11,2,309,322,9
NFE2L1,11,2,309,322,9
MFN2,10,1,311,322,9
SSR2,12,3,307,322,9
BCL2L1,11,2,309,322,9
ATG16L1,12,3,307,322,9
MFSD1,14,5,303,322,9
MMRN2,12,3,307,322,9
CSRNP3,13,4,305,322,9
TCTN1,13,4,305,322,9
TCTEX1D1,12,3,307,322,9
LEMD1,12,3,307,322,9
MGAT5,9,0,313,322,9
ARFGAP1,11,2,309,322,9
SSU72P4,19,10,293,322,9
ANKRD34A,9,0,313,322,9
NEUROG2,12,3,307,322,9
TSNAX-DISC1,11,2,309,322,9
NEURL1,23,14,285,322,9
ST8SIA6,15,6,301,322,9
TSPEAR,10,1,311,322,9
NFKBIL1,13,4,305,322,9
METTL9,12,3,307,322,9
NFYC,11,2,309,322,9
TTBK2,9,0,313,322,9
MED24,11,2,309,322,9
ANKRD17,9,0,313,322,9
EIF3H,9,0,313,322,9
LIMS3,12,3,307,322,9
SRPK2,11,2,309,322,9
SRPK3,13,4,305,322,9
TEN1,16,7,299,322,9
TMEM63B,11,2,309,322,9
LHB,38,29,255,322,9
MEGF9,9,0,313,322,9
MEIS2,10,1,311,322,9
TSSC4,15,6,301,322,9
ANKRD2,13,4,305,322,9
BCOR,13,4,305,322,9
MEMO1,9,0,313,322,9
JADE1,10,1,311,322,9
LGR4,10,1,311,322,9
SRRT,11,2,309,322,9
SRSF1,11,2,309,322,9
METTL17,11,2,309,322,9
NHLRC4,12,3,307,322,9
DEFB103A,22,13,287,322,9
NGRN,11,2,309,322,9
METTL5,12,3,307,322,9
NES,11,2,309,322,9
KANSL3,10,1,311,322,9
ANKRD40CL,19,10,293,322,9
NDUFA3,11,2,309,322,9
DDR2,10,1,311,322,9
ANKRD7,22,13,287,322,9
DDR1,14,5,303,322,9
KCNH5,10,1,311,322,9
NDUFA12,14,5,303,322,9
DDN,17,8,297,322,9
RNF4,10,1,311,322,9
NDST4,10,1,311,322,9
NDST1,10,1,311,322,9
TBPL1,13,4,305,322,9
CTNNB1,11,2,309,322,9
MLN,18,9,295,322,9
TBL3,10,1,311,322,9
TBL1XR1,12,3,307,322,9
DDAH2,13,4,305,322,9
ANLN,10,1,311,322,9
STK19,13,4,305,322,9
EFCAB9,20,11,291,322,9
TNK1,24,15,283,322,9
KCNN3,9,0,313,322,9
NCK1,12,3,307,322,9
NCBP3,11,2,309,322,9
CTSS,12,3,307,322,9
DCTN4,9,0,313,322,9
ATP2A2,11,2,309,322,9
MLF2,11,2,309,322,9
NDUFAB1,10,1,311,322,9
KAT2A,10,1,311,322,9
STAT3,11,2,309,322,9
NELFA,11,2,309,322,9
TCEAL3,12,3,307,322,9
NEK9,10,1,311,322,9
KAT6B,11,2,309,322,9
MICU1,11,2,309,322,9
CT45A5,23,14,285,322,9
BCAP29,10,1,311,322,9
NEFM,10,1,311,322,9
TSC22D2,11,2,309,322,9
TSC2,12,3,307,322,9
TSC1,11,2,309,322,9
NEDD4L,14,5,303,322,9
EGLN2,14,5,303,322,9
BBS5,14,5,303,322,9
STARD3NL,11,2,309,322,9
STARD5,12,3,307,322,9
NEB,16,7,299,322,9
NDUFV1,11,2,309,322,9
TCEA3,15,6,301,322,9
NDUFS7,12,3,307,322,9
NDUFS5,11,2,309,322,9
NDUFS4,14,5,303,322,9
KBTBD4,10,1,311,322,9
DDX17,11,2,309,322,9
KCND3,12,3,307,322,9
SMIM30,12,3,307,322,9
ARMCX3,10,1,311,322,9
RPS17,14,5,303,322,9
ZNF446,10,1,311,322,9
FAM180A,15,6,301,322,9
SFSWAP,9,0,313,322,9
WTAP,12,3,307,322,9
GBA2,11,2,309,322,9
POMZP3,13,4,305,322,9
CD300LB,11,2,309,322,9
RAP1GDS1,10,1,311,322,9
SFXN5,10,1,311,322,9
RRAGD,10,1,311,322,9
POMK,10,1,311,322,9
H2BC18,18,9,295,322,9
H2BC8,14,5,303,322,9
RAPH1,12,3,307,322,9
WFDC11,20,11,291,322,9
RPUSD4,9,0,313,322,9
ABL2,9,0,313,322,9
H3C12,23,14,285,322,9
SGSM1,10,1,311,322,9
SGTA,11,2,309,322,9
H4C14,29,20,273,322,9
PNRC1,12,3,307,322,9
RASGEF1B,15,6,301,322,9
RASGRP3,16,7,299,322,9
SH2B1,11,2,309,322,9
SH2D6,11,2,309,322,9
PNPLA1,10,1,311,322,9
CBR1,11,2,309,322,9
C3orf20,11,2,309,322,9
SH3BGRL,11,2,309,322,9
WWC1,9,0,313,322,9
XPO1,11,2,309,322,9
RRP12,13,4,305,322,9
PPM1G,10,1,311,322,9
SERF2,13,4,305,322,9
ZNF451,9,0,313,322,9
YTHDF3,10,1,311,322,9
RAC1,10,1,311,322,9
GTF2E2,10,1,311,322,9
FETUB,12,3,307,322,9
SERPINB10,12,3,307,322,9
PPP1CB,12,3,307,322,9
GTF2IRD2,24,15,283,322,9
RAD51C,11,2,309,322,9
GTF3C1,10,1,311,322,9
RSL24D1,10,1,311,322,9
ZNF460,10,1,311,322,9
CFB,27,18,277,322,9
RANBP3L,11,2,309,322,9
GCM1,10,1,311,322,9
GUCA1A,13,4,305,322,9
YKT6,11,2,309,322,9
YJEFN3,11,2,309,322,9
RRP8,9,0,313,322,9
YIPF4,11,2,309,322,9
SET,12,3,307,322,9
CFL1,11,2,309,322,9
GXYLT2,11,2,309,322,9
YEATS2,11,2,309,322,9
FAM193A,9,0,313,322,9
FGD1,10,1,311,322,9
FAM187B,11,2,309,322,9
ADIPOR2,9,0,313,322,9
CHMP5,10,1,311,322,9
PNKP,24,15,283,322,9
SLC11A2,12,3,307,322,9
GALNT16,10,1,311,322,9
PLD5P1,14,5,303,322,9
C20orf202,10,1,311,322,9
HDAC5,12,3,307,322,9
GALC,11,2,309,322,9
HDGF,10,1,311,322,9
ADRB2,11,2,309,322,9
PLAG1,14,5,303,322,9
HECTD4,11,2,309,322,9
HELZ,10,1,311,322,9
CIB1,11,2,309,322,9
RBM38,12,3,307,322,9
GAGE13,25,16,281,322,9
SLC12A6,9,0,313,322,9
CCT7,12,3,307,322,9
FHIT,23,14,285,322,9
PKN2,10,1,311,322,9
RBMS2,10,1,311,322,9
FAF2,9,0,313,322,9
ZNF577,12,3,307,322,9
PJVK,12,3,307,322,9
RBP4,14,5,303,322,9
HHEX,14,5,303,322,9
VPS51,12,3,307,322,9
RBPMS,12,3,307,322,9
GABARAPL2,11,2,309,322,9
AGAP1,10,1,311,322,9
SLC22A7,10,1,311,322,9
PLEKHA3,10,1,311,322,9
ABHD16A,10,1,311,322,9
CHMP7,12,3,307,322,9
HBEGF,14,5,303,322,9
PNISR,10,1,311,322,9
SH3BP5L,10,1,311,322,9
C2orf81,25,16,281,322,9
RPS5,11,2,309,322,9
WDR26,10,1,311,322,9
WDR13,12,3,307,322,9
CHRDL2,18,9,295,322,9
PLXNB1,9,0,313,322,9
WDPCP,11,2,309,322,9
WDCP,13,4,305,322,9
RPS3,11,2,309,322,9
WBP1,15,6,301,322,9
RB1CC1,9,0,313,322,9
PLPBP,13,4,305,322,9
PLEKHM1,14,5,303,322,9
WASHC2A,9,0,313,322,9
RPS21,14,5,303,322,9
ABHD5,12,3,307,322,9
ABHD4,22,13,287,322,9
ZNF529,11,2,309,322,9
CHRNE,13,4,305,322,9
FAM120A,10,1,311,322,9
RBM14,10,1,311,322,9
PLEKHO2,12,3,307,322,9
PLEKHO1,10,1,311,322,9
PLEKHM3,9,0,313,322,9
RBM15,11,2,309,322,9
ZNF534,12,3,307,322,9
SEPTIN7,12,3,307,322,9
GSTO2,10,1,311,322,9
VPS35L,10,1,311,322,9
GSTM5,21,12,289,322,9
ACIN1,10,1,311,322,9
FBXW7,13,4,305,322,9
SCAF4,10,1,311,322,9
GNMT,17,8,297,322,9
PYGB,10,1,311,322,9
SCAMP5,16,7,299,322,9
FAU,11,2,309,322,9
CALR3,19,10,293,322,9
GIGYF1,10,1,311,322,9
GOLGA6L22,33,24,265,322,9
ZHX1-C8orf76,17,8,297,322,9
S100A7A,10,1,311,322,9
PSMB5,11,2,309,322,9
ZNF347,15,6,301,322,9
ZGLP1,14,5,303,322,9
GOLPH3,11,2,309,322,9
ZNF37A,9,0,313,322,9
PRXL2A,9,0,313,322,9
GP5,9,0,313,322,9
PRUNE1,10,1,311,322,9
GP9,12,3,307,322,9
PRTN3,18,9,295,322,9
ZFR,9,0,313,322,9
CECR2,9,0,313,322,9
GPANK1,9,0,313,322,9
GPAT3,10,1,311,322,9
FANCG,12,3,307,322,9
SCRIB,10,1,311,322,9
QSOX1,10,1,311,322,9
SBK3,26,17,279,322,9
GJA1,12,3,307,322,9
PSPC1,10,1,311,322,9
CDH2,11,2,309,322,9
GLRA2,11,2,309,322,9
GLUL,11,2,309,322,9
PTPN4,15,6,301,322,9
ZNF225,11,2,309,322,9
GLYCTK,11,2,309,322,9
ACOT7,10,1,311,322,9
PTP4A2,11,2,309,322,9
ZNF263,10,1,311,322,9
GMFG,19,10,293,322,9
FBXO11,12,3,307,322,9
CDK17,11,2,309,322,9
CAPN12,26,17,279,322,9
ZNF175,12,3,307,322,9
PUM1,11,2,309,322,9
SASH1,11,2,309,322,9
CANX,10,1,311,322,9
GNAS,12,3,307,322,9
CAPRIN2,9,0,313,322,9
SARNP,11,2,309,322,9
SARS1,10,1,311,322,9
SAE1,12,3,307,322,9
ACP1,12,3,307,322,9
ZNF320,11,2,309,322,9
PTCH1,12,3,307,322,9
PTBP3,11,2,309,322,9
S1PR3,9,0,313,322,9
CAMSAP1,10,1,311,322,9
CAMP,15,6,301,322,9
GPHB5,22,13,287,322,9
ACAP3,10,1,311,322,9
SCRT1,11,2,309,322,9
GDPD2,11,2,309,322,9
FAM47E-STBD1,28,19,275,322,9
GRIA1,10,1,311,322,9
GFOD2,10,1,311,322,9
ZNF433,20,11,291,322,9
RTEL1,12,3,307,322,9
PPP6R1,11,2,309,322,9
ZBTB18,11,2,309,322,9
SELENBP1,19,10,293,322,9
PPP3CB,10,1,311,322,9
RAB7A,11,2,309,322,9
RABAC1,16,7,299,322,9
CERS2,10,1,311,322,9
CASP9,11,2,309,322,9
CERT1,11,2,309,322,9
SEC61G,11,2,309,322,9
ADAMTS13,13,4,305,322,9
CA6,13,4,305,322,9
ZBED8,9,0,313,322,9
PPP1R9B,11,2,309,322,9
SEMA3A,14,5,303,322,9
ZBED6,10,1,311,322,9
CD80,16,7,299,322,9
GRN,11,2,309,322,9
ODAPH,14,5,303,322,9
GSE1,14,5,303,322,9
CFAP20,11,2,309,322,9
SEPHS1,9,0,313,322,9
FERMT2,16,7,299,322,9
CD99,11,2,309,322,9
PRDM10,10,1,311,322,9
GPM6A,14,5,303,322,9
RTRAF,11,2,309,322,9
CDC27,11,2,309,322,9
GPR132,12,3,307,322,9
ZNF410,10,1,311,322,9
GPR137,12,3,307,322,9
GFUS,13,4,305,322,9
PROM2,10,1,311,322,9
GFRA4,11,2,309,322,9
ZFAND6,11,2,309,322,9
ACTR8,10,1,311,322,9
GPR4,11,2,309,322,9
FAM89B,13,4,305,322,9
RAB39B,9,0,313,322,9
PRKDC,10,1,311,322,9
PRKCZ,20,11,291,322,9
FAM53B,9,0,313,322,9
RTN4,11,2,309,322,9
ZC3HAV1,10,1,311,322,9
ZNF420,17,8,297,322,9
FAM78A,13,4,305,322,9
ZC3H13,9,0,313,322,9
GPX4,13,4,305,322,9
ADAM15,11,2,309,322,9
CASP6,11,2,309,322,9
RTF2,11,2,309,322,9
ADAM17,11,2,309,322,9
SEC61A1,11,2,309,322,9
PRDM4,11,2,309,322,9
ZBTB43,11,2,309,322,9
C1orf127,9,0,313,322,9
ZNF235,12,3,307,322,9
RCN1,10,1,311,322,9
CCL17,14,5,303,322,9
USP17L3,9,0,313,322,9
AKAP12,9,0,313,322,9
SMAD4,10,1,311,322,9
PCP2,36,27,259,322,9
RPL34,13,4,305,322,9
RPL29,14,5,303,322,9
RNF11,10,1,311,322,9
USF3,9,0,313,322,9
SMARCA2,19,10,293,322,9
FOXK2,11,2,309,322,9
UPK3B,13,4,305,322,9
RPL23A,10,1,311,322,9
ETFDH,13,4,305,322,9
PCDHGA3,10,1,311,322,9
IGLV4-3,15,6,301,322,9
RPAIN,10,1,311,322,9
ULK2,9,0,313,322,9
BUD31,11,2,309,322,9
C1orf116,11,2,309,322,9
RPL22,11,2,309,322,9
CNN3,10,1,311,322,9
CNOT1,10,1,311,322,9
RHOF,10,1,311,322,9
ALLC,9,0,313,322,9
PCYT1A,10,1,311,322,9
RNF123,14,5,303,322,9
FOXK1,9,0,313,322,9
CCL21,14,5,303,322,9
VAMP7,10,1,311,322,9
CLSTN3,11,2,309,322,9
RGP1,10,1,311,322,9
CLTA,11,2,309,322,9
FUBP1,11,2,309,322,9
HSD3B7,14,5,303,322,9
CCDC136,14,5,303,322,9
FTSJ3,10,1,311,322,9
OVOL1,12,3,307,322,9
CCDC138,14,5,303,322,9
FLACC1,27,18,277,322,9
ESX1,10,1,311,322,9
IL12B,12,3,307,322,9
USP5,12,3,307,322,9
CMA1,11,2,309,322,9
ABCC11,11,2,309,322,9
FOXJ3,11,2,309,322,9
IGSF9B,10,1,311,322,9
SLC9A6,13,4,305,322,9
RPL35,11,2,309,322,9
PDC,12,3,307,322,9
UBE2E1,11,2,309,322,9
ALOX15,14,5,303,322,9
AKTIP,13,4,305,322,9
OR8S1,10,1,311,322,9
ICOSLG,11,2,309,322,9
UBE2V1,11,2,309,322,9
PAFAH1B3,12,3,307,322,9
UBR4,10,1,311,322,9
PAFAH1B1,11,2,309,322,9
EPHA6,12,3,307,322,9
FPR1,14,5,303,322,9
COBLL1,14,5,303,322,9
FMC1,11,2,309,322,9
UBR2,10,1,311,322,9
RIOK3,10,1,311,322,9
IGDCC3,12,3,307,322,9
P4HB,10,1,311,322,9
COL10A1,21,12,289,322,9
UBQLN1,11,2,309,322,9
EPN1,11,2,309,322,9
COL14A1,12,3,307,322,9
UBL7,14,5,303,322,9
RIPOR1,10,1,311,322,9
UBE2Z,10,1,311,322,9
UBE3B,9,0,313,322,9
P2RY1,9,0,313,322,9
BTBD7,11,2,309,322,9
RIPOR2,13,4,305,322,9
FOXO3,11,2,309,322,9
RNASE7,12,3,307,322,9
BTN2A1,12,3,307,322,9
RPL19,12,3,307,322,9
IFITM3,12,3,307,322,9
SNRNP27,12,3,307,322,9
SMCHD1,9,0,313,322,9
IDH1,11,2,309,322,9
PATL2,21,12,289,322,9
ZNF717,14,5,303,322,9
PATL1,10,1,311,322,9
IDH3G,12,3,307,322,9
UFC1,10,1,311,322,9
RNASEK,14,5,303,322,9
SNCAIP,22,13,287,322,9
CNR1,11,2,309,322,9
RNASE8,10,1,311,322,9
IGHV3-35,24,15,283,322,9
CNTF,9,0,313,322,9
SMG5,10,1,311,322,9
CCDC90B,12,3,307,322,9
COL4A5,15,6,301,322,9
ERBB4,11,2,309,322,9
ALDH1L1,20,11,291,322,9
SMU1,9,0,313,322,9
UBR7,12,3,307,322,9
ALDH7A1,10,1,311,322,9
IFITM2,11,2,309,322,9
SLC4A3,12,3,307,322,9
C12orf54,18,9,295,322,9
FUBP3,11,2,309,322,9
RESP18,12,3,307,322,9
CLDN15,14,5,303,322,9
SLC25A31,11,2,309,322,9
ENO2,11,2,309,322,9
RPN2,11,2,309,322,9
HMCES,10,1,311,322,9
RERE,12,3,307,322,9
SNX19,9,0,313,322,9
SNX17,10,1,311,322,9
HMGN1,13,4,305,322,9
PHF24,12,3,307,322,9
HMGN3,10,1,311,322,9
ZNF669,11,2,309,322,9
AARS1,11,2,309,322,9
HNRNPH3,10,1,311,322,9
SNX16,9,0,313,322,9
HNRNPK,10,1,311,322,9
EXOC6B,10,1,311,322,9
HNRNPL,11,2,309,322,9
ETNK1,10,1,311,322,9
ABCC8,15,6,301,322,9
COPZ1,11,2,309,322,9
SNX14,10,1,311,322,9
RFC2,10,1,311,322,9
RPL9,12,3,307,322,9
CLDN14,14,5,303,322,9
BRD4,12,3,307,322,9
RPL7A,13,4,305,322,9
ZNF609,9,0,313,322,9
HIP1,10,1,311,322,9
PIK3R3,10,1,311,322,9
RPRD2,9,0,313,322,9
CORO2B,10,1,311,322,9
VPS11,13,4,305,322,9
RNF223,15,6,301,322,9
RNF214,9,0,313,322,9
CCDC107,15,6,301,322,9
HLA-C,13,4,305,322,9
ODF3L2,11,2,309,322,9
PIGL,11,2,309,322,9
OGDH,10,1,311,322,9
ZNF66,12,3,307,322,9
OGDHL,11,2,309,322,9
G6PD,11,2,309,322,9
EZH1,13,4,305,322,9
RNF208,19,10,293,322,9
CLCN7,10,1,311,322,9
RNF20,10,1,311,322,9
ZSCAN25,11,2,309,322,9
SLC25A11,10,1,311,322,9
EYA4,11,2,309,322,9
ENO1,13,4,305,322,9
PI3,22,13,287,322,9
SLC2A9,14,5,303,322,9
EXOC5,10,1,311,322,9
AHCY,11,2,309,322,9
OR10P1,12,3,307,322,9
OR11H2,11,2,309,322,9
RGCC,14,5,303,322,9
PEX2,13,4,305,322,9
EVL,13,4,305,322,9
EVI5L,13,4,305,322,9
OPN5,9,0,313,322,9
SLC39A14,13,4,305,322,9
SLC39A2,16,7,299,322,9
SLC3A1,12,3,307,322,9
SLC41A1,9,0,313,322,9
ETV3,9,0,313,322,9
RNPEP,10,1,311,322,9
RGL2,16,7,299,322,9
ETV2,20,11,291,322,9
VARS1,10,1,311,322,9
CCDC50,11,2,309,322,9
VAPB,10,1,311,322,9
HSBP1L1,11,2,309,322,9
OR13C5,11,2,309,322,9
IL17C,20,11,291,322,9
OR14A2,9,0,313,322,9
PDXDC1,11,2,309,322,9
CCDC54,9,0,313,322,9
SLC38A8,18,9,295,322,9
CCDC17,16,7,299,322,9
SLC36A4,12,3,307,322,9
UBA3,21,12,289,322,9
HOXB9,13,4,305,322,9
U2AF2,11,2,309,322,9
VEGFA,14,5,303,322,9
PGAM1,11,2,309,322,9
ABCC2,10,1,311,322,9
RPL7,11,2,309,322,9
PFKM,12,3,307,322,9
TYW1B,10,1,311,322,9
TNFSF12-TNFSF13,31,23,268,322,8
ACE,10,2,310,322,8
ARL6IP1,11,3,308,322,8
LDLRAD4,18,10,294,322,8
AATK,14,6,302,322,8
GGA2,10,2,310,322,8
GLG1,10,2,310,322,8
GIMAP8,8,0,314,322,8
LCN15,13,5,304,322,8
ZNF382,8,0,314,322,8
FOXN2,9,1,312,322,8
GJB3,11,3,308,322,8
LTBP1,12,4,306,322,8
GIN1,11,3,308,322,8
DPY19L2,11,3,308,322,8
DMRTA2,15,7,300,322,8
FCHO1,12,4,306,322,8
APRT,11,3,308,322,8
FMNL2,10,2,310,322,8
TMEM126B,11,3,308,322,8
FCGR1A,16,8,298,322,8
LDB1,9,1,312,322,8
FCHSD2,13,5,304,322,8
TMED5,8,0,314,322,8
TNC,14,6,302,322,8
LCLAT1,10,2,310,322,8
ZNF404,10,2,310,322,8
ZSCAN20,9,1,312,322,8
ZNF267,10,2,310,322,8
FCGBP,9,1,312,322,8
LDHB,11,3,308,322,8
TMEM106C,12,4,306,322,8
DRAM1,13,5,304,322,8
FBXO47,10,2,310,322,8
ARL8B,10,2,310,322,8
ZNF827,8,0,314,322,8
ARAP1,13,5,304,322,8
TNFSF13B,12,4,306,322,8
ZNF81,16,8,298,322,8
LY6E,11,3,308,322,8
TMEM88B,25,17,280,322,8
FMN2,11,3,308,322,8
TMSB15A,18,10,294,322,8
FUT8,10,2,310,322,8
ZNF670-ZNF695,9,1,312,322,8
ABI1,10,2,310,322,8
ZNF692,11,3,308,322,8
GART,10,2,310,322,8
ZNF518B,9,1,312,322,8
DNM1L,10,2,310,322,8
ABCC3,12,4,306,322,8
LRRC4C,9,1,312,322,8
LRRC56,9,1,312,322,8
FGF22,16,8,298,322,8
FUNDC2,10,2,310,322,8
DNAJB9,12,4,306,322,8
ARID3B,9,1,312,322,8
GATA3,10,2,310,322,8
FGF17,11,3,308,322,8
TMEM179,12,4,306,322,8
ABCC12,10,2,310,322,8
TMEM167A,8,0,314,322,8
LMAN2,10,2,310,322,8
ARHGAP31,9,1,312,322,8
TMEM231,9,1,312,322,8
FGFR3,13,5,304,322,8
TMEM184A,9,1,312,322,8
DNAL1,12,4,306,322,8
DNAJC3,10,2,310,322,8
TMEM221,11,3,308,322,8
GABRP,16,8,298,322,8
DNAJC5,10,2,310,322,8
ZNF581,13,5,304,322,8
TMEM225B,16,8,298,322,8
ZNF569,11,3,308,322,8
ARHGEF18,10,2,310,322,8
TMEM214,9,1,312,322,8
DNAL4,17,9,296,322,8
LBHD2,11,3,308,322,8
ZNF644,9,1,312,322,8
GAGE2A,27,19,276,322,8
ABCD4,12,4,306,322,8
GAGE2E,25,17,280,322,8
DNASE1L2,19,11,292,322,8
ZNF559,9,1,312,322,8
ZNF664,10,2,310,322,8
ARHGEF9,14,6,302,322,8
LRRC20,9,1,312,322,8
GATAD2A,11,3,308,322,8
GATD3A,15,7,300,322,8
LIPG,10,2,310,322,8
ZNF718,9,1,312,322,8
FLNC,9,1,312,322,8
ZNF704,12,4,306,322,8
GDNF,10,2,310,322,8
ARL2,12,4,306,322,8
GDPD1,9,1,312,322,8
ARL2-SNX15,36,28,258,322,8
LGALS14,16,8,298,322,8
GET4,10,2,310,322,8
ARGLU1,9,1,312,322,8
LSM14B,12,4,306,322,8
GDF11,9,1,312,322,8
ZNF771,11,3,308,322,8
FPR2,28,20,274,322,8
TMEM131,8,0,314,322,8
LSM6,11,3,308,322,8
FCSK,10,2,310,322,8
LETM1,9,1,312,322,8
TMEM130,11,3,308,322,8
ZNF419,14,6,302,322,8
ZNF418,16,8,298,322,8
GDI1,11,3,308,322,8
ARHGAP17,10,2,310,322,8
FTO,11,3,308,322,8
LRRC8C,10,2,310,322,8
ZNF493,11,3,308,322,8
LIMCH1,11,3,308,322,8
LILRB1,10,2,310,322,8
ABLIM3,8,0,314,322,8
TMEM51,9,1,312,322,8
TMEM59,9,1,312,322,8
GCC1,9,1,312,322,8
LHX2,16,8,298,322,8
ZNF480,10,2,310,322,8
GCN1,9,1,312,322,8
ABCC1,8,0,314,322,8
ZNF461,11,3,308,322,8
FSTL4,10,2,310,322,8
DNAI4,12,4,306,322,8
FSD2,9,1,312,322,8
GCSAML,9,1,312,322,8
DNAI2,9,1,312,322,8
FSD1,15,7,300,322,8
LGALS9B,20,12,290,322,8
LGALS9,15,7,300,322,8
AMOTL1,10,2,310,322,8
ZAR1,19,11,292,322,8
FBXO33,10,2,310,322,8
JOSD2,16,8,298,322,8
HOXA5,14,6,302,322,8
JAK3,10,2,310,322,8
ANKRD24,9,1,312,322,8
TSPAN8,12,4,306,322,8
HOXA1,8,0,314,322,8
VGLL2,8,0,314,322,8
TSPAN7,13,5,304,322,8
VDAC2,11,3,308,322,8
HOMER3,13,5,304,322,8
HNRNPUL2-BSCL2,17,9,296,322,8
HNRNPF,10,2,310,322,8
HNRNPDL,9,1,312,322,8
TSPAN17,12,4,306,322,8
HMGA1,10,2,310,322,8
EXD3,10,2,310,322,8
JAG1,15,7,300,322,8
HDAC3,9,1,312,322,8
EIF4B,11,3,308,322,8
ITGB1BP2,12,4,306,322,8
ITGB2,23,15,284,322,8
EIF4EBP2,9,1,312,322,8
ITGB8,10,2,310,322,8
ANKRD13A,9,1,312,322,8
HSD3B2,10,2,310,322,8
EIF4A1,11,3,308,322,8
VCPIP1,8,0,314,322,8
EIF3L,9,1,312,322,8
HSD17B11,9,1,312,322,8
AHSG,8,0,314,322,8
IYD,11,3,308,322,8
AHCYL1,10,2,310,322,8
EIF3B,10,2,310,322,8
HMBS,11,3,308,322,8
HMBOX1,10,2,310,322,8
HLX,12,4,306,322,8
TRPS1,9,1,312,322,8
KCNC4,8,0,314,322,8
HEY2,8,0,314,322,8
AFDN,14,6,302,322,8
HEXA,11,3,308,322,8
HES7,24,16,282,322,8
TRPT1,18,10,294,322,8
VTN,19,11,292,322,8
AGO1,10,2,310,322,8
HERC2,10,2,310,322,8
ANKRD9,9,1,312,322,8
HEPACAM,9,1,312,322,8
HEMK1,9,1,312,322,8
TRNP1,13,5,304,322,8
TRNAU1AP,10,2,310,322,8
FABP9,9,1,312,322,8
FABP7,19,11,292,322,8
VRTN,12,4,306,322,8
TSACC,28,20,274,322,8
VPS72,11,3,308,322,8
AFTPH,10,2,310,322,8
VPS4A,9,1,312,322,8
VPS35,11,3,308,322,8
HIPK2,8,0,314,322,8
AGBL5,12,4,306,322,8
EHBP1,11,3,308,322,8
KATNIP,11,3,308,322,8
KATNA1,8,0,314,322,8
HLA-F,15,7,300,322,8
EHHADH,8,0,314,322,8
EI24,11,3,308,322,8
EYA3,8,0,314,322,8
USP40,11,3,308,322,8
USP36,10,2,310,322,8
USP33,10,2,310,322,8
IGLV5-45,17,9,296,322,8
IL11,12,4,306,322,8
INO80C,11,3,308,322,8
INO80D,8,0,314,322,8
INPP4A,10,2,310,322,8
EMC3,9,1,312,322,8
INPP5E,23,15,284,322,8
IGLV1-51,28,20,274,322,8
UBL5,11,3,308,322,8
ALOX12,15,7,300,322,8
TUBG2,11,3,308,322,8
EPB41L3,14,6,302,322,8
ALKBH1,9,1,312,322,8
INTS11,10,2,310,322,8
INTS8,11,3,308,322,8
TULP3,10,2,310,322,8
IL17B,23,15,284,322,8
TULP4,8,0,314,322,8
TUSC2,10,2,310,322,8
TWF1,10,2,310,322,8
IMPA2,10,2,310,322,8
ALYREF,10,2,310,322,8
UBA1,11,3,308,322,8
TYSND1,8,0,314,322,8
ENOSF1,9,1,312,322,8
EML6,14,6,302,322,8
TXLNA,10,2,310,322,8
IL27,11,3,308,322,8
AMPD3,18,10,294,322,8
EMSY,9,1,312,322,8
TXNL4A,10,2,310,322,8
TXNIP,23,15,284,322,8
UBE2W,10,2,310,322,8
ANAPC5,9,1,312,322,8
USP22,10,2,310,322,8
TTI2,8,0,314,322,8
ELAVL2,11,3,308,322,8
ERFL,13,5,304,322,8
ERGIC1,9,1,312,322,8
ICA1L,8,0,314,322,8
ERGIC3,10,2,310,322,8
UNC45A,9,1,312,322,8
UPF1,10,2,310,322,8
ELOVL1,10,2,310,322,8
ELANE,14,6,302,322,8
UQCR11,12,4,306,322,8
UROD,10,2,310,322,8
USF2,11,3,308,322,8
USHBP1,14,6,302,322,8
EIF6,10,2,310,322,8
UFSP2,16,8,298,322,8
ELF1,11,3,308,322,8
ERCC3,12,4,306,322,8
ERCC2,11,3,308,322,8
IDUA,17,9,296,322,8
UCKL1,12,4,306,322,8
UCK1,9,1,312,322,8
UCHL3,10,2,310,322,8
UBXN7,12,4,306,322,8
ELK4,8,0,314,322,8
ANGPTL6,15,7,300,322,8
ANGPTL3,11,3,308,322,8
IFT20,9,1,312,322,8
ALDOA,13,5,304,322,8
ELMOD3,8,0,314,322,8
IGFBP6,11,3,308,322,8
IGFL1,13,5,304,322,8
KCNMA1,10,2,310,322,8
HDAC1,8,0,314,322,8
GLYATL3,14,6,302,322,8
ACTR2,10,2,310,322,8
ZDHHC5,10,2,310,322,8
ACVR1B,13,5,304,322,8
ZFAT,10,2,310,322,8
TPI1,15,7,300,322,8
GPR179,9,1,312,322,8
KMT2D,10,2,310,322,8
APIP,11,3,308,322,8
GPRC5A,9,1,312,322,8
GPR108,13,5,304,322,8
GPR107,9,1,312,322,8
KPNA4,9,1,312,322,8
ZFP30,12,4,306,322,8
KPNB1,10,2,310,322,8
ZFP36L1,17,9,296,322,8
ZCRB1,10,2,310,322,8
ZCCHC10,11,3,308,322,8
ANO10,12,4,306,322,8
ZBTB20,13,5,304,322,8
TRAP1,10,2,310,322,8
KLHL21,13,5,304,322,8
TRAF4,14,6,302,322,8
FAM32A,9,1,312,322,8
GRIN2A,11,3,308,322,8
AP5M1,11,3,308,322,8
GRID1,10,2,310,322,8
DUT,10,2,310,322,8
ZBTB38,10,2,310,322,8
ZBTB40,9,1,312,322,8
TPST2,12,4,306,322,8
ZBTB6,10,2,310,322,8
DXO,10,2,310,322,8
GRAPL,31,23,268,322,8
ZFP42,11,3,308,322,8
KRBA2,9,1,312,322,8
APLNR,9,1,312,322,8
GNAQ,10,2,310,322,8
GNB5,9,1,312,322,8
LAMA4,16,8,298,322,8
ZNF121,10,2,310,322,8
TNXB,21,13,288,322,8
TNRC6C,9,1,312,322,8
DRP2,9,1,312,322,8
ZNF143,8,0,314,322,8
ZFP91,9,1,312,322,8
LARGE1,9,1,312,322,8
LARP1,11,3,308,322,8
TNNT2,17,9,296,322,8
FBXO2,13,5,304,322,8
ZNF208,26,18,278,322,8
ZNF211,10,2,310,322,8
GNG12,9,1,312,322,8
ZMYM4,10,2,310,322,8
FBRSL1,10,2,310,322,8
ZKSCAN5,8,0,314,322,8
ZIC5,8,0,314,322,8
FAXDC2,20,12,290,322,8
DTNA,16,8,298,322,8
DTNB,9,1,312,322,8
KRTAP9-6,12,4,306,322,8
GOLGA6L10,9,1,312,322,8
KRTAP5-2,10,2,310,322,8
GOLGA6L9,11,3,308,322,8
GOLGA7,9,1,312,322,8
ZFYVE9,10,2,310,322,8
ZFYVE19,13,5,304,322,8
ZFX,10,2,310,322,8
TP53BP2,9,1,312,322,8
DYNLT2B,11,3,308,322,8
TRAPPC1,11,3,308,322,8
KLF10,10,2,310,322,8
H3C10,13,5,304,322,8
H4C6,28,20,274,322,8
ADIPOR1,9,1,312,322,8
KDM4A,10,2,310,322,8
TRIM28,10,2,310,322,8
WDR54,11,3,308,322,8
WDR70,8,0,314,322,8
H3-5,21,13,288,322,8
WRNIP1,9,1,312,322,8
H3-3A,10,2,310,322,8
WIF1,12,4,306,322,8
WNT6,13,5,304,322,8
TRIM23,10,2,310,322,8
H2AZ2,9,1,312,322,8
KHDRBS1,11,3,308,322,8
HAGH,12,4,306,322,8
ADORA3,8,0,314,322,8
EEF1D,12,4,306,322,8
FAM131A,11,3,308,322,8
HAVCR2,9,1,312,322,8
WASL,9,1,312,322,8
KCTD19,41,33,248,322,8
TRIM43B,12,4,306,322,8
FAM120C,11,3,308,322,8
HBS1L,8,0,314,322,8
KCTD15,14,6,302,322,8
HCFC1,10,2,310,322,8
ANP32E,10,2,310,322,8
WASF2,10,2,310,322,8
TRIO,9,1,312,322,8
EFCAB6,11,3,308,322,8
FAM117A,11,3,308,322,8
KHSRP,10,2,310,322,8
KIAA0825,10,2,310,322,8
KLF1,13,5,304,322,8
KIF9,12,4,306,322,8
AP2A2,10,2,310,322,8
KIF5B,10,2,310,322,8
GTF2I,9,1,312,322,8
GTF2H1,9,1,312,322,8
GSX2,9,1,312,322,8
YWHAB,10,2,310,322,8
FAM222B,10,2,310,322,8
KIAA1328,9,1,312,322,8
KIFAP3,11,3,308,322,8
YWHAH,10,2,310,322,8
KIFC3,16,8,298,322,8
FAM229B,14,6,302,322,8
E2F5,12,4,306,322,8
GSK3A,12,4,306,322,8
TRBV9,21,13,288,322,8
KIF3C,10,2,310,322,8
ADAMTSL5,10,2,310,322,8
ADAP2,20,12,290,322,8
KIF21B,12,4,306,322,8
YIPF3,10,2,310,322,8
KIF1B,9,1,312,322,8
ADCK1,13,5,304,322,8
YIPF2,12,4,306,322,8
YIF1B,11,3,308,322,8
FAM199X,9,1,312,322,8
ECM1,12,4,306,322,8
YBX1,10,2,310,322,8
ADCY5,14,6,302,322,8
FAM186B,16,8,298,322,8
H2AB2,38,30,254,322,8
XRCC6,10,2,310,322,8
CCDC197,10,2,310,322,8
DDIT4L,11,3,308,322,8
PCDH8,8,0,314,322,8
PDE1B,11,3,308,322,8
SMC1A,10,2,310,322,8
SMARCE1,9,1,312,322,8
SMARCC2,11,3,308,322,8
SMARCA5,8,0,314,322,8
SMAD9,12,4,306,322,8
SMAD5,12,4,306,322,8
PCNX4,12,4,306,322,8
C11orf49,10,2,310,322,8
SLMAP,9,1,312,322,8
SLIT2,12,4,306,322,8
CMPK1,10,2,310,322,8
SLC7A7,10,2,310,322,8
SH3GL1,9,1,312,322,8
SLC6A16,22,14,286,322,8
PDP1,12,4,306,322,8
PDPK1,9,1,312,322,8
SLC47A1,10,2,310,322,8
CLPB,10,2,310,322,8
PDZD9,18,10,294,322,8
CLN3,9,1,312,322,8
PEF1,9,1,312,322,8
SLC41A3,11,3,308,322,8
PELI1,10,2,310,322,8
CLIC4,9,1,312,322,8
PCDHB2,20,12,290,322,8
CNN1,20,12,290,322,8
PCBD1,13,5,304,322,8
CNOT3,12,4,306,322,8
COL12A1,10,2,310,322,8
BTF3,10,2,310,322,8
BTG1,9,1,312,322,8
COG6,14,6,302,322,8
PACS1,15,7,300,322,8
SMIM28,11,3,308,322,8
COASY,9,1,312,322,8
PAF1,10,2,310,322,8
PAFAH1B2,9,1,312,322,8
PAGE2B,29,21,272,322,8
PAICS,9,1,312,322,8
PAK2,10,2,310,322,8
BTN2A2,14,6,302,322,8
PAK4,9,1,312,322,8
PAM16,16,8,298,322,8
CNTNAP1,8,0,314,322,8
PANK3,9,1,312,322,8
PAPSS1,10,2,310,322,8
SMG8,9,1,312,322,8
PARD3B,9,1,312,322,8
SMCO1,9,1,312,322,8
PBRM1,10,2,310,322,8
CNOT6,8,0,314,322,8
PEX5,12,4,306,322,8
SLC38A3,22,14,286,322,8
PFDN6,10,2,310,322,8
CKS1B,9,1,312,322,8
C1orf146,17,9,296,322,8
PIP5K1C,9,1,312,322,8
PJA2,10,2,310,322,8
SLC15A2,11,3,308,322,8
PKDCC,13,5,304,322,8
PKIA,11,3,308,322,8
PLA2G2A,15,7,300,322,8
CIB3,28,20,274,322,8
SKIDA1,8,0,314,322,8
PLCB1,16,8,298,322,8
SIRT7,11,3,308,322,8
PLCH2,11,3,308,322,8
SIRT3,11,3,308,322,8
SIPA1L3,12,4,306,322,8
SIM1,8,0,314,322,8
SIK3,10,2,310,322,8
SIGLEC10,9,1,312,322,8
SHQ1,13,5,304,322,8
C2CD3,9,1,312,322,8
C2CD6,9,1,312,322,8
SHBG,26,18,278,322,8
SHB,8,0,314,322,8
PLXNA1,9,1,312,322,8
PIM3,12,4,306,322,8
C1orf122,10,2,310,322,8
PFKFB4,14,6,302,322,8
PIGS,10,2,310,322,8
SLC35C2,10,2,310,322,8
PGAP1,10,2,310,322,8
SLC35B3,12,4,306,322,8
SLC28A1,10,2,310,322,8
SLC27A1,11,3,308,322,8
PGRMC1,10,2,310,322,8
SLC25A52,22,14,286,322,8
PHF10,9,1,312,322,8
PHF12,12,4,306,322,8
SLC25A44,9,1,312,322,8
PHF21B,12,4,306,322,8
PHF8,11,3,308,322,8
SLC25A39,9,1,312,322,8
CLDN20,15,7,300,322,8
PHLDB1,10,2,310,322,8
PHOX2B,10,2,310,322,8
SLC25A3,10,2,310,322,8
SLC25A29,13,5,304,322,8
C1orf100,13,5,304,322,8
PIAS1,9,1,312,322,8
PICALM,12,4,306,322,8
PIFO,12,4,306,322,8
PIGQ,10,2,310,322,8
P2RY11,13,5,304,322,8
BTBD6,9,1,312,322,8
BTBD3,12,4,306,322,8
CSF1,12,4,306,322,8
NKX1-2,8,0,314,322,8
NKX2-8,9,1,312,322,8
SRP9,13,5,304,322,8
NKX6-1,9,1,312,322,8
SRGAP3,8,0,314,322,8
SRGAP2B,9,1,312,322,8
SRGAP1,8,0,314,322,8
SREBF2,9,1,312,322,8
SRCIN1,12,4,306,322,8
SQSTM1,15,7,300,322,8
BET1L,11,3,308,322,8
CRTC3,9,1,312,322,8
BEX3,11,3,308,322,8
NOMO2,11,3,308,322,8
CRNKL1,9,1,312,322,8
SPPL3,10,2,310,322,8
NPIPB2,12,4,306,322,8
SPINK6,18,10,294,322,8
CREBBP,12,4,306,322,8
NPY1R,21,13,288,322,8
NR0B1,11,3,308,322,8
CRAT,19,11,292,322,8
SPEM3,13,5,304,322,8
NKIRAS1,8,0,314,322,8
NKAIN4,22,14,286,322,8
SPECC1,9,1,312,322,8
NID2,10,2,310,322,8
NEDD8,10,2,310,322,8
NEDD9,12,4,306,322,8
BCAP31,10,2,310,322,8
BCAR1,12,4,306,322,8
NEK11,9,1,312,322,8
BCAS1,9,1,312,322,8
BCAS3,15,7,300,322,8
NEMP1,8,0,314,322,8
NEO1,8,0,314,322,8
NEURL4,10,2,310,322,8
ST7,9,1,312,322,8
NF1,9,1,312,322,8
SSU72,10,2,310,322,8
SST,14,6,302,322,8
SSRP1,10,2,310,322,8
CSNK2A2,9,1,312,322,8
SSBP3,9,1,312,322,8
SSB,9,1,312,322,8
NFILZ,11,3,308,322,8
CSNK1D,10,2,310,322,8
CSNK1A1,9,1,312,322,8
SRSF12,9,1,312,322,8
SRSF11,10,2,310,322,8
NR2C2,12,4,306,322,8
CR1L,9,1,312,322,8
SMN2,15,7,300,322,8
SOD3,18,10,294,322,8
ODF2,10,2,310,322,8
CORO1B,11,3,308,322,8
ODF3L1,16,8,298,322,8
CORIN,13,5,304,322,8
BRD2,10,2,310,322,8
SNX21,12,4,306,322,8
BRF2,13,5,304,322,8
COPS5,10,2,310,322,8
COPS3,13,5,304,322,8
OR13C9,11,3,308,322,8
SNRPE,10,2,310,322,8
COMMD5,12,4,306,322,8
OR52B6,9,1,312,322,8
BRK1,9,1,312,322,8
BRME1,22,14,286,322,8
OR6K3,10,2,310,322,8
OSBPL8,11,3,308,322,8
BRWD1,10,2,310,322,8
OSTM1,9,1,312,322,8
BSDC1,9,1,312,322,8
OTUD7B,9,1,312,322,8
SMPDL3B,9,1,312,322,8
SMNDC1,8,0,314,322,8
SNX6,9,1,312,322,8
NXN,9,1,312,322,8
SPDEF,12,4,306,322,8
NXF2,10,2,310,322,8
CPSF7,11,3,308,322,8
NRXN3,9,1,312,322,8
SPATA9,17,9,296,322,8
SPATA5L1,16,8,298,322,8
NTAN1,12,4,306,322,8
NTMT1,10,2,310,322,8
NTN1,11,3,308,322,8
SPATA24,14,6,302,322,8
CPNE1,12,4,306,322,8
SPAST,8,0,314,322,8
BNC1,9,1,312,322,8
SPARC,17,9,296,322,8
BOD1,11,3,308,322,8
CPLX1,12,4,306,322,8
CPLANE2,21,13,288,322,8
NUDCD3,9,1,312,322,8
SPACA7,17,9,296,322,8
NUDT11,9,1,312,322,8
SP1,9,1,312,322,8
NUMA1,12,4,306,322,8
NUMB,10,2,310,322,8
COX6A1,11,3,308,322,8
NXF1,12,4,306,322,8
C2orf76,14,6,302,322,8
PMF1,12,4,306,322,8
NECAB3,16,8,298,322,8
RAD54L,9,1,312,322,8
RUSC2,11,3,308,322,8
CASK,11,3,308,322,8
CD99L2,10,2,310,322,8
RAB5C,11,3,308,322,8
RABEP1,10,2,310,322,8
CAST,8,0,314,322,8
CASTOR2,9,1,312,322,8
RSPH9,16,8,298,322,8
CATSPER2,14,6,302,322,8
RACK1,13,5,304,322,8
RAD21,10,2,310,322,8
RAD54L2,9,1,312,322,8
PNP,11,3,308,322,8
CAV2,10,2,310,322,8
RRP36,11,3,308,322,8
CAVIN4,10,2,310,322,8
RAI2,11,3,308,322,8
RANBP3,12,4,306,322,8
RANBP9,9,1,312,322,8
RAP1B,12,4,306,322,8
CBLB,13,5,304,322,8
CD2BP2,10,2,310,322,8
RAPGEF2,10,2,310,322,8
RARA,11,3,308,322,8
RAB11FIP1,9,1,312,322,8
RAB11A,9,1,312,322,8
QTRT1,14,6,302,322,8
CDC42BPA,9,1,312,322,8
SAMD3,13,5,304,322,8
CAPN2,11,3,308,322,8
CDIPT,9,1,312,322,8
PTPN14,8,0,314,322,8
CDHR5,16,8,298,322,8
PTPN20,14,6,302,322,8
CAPN3,11,3,308,322,8
CDHR1,13,5,304,322,8
PTPN23,11,3,308,322,8
PTPRG,8,0,314,322,8
CDH26,12,4,306,322,8
PUM2,10,2,310,322,8
SAA1,24,16,282,322,8
PWWP3B,8,0,314,322,8
CDCA5,10,2,310,322,8
PYDC1,14,6,302,322,8
CARD18,11,3,308,322,8
S100G,15,7,300,322,8
QPCT,14,6,302,322,8
S100A11,10,2,310,322,8
RYR1,22,14,286,322,8
QSER1,9,1,312,322,8
RUVBL2,13,5,304,322,8
RASA4B,11,3,308,322,8
RASGRF2,11,3,308,322,8
RPS8,11,3,308,322,8
RPL6,9,1,312,322,8
RGMB,9,1,312,322,8
RPL4,12,4,306,322,8
RPL26L1,12,4,306,322,8
RHOC,11,3,308,322,8
RIC8B,10,2,310,322,8
RIIAD1,18,10,294,322,8
RIMBP3B,35,27,260,322,8
RIMKLA,10,2,310,322,8
CCDC88B,11,3,308,322,8
CCDC88A,12,4,306,322,8
RIT1,10,2,310,322,8
RLF,8,0,314,322,8
RMND5A,9,1,312,322,8
RPL11,11,3,308,322,8
CCDC74B,19,11,292,322,8
RPAP1,9,1,312,322,8
RNF13,8,0,314,322,8
ROCK1,8,0,314,322,8
ROBO2,12,4,306,322,8
RNF187,9,1,312,322,8
RNF19A,9,1,312,322,8
CCDC38,12,4,306,322,8
CCDC33,13,5,304,322,8
RPL5,10,2,310,322,8
RFTN1,12,4,306,322,8
RAX2,13,5,304,322,8
RPL8,13,5,304,322,8
RPS27A,11,3,308,322,8
RPS26,10,2,310,322,8
CBX1,9,1,312,322,8
CD164,10,2,310,322,8
CBX3,9,1,312,322,8
RPS2,13,5,304,322,8
CBX8,10,2,310,322,8
CCT8,10,2,310,322,8
CCT6A,10,2,310,322,8
RPS15A,11,3,308,322,8
RPS15,12,4,306,322,8
CCSAP,11,3,308,322,8
CC2D2B,29,21,272,322,8
RBP1,11,3,308,322,8
RBPJ,10,2,310,322,8
CCNYL1,8,0,314,322,8
RC3H2,9,1,312,322,8
RPS12,12,4,306,322,8
RCOR2,12,4,306,322,8
RECQL,9,1,312,322,8
CCNI,10,2,310,322,8
CCND3,12,4,306,322,8
CCDC115,9,1,312,322,8
SAMD4B,19,11,292,322,8
CDK13,9,1,312,322,8
PTMS,12,4,306,322,8
PPP1CA,12,4,306,322,8
PPP1CC,9,1,312,322,8
PPP1R13L,16,8,298,322,8
CFAP52,32,24,266,322,8
SEPTIN3,10,2,310,322,8
C9orf40,9,1,312,322,8
SEPTIN11,10,2,310,322,8
PPP1R37,12,4,306,322,8
C9orf64,8,0,314,322,8
SEMA6D,26,18,278,322,8
CFAP126,19,11,292,322,8
SEMA6A,19,11,292,322,8
CA12,10,2,310,322,8
SEM1,11,3,308,322,8
PPP2R2A,9,1,312,322,8
SELENOT,9,1,312,322,8
SELENOP,16,8,298,322,8
CERS6,9,1,312,322,8
CERS3,16,8,298,322,8
SELENOK,9,1,312,322,8
CEP95,11,3,308,322,8
PPP6R2,10,2,310,322,8
PPP6R3,10,2,310,322,8
SEL1L,12,4,306,322,8
SERPINA7,8,0,314,322,8
SERPINE2,11,3,308,322,8
SEC61B,11,3,308,322,8
PPM1J,13,5,304,322,8
PNPLA8,10,2,310,322,8
PODNL1,16,8,298,322,8
CHID1,11,3,308,322,8
CHIC2,13,5,304,322,8
CHIA,9,1,312,322,8
POLDIP2,10,2,310,322,8
CHGA,12,4,306,322,8
POLR2B,10,2,310,322,8
SGF29,13,5,304,322,8
POM121C,11,3,308,322,8
CHD5,13,5,304,322,8
CHD2,10,2,310,322,8
SFXN3,8,0,314,322,8
CHCHD3,9,1,312,322,8
PORCN,10,2,310,322,8
PPAT,10,2,310,322,8
SEZ6L,10,2,310,322,8
C5orf24,8,0,314,322,8
SEZ6,17,9,296,322,8
SETD2,8,0,314,322,8
CFL2,12,4,306,322,8
PPIE,9,1,312,322,8
CFD,14,6,302,322,8
PRAME,11,3,308,322,8
PRDM2,9,1,312,322,8
PTK2,10,2,310,322,8
CEBPZOS,11,3,308,322,8
CALHM3,11,3,308,322,8
CEACAM6,13,5,304,322,8
SCGB3A1,19,11,292,322,8
PSENEN,14,6,302,322,8
PSG2,15,7,300,322,8
PSMA4,10,2,310,322,8
PSMB11,8,0,314,322,8
PSMB4,11,3,308,322,8
PSMC1,9,1,312,322,8
PSMC3IP,12,4,306,322,8
PSMD2,9,1,312,322,8
SCAMP3,10,2,310,322,8
SCAF11,11,3,308,322,8
CDKN2AIPNL,9,1,312,322,8
SART1,10,2,310,322,8
CDK9,8,0,314,322,8
PTCRA,14,6,302,322,8
PTDSS2,12,4,306,322,8
PTEN,9,1,312,322,8
CAMTA1,13,5,304,322,8
CAP1,9,1,312,322,8
SAP30BP,9,1,312,322,8
CAPN1,10,2,310,322,8
CEBPE,11,3,308,322,8
CELA1,14,6,302,322,8
PRDX6,10,2,310,322,8
PRR5L,16,8,298,322,8
PRELID3B,10,2,310,322,8
PREPL,10,2,310,322,8
SEC23B,12,4,306,322,8
CACNA1C,14,6,302,322,8
SEC16A,10,2,310,322,8
PRKACA,9,1,312,322,8
CACNA2D2,9,1,312,322,8
CENPX,11,3,308,322,8
SDK2,10,2,310,322,8
PRMT1,13,5,304,322,8
CENPS-CORT,27,19,276,322,8
PRMT5,12,4,306,322,8
PRNP,11,3,308,322,8
SDHAF2,11,3,308,322,8
PRORP,10,2,310,322,8
PRPF40B,13,5,304,322,8
PRPH2,12,4,306,322,8
CACTIN,10,2,310,322,8
CACUL1,8,0,314,322,8
CELSR3,9,1,312,322,8
CELSR2,8,0,314,322,8
PRR3,12,4,306,322,8
CALB2,16,8,298,322,8
STAR,11,3,308,322,8
MKRN3,10,2,310,322,8
NDUFS8,11,3,308,322,8
SZT2,9,1,312,322,8
SYNGR1,14,6,302,322,8
SYNJ1,11,3,308,322,8
SYPL2,8,0,314,322,8
SYT5,12,4,306,322,8
CYP2F1,19,11,292,322,8
DERL1,8,0,314,322,8
ATXN2L,9,1,312,322,8
ATXN2,9,1,312,322,8
MCM3AP,9,1,312,322,8
MCM4,11,3,308,322,8
MCM7,11,3,308,322,8
ATRX,10,2,310,322,8
TEX261,8,0,314,322,8
ASXL1,12,4,306,322,8
DENND1A,10,2,310,322,8
TFF2,13,5,304,322,8
MDH2,10,2,310,322,8
MDM2,12,4,306,322,8
TET3,10,2,310,322,8
MED10,10,2,310,322,8
TAB2,10,2,310,322,8
ATAD2B,8,0,314,322,8
MTCL1,11,3,308,322,8
MED15,10,2,310,322,8
MTARC2,11,3,308,322,8
MTA3,10,2,310,322,8
MTA1,10,2,310,322,8
MED25,12,4,306,322,8
TACC3,9,1,312,322,8
ATAD3B,9,1,312,322,8
SYNE2,10,2,310,322,8
CYP26A1,12,4,306,322,8
NACA,11,3,308,322,8
MYL6B,11,3,308,322,8
TIA1,13,5,304,322,8
DHX9,9,1,312,322,8
N4BP2L2,8,0,314,322,8
ASAH1,12,4,306,322,8
THUMPD1,9,1,312,322,8
THTPA,15,7,300,322,8
STXBP2,11,3,308,322,8
DHX30,9,1,312,322,8
STYXL2,9,1,312,322,8
MAP3K5,8,0,314,322,8
MAP4,10,2,310,322,8
MYPN,11,3,308,322,8
THRA,9,1,312,322,8
SUMO2,9,1,312,322,8
MAPRE1,10,2,310,322,8
ASF1B,11,3,308,322,8
MYL5,15,7,300,322,8
MAPT,15,7,300,322,8
DGUOK,12,4,306,322,8
MYL1,12,4,306,322,8
MYH14,10,2,310,322,8
MYH10,10,2,310,322,8
CYGB,20,12,290,322,8
MARCKS,9,1,312,322,8
MARK4,10,2,310,322,8
MXD4,9,1,312,322,8
TGM1,16,8,298,322,8
MAST2,10,2,310,322,8
AZIN2,11,3,308,322,8
DGAT1,10,2,310,322,8
ATP9B,12,4,306,322,8
MT1F,29,21,272,322,8
CYSLTR1,12,4,306,322,8
MPI,10,2,310,322,8
MIDEAS,9,1,312,322,8
ATP5PO,11,3,308,322,8
MRGPRG,8,0,314,322,8
MIGA2,10,2,310,322,8
MRFAP1,11,3,308,322,8
ATMIN,9,1,312,322,8
ATP5MG,10,2,310,322,8
MIPOL1,11,3,308,322,8
MPZL1,12,4,306,322,8
TCEA1,12,4,306,322,8
TATDN2,9,1,312,322,8
TBX21,9,1,312,322,8
MLLT6,9,1,312,322,8
DCAF7,9,1,312,322,8
ATP13A2,11,3,308,322,8
MEFV,10,2,310,322,8
MLXIPL,12,4,306,322,8
TBC1D5,11,3,308,322,8
MPHOSPH8,10,2,310,322,8
MPC1L,22,14,286,322,8
DCUN1D5,13,5,304,322,8
MMP21,19,11,292,322,8
DCTN1,10,2,310,322,8
DCLK2,8,0,314,322,8
DCLK3,8,0,314,322,8
MOB3A,10,2,310,322,8
TBC1D12,8,0,314,322,8
TBC1D28,17,9,296,322,8
TBC1D23,10,2,310,322,8
MOCS2,10,2,310,322,8
DDX39B,9,1,312,322,8
MIB1,9,1,312,322,8
ATP6AP1,10,2,310,322,8
DBI,11,3,308,322,8
CYSRT1,17,9,296,322,8
CYSTM1,14,6,302,322,8
TEKT3,29,21,272,322,8
MT-CO2,12,4,306,322,8
DEFB119,9,1,312,322,8
ATF6B,10,2,310,322,8
MT-ATP6,14,6,302,322,8
TAF11L11,9,1,312,322,8
METAP2,9,1,312,322,8
TDRKH,8,0,314,322,8
MSLN,12,4,306,322,8
TALDO1,10,2,310,322,8
TANC2,13,5,304,322,8
TAOK1,9,1,312,322,8
TAOK3,12,4,306,322,8
MRPS5,8,0,314,322,8
MEX3D,12,4,306,322,8
TCTN2,10,2,310,322,8
MFAP5,12,4,306,322,8
MRPL47,11,3,308,322,8
MRPL32,14,6,302,322,8
MRPL28,14,6,302,322,8
DAZAP2,9,1,312,322,8
MFGE8,13,5,304,322,8
TAS1R3,11,3,308,322,8
MFSD11,10,2,310,322,8
TAS2R1,14,6,302,322,8
TCOF1,10,2,310,322,8
ATG5,10,2,310,322,8
DIAPH1,10,2,310,322,8
DCP2,8,0,314,322,8
CTSE,10,2,310,322,8
MAN1B1,14,6,302,322,8
STK33,19,11,292,322,8
ARSF,8,0,314,322,8
NDUFA2,12,4,306,322,8
NCOA2,11,3,308,322,8
STOML2,11,3,308,322,8
MACROD1,17,9,296,322,8
TM9SF2,8,0,314,322,8
MAFG,10,2,310,322,8
NCBP1,10,2,310,322,8
NDUFB3,11,3,308,322,8
NCBP2,11,3,308,322,8
BAIAP3,16,8,298,322,8
MAD2L2,11,3,308,322,8
TIMM23,9,1,312,322,8
DLX4,10,2,310,322,8
STAU2,10,2,310,322,8
MAL,12,4,306,322,8
CUEDC2,12,4,306,322,8
NCR1,12,4,306,322,8
CTTN,12,4,306,322,8
CTNND1,13,5,304,322,8
TM2D3,10,2,310,322,8
NDOR1,11,3,308,322,8
TLN2,8,0,314,322,8
STMN3,14,6,302,322,8
NBPF10,8,0,314,322,8
BAX,11,3,308,322,8
MAGI1,9,1,312,322,8
TIMMDC1,10,2,310,322,8
ARPC5,9,1,312,322,8
DLGAP1,11,3,308,322,8
ARMS2,20,12,290,322,8
NDFIP1,10,2,310,322,8
NCK2,13,5,304,322,8
DIO1,20,12,290,322,8
NCKAP5L,9,1,312,322,8
ARSA,12,4,306,322,8
STRADA,13,5,304,322,8
STK25,11,3,308,322,8
NALCN,12,4,306,322,8
TMA7,11,3,308,322,8
TIMD4,9,1,312,322,8
NADSYN1,11,3,308,322,8
CUTC,9,1,312,322,8
LTBP3,14,7,301,322,7
MADD,10,3,309,322,7
RHOT2,12,5,305,322,7
LHX6,15,8,299,322,7
ZCWPW2,12,5,305,322,7
ZNF701,7,0,315,322,7
ZDHHC18,8,1,313,322,7
ZNF774,9,2,311,322,7
LENG8,10,3,309,322,7
MEGF11,22,15,285,322,7
FOXRED1,10,3,309,322,7
SCN4A,8,1,313,322,7
RIMS3,7,0,315,322,7
RPL24,11,4,307,322,7
GOT2,9,2,311,322,7
SEC11A,10,3,309,322,7
SDSL,12,5,305,322,7
TMSB10,15,8,299,322,7
FTL,12,5,305,322,7
SEC31A,10,3,309,322,7
MIA2,10,3,309,322,7
GON4L,7,0,315,322,7
RGS5,13,6,303,322,7
FTCDNL1,10,3,309,322,7
GPX8,9,2,311,322,7
MGAT4B,9,2,311,322,7
PSEN1,9,2,311,322,7
MGAT4A,8,1,313,322,7
PRKACB,8,1,313,322,7
GOSR1,9,2,311,322,7
PRKAR1A,10,3,309,322,7
GPRC6A,7,0,315,322,7
PRKAR2B,9,2,311,322,7
RPL13,13,6,303,322,7
ZDHHC23,9,2,311,322,7
MEN1,10,3,309,322,7
PRKRIP1,8,1,313,322,7
LETMD1,13,6,303,322,7
GPR161,8,1,313,322,7
SDC3,10,3,309,322,7
TMEM91,13,6,303,322,7
RHEB,9,2,311,322,7
PRPS1,10,3,309,322,7
LGI1,12,5,305,322,7
PRPS1L1,7,0,315,322,7
PRPSAP1,9,2,311,322,7
RIDA,10,3,309,322,7
METTL6,8,1,313,322,7
METTL22,8,1,313,322,7
RIC8A,12,5,305,322,7
METTL15,11,4,307,322,7
METRNL,16,9,297,322,7
GPI,9,2,311,322,7
TLE5,8,1,313,322,7
PRR27,7,0,315,322,7
GPATCH2L,10,3,309,322,7
LGALS3,11,4,307,322,7
GPATCH2,7,0,315,322,7
MEX3C,11,4,307,322,7
RPL17,12,5,305,322,7
GPER1,16,9,297,322,7
ZEB1,9,2,311,322,7
PRMT2,9,2,311,322,7
RIMKLB,12,5,305,322,7
ZFAND3,11,4,307,322,7
SCN4B,8,1,313,322,7
MACROH2A1,8,1,313,322,7
PROSER2,9,2,311,322,7
SDCCAG8,9,2,311,322,7
GPR21,11,4,307,322,7
MESD,7,0,315,322,7
SCP2,9,2,311,322,7
LTA4H,11,4,307,322,7
TDRD3,9,2,311,322,7
MIA3,7,0,315,322,7
PROSER1,7,0,315,322,7
TCF7L2,25,18,279,322,7
ZC2HC1C,11,4,307,322,7
PPFIBP1,10,3,309,322,7
SETBP1,9,2,311,322,7
SERTAD3,12,5,305,322,7
SERPINI2,16,9,297,322,7
TBC1D3K,27,20,275,322,7
SERPINE3,13,6,303,322,7
PPIL4,8,1,313,322,7
PPM1D,11,4,307,322,7
ZNF880,18,11,293,322,7
GTF3C4,7,0,315,322,7
RNF181,12,5,305,322,7
TBC1D4,7,0,315,322,7
PPM1M,13,6,303,322,7
PPME1,9,2,311,322,7
ZNF846,7,0,315,322,7
ZNF843,9,2,311,322,7
TBC1D9,7,0,315,322,7
SERINC1,8,1,313,322,7
YME1L1,8,1,313,322,7
MMP1,8,1,313,322,7
RNMT,9,2,311,322,7
RNF141,8,1,313,322,7
LAT,14,7,301,322,7
LASP1,9,2,311,322,7
PRDX4,12,5,305,322,7
SETD7,9,2,311,322,7
ZYG11A,8,1,313,322,7
POTEH,13,6,303,322,7
XIAP,9,2,311,322,7
RNF41,10,3,309,322,7
POTEM,7,0,315,322,7
XRCC1,11,4,307,322,7
POU1F1,12,5,305,322,7
SF3B3,8,1,313,322,7
SF3B2,10,3,309,322,7
SF3A3,8,1,313,322,7
POU6F1,9,2,311,322,7
SF3A2,12,5,305,322,7
RNF217,7,0,315,322,7
SF3A1,9,2,311,322,7
RNF215,8,1,313,322,7
TBC1D2B,7,0,315,322,7
ZSCAN32,10,3,309,322,7
TM9SF3,8,1,313,322,7
GZMB,19,12,291,322,7
TMCO3,9,2,311,322,7
GZF1,10,3,309,322,7
FOXE1,8,1,313,322,7
PPP1R15B,9,2,311,322,7
PPP1R1A,13,6,303,322,7
TMED2,11,4,307,322,7
LDAH,9,2,311,322,7
RPL10A,12,5,305,322,7
MIEN1,10,3,309,322,7
PPP2R5E,7,0,315,322,7
ZBTB16,11,4,307,322,7
LYSMD3,7,0,315,322,7
PPP5C,9,2,311,322,7
TCF20,10,3,309,322,7
GRIK2,10,3,309,322,7
TMX2,9,2,311,322,7
ZBTB32,18,11,293,322,7
TCF3,9,2,311,322,7
RPL36,13,6,303,322,7
SEC63,10,3,309,322,7
GRHPR,10,3,309,322,7
LDLR,10,3,309,322,7
SEC62,12,5,305,322,7
M6PR,13,6,303,322,7
GRB2,9,2,311,322,7
TMX1,10,3,309,322,7
PRDX1,10,3,309,322,7
RPAP2,8,1,313,322,7
GRK2,9,2,311,322,7
GRK4,8,1,313,322,7
YY1AP1,8,1,313,322,7
ZNF816,10,3,309,322,7
TCAF1,10,3,309,322,7
GSTM3,8,1,313,322,7
TNFRSF1A,9,2,311,322,7
MKRN2,9,2,311,322,7
YY1,8,1,313,322,7
GSTCD,10,3,309,322,7
GSTA4,17,10,295,322,7
GSS,12,5,305,322,7
SEMA6C,14,7,301,322,7
MIIP,12,5,305,322,7
RNF130,8,1,313,322,7
PPP1R3F,10,3,309,322,7
GRTP1,10,3,309,322,7
TNFRSF10D,11,4,307,322,7
GRPEL2,10,3,309,322,7
ZAR1L,12,5,305,322,7
MKLN1,8,1,313,322,7
RPA1,7,0,315,322,7
LYRM1,10,3,309,322,7
GOLT1B,18,11,293,322,7
RBM23,10,3,309,322,7
RPL39,13,6,303,322,7
RAB2A,9,2,311,322,7
RUFY1,8,1,313,322,7
RUBCN,9,2,311,322,7
RTN3,9,2,311,322,7
LRP1,10,3,309,322,7
GFPT1,8,1,313,322,7
LRP10,7,0,315,322,7
RTEL1-TNFRSF6B,29,22,271,322,7
ZNF593,15,8,299,322,7
RABEP2,9,2,311,322,7
GET1,11,4,307,322,7
ZNF439,11,4,307,322,7
GDPD5,12,5,305,322,7
RTBDN,11,4,307,322,7
RABGAP1L,9,2,311,322,7
RSRC1,10,3,309,322,7
TMEM205,13,6,303,322,7
RSPRY1,10,3,309,322,7
ZNF592,9,2,311,322,7
RABGEF1,9,2,311,322,7
ZNF445,8,1,313,322,7
TGM6,8,1,313,322,7
RUFY3,9,2,311,322,7
GGA1,9,2,311,322,7
TMEM230,13,6,303,322,7
RBSN,9,2,311,322,7
GHSR,10,3,309,322,7
ZNF345,11,4,307,322,7
MBOAT2,10,3,309,322,7
QARS1,10,3,309,322,7
RPRD1B,10,3,309,322,7
S100A16,11,4,307,322,7
RPS11,12,5,305,322,7
GHITM,9,2,311,322,7
QRFPR,7,0,315,322,7
TFPI,10,3,309,322,7
LRCOL1,13,6,303,322,7
ZNF383,7,0,315,322,7
RXFP1,9,2,311,322,7
LRSAM1,9,2,311,322,7
LRFN4,13,6,303,322,7
TIMM44,12,5,305,322,7
MB,19,12,291,322,7
MAX,10,3,309,322,7
GABPA,7,0,315,322,7
RUNDC3A,12,5,305,322,7
GABRB3,9,2,311,322,7
GDAP2,8,1,313,322,7
RBP2,15,8,299,322,7
TMEM191C,27,20,275,322,7
RABL3,8,1,313,322,7
MAP4K5,9,2,311,322,7
TMEM183A,9,2,311,322,7
THSD8,34,27,261,322,7
RARS1,15,8,299,322,7
GATA4,9,2,311,322,7
RBM42,11,4,307,322,7
RBM4,12,5,305,322,7
TIMM21,7,0,315,322,7
RPS3A,10,3,309,322,7
RASSF4,24,17,281,322,7
TMEM168,10,3,309,322,7
GAK,9,2,311,322,7
LRRC72,8,1,313,322,7
RBM25,10,3,309,322,7
LRRC8A,11,4,307,322,7
GALNT15,14,7,301,322,7
RPS19,10,3,309,322,7
RBM17,11,4,307,322,7
RBM22,10,3,309,322,7
ZNF549,8,1,313,322,7
TIAL1,8,1,313,322,7
GATD3B,13,6,303,322,7
ZNF496,8,1,313,322,7
ZNF563,12,5,305,322,7
LRRC37A3,10,3,309,322,7
TMEM184C,10,3,309,322,7
LRRC10,11,4,307,322,7
LRRN1,8,1,313,322,7
MAPRE3,13,6,303,322,7
RADX,7,0,315,322,7
RSL1D1,9,2,311,322,7
LRRC23,10,3,309,322,7
ZNF573,15,8,299,322,7
ZNF571,10,3,309,322,7
RBMS3,8,1,313,322,7
RRN3,9,2,311,322,7
THAP1,11,4,307,322,7
RALBP1,7,0,315,322,7
GBGT1,23,16,283,322,7
RANBP1,9,2,311,322,7
RANBP2,10,3,309,322,7
MAPK8IP2,9,2,311,322,7
THEG,18,11,293,322,7
THEMIS2,12,5,305,322,7
RRNAD1,12,5,305,322,7
LPP,9,2,311,322,7
LPCAT1,10,3,309,322,7
PSMA1,9,2,311,322,7
RGMA,10,3,309,322,7
LIN28B,11,4,307,322,7
ZMIZ1,11,4,307,322,7
GNL3L,9,2,311,322,7
FURIN,10,3,309,322,7
TMEM45A,8,1,313,322,7
GNG5,9,2,311,322,7
FUS,9,2,311,322,7
ZMYM2,9,2,311,322,7
SBNO1,8,1,313,322,7
SATB1,10,3,309,322,7
MED12L,8,1,313,322,7
RFX7,7,0,315,322,7
FUT10,8,1,313,322,7
LLGL1,9,2,311,322,7
MEAF6,8,1,313,322,7
MEA1,8,1,313,322,7
SAR1B,11,4,307,322,7
GNAL,10,3,309,322,7
PTGES2,8,1,313,322,7
GNA12,10,3,309,322,7
GNA11,11,4,307,322,7
PSME3,9,2,311,322,7
GNPDA1,9,2,311,322,7
PXN,10,3,309,322,7
GNPDA2,9,2,311,322,7
PSMA3,10,3,309,322,7
LIG4,7,0,315,322,7
RGR,14,7,301,322,7
PSMA7,11,4,307,322,7
LILRA6,11,4,307,322,7
MED31,12,5,305,322,7
PSMB7,11,4,307,322,7
TLCD2,8,1,313,322,7
LIME1,23,16,283,322,7
PSMC5,10,3,309,322,7
GALNT2,9,2,311,322,7
SCAPER,9,2,311,322,7
SCAP,9,2,311,322,7
GOLGA6D,16,9,297,322,7
PSMD3,9,2,311,322,7
GOLGA4,9,2,311,322,7
GNS,8,1,313,322,7
SCAMP4,8,1,313,322,7
PSMD9,8,1,313,322,7
ZIM2,9,2,311,322,7
ZKSCAN4,7,0,315,322,7
MDN1,9,2,311,322,7
LMF1,16,9,297,322,7
LMF2,13,6,303,322,7
PTMA,8,1,313,322,7
GK5,9,2,311,322,7
PTTG1IP,10,3,309,322,7
GK3P,10,3,309,322,7
GK,11,4,307,322,7
SAFB,9,2,311,322,7
TFAP2C,8,1,313,322,7
TIMP3,10,3,309,322,7
PURB,8,1,313,322,7
ZNF300,10,3,309,322,7
PUS10,11,4,307,322,7
G3BP1,9,2,311,322,7
RDX,9,2,311,322,7
GJA4,11,4,307,322,7
MBTD1,7,0,315,322,7
RCVRN,7,0,315,322,7
PXDC1,12,5,305,322,7
ZNF333,11,4,307,322,7
PXDN,10,3,309,322,7
ZNF622,9,2,311,322,7
PXK,10,3,309,322,7
GINM1,11,4,307,322,7
LPAR1,8,1,313,322,7
PTPRM,10,3,309,322,7
ZNF248,9,2,311,322,7
LMO7,7,0,315,322,7
GMPPA,12,5,305,322,7
MDM4,9,2,311,322,7
LSM7,14,7,301,322,7
MDK,11,4,307,322,7
GMFB,9,2,311,322,7
MAGEA4,9,2,311,322,7
PTPN11,10,3,309,322,7
REV3L,10,3,309,322,7
RPLP0,13,6,303,322,7
MAGED1,10,3,309,322,7
REEP5,10,3,309,322,7
ZNF219,11,4,307,322,7
MCRS1,9,2,311,322,7
PTPN21,8,1,313,322,7
MCRIP1,13,6,303,322,7
GLTP,9,2,311,322,7
ZNF227,12,5,305,322,7
MAGED2,11,4,307,322,7
GLIPR2,13,6,303,322,7
MOBP,10,3,309,322,7
PTPRD,13,6,303,322,7
HARS1,9,2,311,322,7
POPDC2,17,10,295,322,7
TYK2,9,2,311,322,7
SNUPN,10,3,309,322,7
U2AF1L5,21,14,287,322,7
UAP1L1,8,1,313,322,7
SNTB1,7,0,315,322,7
OR10G4,11,4,307,322,7
IL17RC,11,4,307,322,7
OR10H1,9,2,311,322,7
SUOX,9,2,311,322,7
OR2A25,11,4,307,322,7
SNRPN,10,3,309,322,7
IL12RB1,11,4,307,322,7
SNRPG,10,3,309,322,7
OR2C1,7,0,315,322,7
IKZF4,10,3,309,322,7
UBE2D4,10,3,309,322,7
OR2T33,9,2,311,322,7
OR4B1,7,0,315,322,7
SNRPD2,14,7,301,322,7
SUPT16H,8,1,313,322,7
IGLV11-55,15,8,299,322,7
UBE2I,8,1,313,322,7
SUPT4H1,9,2,311,322,7
UBE2L3,8,1,313,322,7
OR8D4,8,1,313,322,7
SNRNP48,8,1,313,322,7
OPA1,11,4,307,322,7
TXNRD1,8,1,313,322,7
IMP4,10,3,309,322,7
SUMF1,7,0,315,322,7
ILF3,10,3,309,322,7
NUP188,8,1,313,322,7
NUS1,7,0,315,322,7
IL6ST,20,13,289,322,7
SOS 2,8,1,313,322,7
TWSG1,8,1,313,322,7
KHK,12,5,305,322,7
SORL1,8,1,313,322,7
KIAA0408,19,12,291,322,7
SUB1,10,3,309,322,7
OAZ2,8,1,313,322,7
OBSCN,8,1,313,322,7
SOCS4,8,1,313,322,7
MYRF,17,10,295,322,7
IL3RA,19,12,291,322,7
TXN,11,4,307,322,7
IL36G,15,8,299,322,7
OCM2,8,1,313,322,7
MYOZ3,10,3,309,322,7
SUDS3,7,0,315,322,7
MYOC,9,2,311,322,7
SNX5,8,1,313,322,7
IL2RB,21,14,287,322,7
MYO1C,8,1,313,322,7
SNX25,8,1,313,322,7
IGLC7,13,6,303,322,7
KIF2A,13,6,303,322,7
UBE2M,11,4,307,322,7
OSCAR,11,4,307,322,7
UBQLN4,8,1,313,322,7
MTSS2,11,4,307,322,7
KIRREL1,7,0,315,322,7
IGBP1,9,2,311,322,7
PAAF1,11,4,307,322,7
IFT80,9,2,311,322,7
TRBV11-1,9,2,311,322,7
KITLG,14,7,301,322,7
KLC2,11,4,307,322,7
MTRNR2L5,12,5,305,322,7
PAIP2,10,3,309,322,7
UBTD2,9,2,311,322,7
TRAV1-2,8,1,313,322,7
IFFO2,10,3,309,322,7
SMIM20,12,5,305,322,7
KLF6,15,8,299,322,7
PANK1,9,2,311,322,7
KLF9,9,2,311,322,7
KLHDC2,11,4,307,322,7
KLHDC4,8,1,313,322,7
SMDT1,12,5,305,322,7
PARP1,9,2,311,322,7
PARP8,11,4,307,322,7
TRAPPC12,12,5,305,322,7
IDH3B,10,3,309,322,7
UBN2,8,1,313,322,7
UBN1,9,2,311,322,7
KIFC2,10,3,309,322,7
OTUD5,11,4,307,322,7
IGKV3-15,9,2,311,322,7
OSER1,9,2,311,322,7
OSGIN1,19,12,291,322,7
SNRNP200,9,2,311,322,7
UBE2Q2,9,2,311,322,7
SURF1,12,5,305,322,7
IGIP,13,6,303,322,7
SURF4,9,2,311,322,7
UBE2R2,8,1,313,322,7
UBE2T,12,5,305,322,7
SNAI3,16,9,297,322,7
UBE2V2,13,6,303,322,7
P3H1,10,3,309,322,7
MUTYH,12,5,305,322,7
SMPD4,9,2,311,322,7
SMOC1,9,2,311,322,7
MUL1,9,2,311,322,7
MUC17,7,0,315,322,7
IGHA2,8,1,313,322,7
SMIM7,9,2,311,322,7
TRBV5-3,17,10,295,322,7
IGFLR1,33,26,263,322,7
MUC13,10,3,309,322,7
IGFBP4,8,1,313,322,7
NAA35,7,0,315,322,7
TRIM2,12,5,305,322,7
PAX5,9,2,311,322,7
STIMATE,12,5,305,322,7
TSPO2,15,8,299,322,7
JAK2,9,2,311,322,7
NCOA6,10,3,309,322,7
NIPBL,8,1,313,322,7
NIPSNAP1,9,2,311,322,7
SRPRA,9,2,311,322,7
NKAIN3,11,4,307,322,7
NCOA4,8,1,313,322,7
STK24,8,1,313,322,7
TRIP12,10,3,309,322,7
TRIOBP,9,2,311,322,7
ITPRID2,7,0,315,322,7
TTBK1,7,0,315,322,7
NKX3-2,12,5,305,322,7
NCOA1,8,1,313,322,7
NCKIPSD,10,3,309,322,7
SRGAP2C,10,3,309,322,7
NLRP10,9,2,311,322,7
KCNS1,12,5,305,322,7
NME1,9,2,311,322,7
KCTD1,11,4,307,322,7
ITGB5,9,2,311,322,7
TRIM71,7,0,315,322,7
TTC24,9,2,311,322,7
SRC,8,1,313,322,7
NFKBIB,10,3,309,322,7
JMY,7,0,315,322,7
NUDT5,11,4,307,322,7
NFIC,10,3,309,322,7
STAMBP,10,3,309,322,7
TSC22D1,11,4,307,322,7
KBTBD7,8,1,313,322,7
NDUFC2,11,4,307,322,7
KCMF1,8,1,313,322,7
KBTBD13,8,1,313,322,7
STAG1,8,1,313,322,7
KAZN,8,1,313,322,7
NDUFB9,9,2,311,322,7
NDUFB7,13,6,303,322,7
STAC3,20,13,289,322,7
NDUFB5,9,2,311,322,7
NELFE,10,3,309,322,7
NELL2,21,14,287,322,7
STAT5B,8,1,313,322,7
TSEN15,12,5,305,322,7
STAU1,10,3,309,322,7
NDUFA4,9,2,311,322,7
ST6GALNAC4,10,3,309,322,7
NDUFA13,11,4,307,322,7
TSPAN2,11,4,307,322,7
NDUFA1,11,4,307,322,7
NFIA,10,3,309,322,7
TRPM4,12,5,305,322,7
TRPC4AP,11,4,307,322,7
KCTD10,11,4,307,322,7
NME4,11,4,307,322,7
ITGAV,9,2,311,322,7
TRIM49D2,9,2,311,322,7
TUBA1C,11,4,307,322,7
NRIP2,10,3,309,322,7
SPATS2,9,2,311,322,7
SPATS1,9,2,311,322,7
NARS1,8,1,313,322,7
IPO11,9,2,311,322,7
NSD3,8,1,313,322,7
NAPRT,13,6,303,322,7
TRIM33,8,1,313,322,7
NSUN2,8,1,313,322,7
NAPA,13,6,303,322,7
TRIM3,8,1,313,322,7
TUBGCP4,10,3,309,322,7
STRN,8,1,313,322,7
NUAK1,9,2,311,322,7
NAIF1,8,1,313,322,7
KDM5B,9,2,311,322,7
SPANXN4,10,3,309,322,7
KDM5C,9,2,311,322,7
STS,9,2,311,322,7
KHDC1,15,8,299,322,7
STX7,9,2,311,322,7
INHBB,7,0,315,322,7
INHBA,10,3,309,322,7
SP8,11,4,307,322,7
NRDC,8,1,313,322,7
NR5A1,10,3,309,322,7
KDM1B,11,4,307,322,7
SPINT3,11,4,307,322,7
NNT,10,3,309,322,7
ITGA10,7,0,315,322,7
SPTAN1,17,10,295,322,7
NCDN,10,3,309,322,7
ISYNA1,16,9,297,322,7
NONO,8,1,313,322,7
SPOP,10,3,309,322,7
ISG15,16,9,297,322,7
NPHS1,9,2,311,322,7
NPIPB12,15,8,299,322,7
NCAPD2,11,4,307,322,7
NPTX2,14,7,301,322,7
SPEM1,18,11,293,322,7
SPIB,10,3,309,322,7
IRF3,11,4,307,322,7
IRF2BPL,16,9,297,322,7
NBPF15,8,1,313,322,7
NR1D2,7,0,315,322,7
KCTD4,18,11,293,322,7
IRF1,15,8,299,322,7
IRAK1BP1,14,7,301,322,7
IQGAP2,9,2,311,322,7
IQGAP1,8,1,313,322,7
KDELR1,9,2,311,322,7
IDH3A,11,4,307,322,7
KLHL15,10,3,309,322,7
WRAP73,12,5,305,322,7
PIN1,10,3,309,322,7
TOX4,10,3,309,322,7
VRK3,10,3,309,322,7
SLC1A4,9,2,311,322,7
SLC17A7,12,5,305,322,7
PJA1,11,4,307,322,7
MROH8,22,15,285,322,7
HGFAC,8,1,313,322,7
VSTM4,10,3,309,322,7
SLC16A1,9,2,311,322,7
PKD1L3,11,4,307,322,7
VTI1B,14,7,301,322,7
TAS2R13,12,5,305,322,7
TAS2R41,8,1,313,322,7
PKNOX1,9,2,311,322,7
SLC12A4,8,1,313,322,7
WAC,8,1,313,322,7
PLA2G4F,11,4,307,322,7
WAPL,8,1,313,322,7
PLA2G7,9,2,311,322,7
SKP2,7,0,315,322,7
SKA2,9,2,311,322,7
HECA,8,1,313,322,7
PLBD2,9,2,311,322,7
MRAP2,11,4,307,322,7
KRTAP5-7,11,4,307,322,7
PIP4K2C,9,2,311,322,7
KRT6A,7,0,315,322,7
MRPL55,12,5,305,322,7
MRPL16,10,3,309,322,7
MRPL43,11,4,307,322,7
MRPL24,10,3,309,322,7
HLA-DQA2,8,1,313,322,7
SLC25A1,10,3,309,322,7
HLA-DPA1,15,8,299,322,7
VKORC1,11,4,307,322,7
VMA21,9,2,311,322,7
TP53TG3B,27,20,275,322,7
VOPP1,9,2,311,322,7
PIGT,12,5,305,322,7
HLA-A,10,3,309,322,7
VPS16,11,4,307,322,7
HIVEP3,9,2,311,322,7
PIGZ,13,6,303,322,7
HIPK3,7,0,315,322,7
PIK3CA,10,3,309,322,7
VPS26B,9,2,311,322,7
HIP1R,8,1,313,322,7
PIK3R4,9,2,311,322,7
HINT1,9,2,311,322,7
VPS36,8,1,313,322,7
VPS37B,9,2,311,322,7
VPS39,11,4,307,322,7
VPS45,9,2,311,322,7
HIF1AN,9,2,311,322,7
WARS1,9,2,311,322,7
MPZL3,7,0,315,322,7
MPST,9,2,311,322,7
PLEKHA8,7,0,315,322,7
PMPCB,10,3,309,322,7
WDR33,8,1,313,322,7
SH3BP5,11,4,307,322,7
PNMA6E,7,0,315,322,7
MORF4L2,11,4,307,322,7
TBC1D1,8,1,313,322,7
WDR61,9,2,311,322,7
MORF4L1,9,2,311,322,7
TBC1D10C,17,10,295,322,7
LAMB1,9,2,311,322,7
LAMB2,11,4,307,322,7
SGSH,13,6,303,322,7
POLE,8,1,313,322,7
SGK2,21,14,287,322,7
POLR2J,8,1,313,322,7
WHAMM,8,1,313,322,7
POLR3A,8,1,313,322,7
TNPO3,8,1,313,322,7
LAP3,9,2,311,322,7
WIPF2,8,1,313,322,7
H2BC3,32,25,265,322,7
LAPTM4A,10,3,309,322,7
WNK2,9,2,311,322,7
SGCA,26,19,277,322,7
POMP,9,2,311,322,7
PMIS2,11,4,307,322,7
MORN2,12,5,305,322,7
HACD3,10,3,309,322,7
TOB1,11,4,307,322,7
MPPED2,11,4,307,322,7
PLEKHS1,11,4,307,322,7
TASOR,8,1,313,322,7
TOMM20,11,4,307,322,7
WASH6P,10,3,309,322,7
PLIN3,8,1,313,322,7
TOGARAM2,19,12,291,322,7
SHOX,11,4,307,322,7
HBG2,25,18,279,322,7
WASHC2C,9,2,311,322,7
SHOC1,9,2,311,322,7
SHC1,8,1,313,322,7
HACE1,10,3,309,322,7
SH3YL1,9,2,311,322,7
HAT1,8,1,313,322,7
STARD7,9,2,311,322,7
SH3RF3,8,1,313,322,7
HAND1,9,2,311,322,7
LAD1,11,4,307,322,7
PLXNA2,7,0,315,322,7
HAGHL,40,33,249,322,7
WDR18,13,6,303,322,7
SH3KBP1,8,1,313,322,7
WDR20,8,1,313,322,7
HM13,9,2,311,322,7
KPNA5,9,2,311,322,7
SYVN1,10,3,309,322,7
PCF11,12,5,305,322,7
SMARCAL1,12,5,305,322,7
PCGF5,7,0,315,322,7
USE1,10,3,309,322,7
PCM1,8,1,313,322,7
KLHL24,8,1,313,322,7
SMAD6,14,7,301,322,7
USP11,11,4,307,322,7
USP17L1,9,2,311,322,7
MTCH2,8,1,313,322,7
SMAD2,10,3,309,322,7
SLTM,11,4,307,322,7
HSPA9,9,2,311,322,7
USP20,9,2,311,322,7
KLHL28,8,1,313,322,7
USP24,9,2,311,322,7
SLF1,10,3,309,322,7
KLHL40,8,1,313,322,7
SLC9A1,8,1,313,322,7
PDE4A,8,1,313,322,7
USP42,8,1,313,322,7
USP47,7,0,315,322,7
PDE5A,14,7,301,322,7
USP53,9,2,311,322,7
TRA2A,9,2,311,322,7
UTP4,8,1,313,322,7
HTATSF1,9,2,311,322,7
UQCRB,9,2,311,322,7
TPGS2,10,3,309,322,7
TRAM1,8,1,313,322,7
UGGT2,9,2,311,322,7
SZRD1,9,2,311,322,7
PBX2,8,1,313,322,7
UGT3A2,16,9,297,322,7
SMC4,9,2,311,322,7
PC,12,5,305,322,7
KLHL2,10,3,309,322,7
PCDH11Y,8,1,313,322,7
LYNX1,11,4,307,322,7
HYAL1,17,10,295,322,7
SMC2,9,2,311,322,7
UHRF1,9,2,311,322,7
MTIF2,9,2,311,322,7
UMODL1,8,1,313,322,7
UNC13B,7,0,315,322,7
PCDHGA11,8,1,313,322,7
MTHFR,10,3,309,322,7
PCDHGB5,8,1,313,322,7
PCDHGB7,7,0,315,322,7
HTRA2,12,5,305,322,7
HTRA1,11,4,307,322,7
HTR6,13,6,303,322,7
SMARCD2,12,5,305,322,7
UPK3BL2,17,10,295,322,7
UPP1,11,4,307,322,7
SLC6A18,7,0,315,322,7
HSF4,22,15,285,322,7
PDIA3,10,3,309,322,7
SLC6A1,9,2,311,322,7
SLC35F6,8,1,313,322,7
PFN4,21,14,287,322,7
PGA5,13,6,303,322,7
TAF1A,9,2,311,322,7
KLRD1,9,2,311,322,7
HOXA2,13,6,303,322,7
SLC35B1,9,2,311,322,7
SLC29A1,10,3,309,322,7
HNRNPU,10,3,309,322,7
VGLL3,9,2,311,322,7
KMT2A,11,4,307,322,7
PGRMC2,8,1,313,322,7
PHACTR2,8,1,313,322,7
PHAX,7,0,315,322,7
PHB,9,2,311,322,7
VGLL4,12,5,305,322,7
SLC25A6,12,5,305,322,7
PHB2,9,2,311,322,7
HNRNPCL1,13,6,303,322,7
SLC25A5,11,4,307,322,7
PHF14,8,1,313,322,7
MRPS25,9,2,311,322,7
MRPS2,9,2,311,322,7
PHF3,11,4,307,322,7
MRPS18A,10,3,309,322,7
TPP2,8,1,313,322,7
TAF10,12,5,305,322,7
VCP,11,4,307,322,7
HRH4,8,1,313,322,7
SLC66A3,13,6,303,322,7
PDK4,9,2,311,322,7
PDLIM4,20,13,289,322,7
HSD17B4,8,1,313,322,7
MT1HL1,17,10,295,322,7
PDPR,9,2,311,322,7
HSD17B12,9,2,311,322,7
PDRG1,10,3,309,322,7
PDXK,9,2,311,322,7
PDYN,10,3,309,322,7
SLC44A2,11,4,307,322,7
SLC43A2,9,2,311,322,7
PEX19,12,5,305,322,7
TPRKB,10,3,309,322,7
VARS2,10,3,309,322,7
VAV2,9,2,311,322,7
HPR,13,6,303,322,7
HPD,12,5,305,322,7
KLLN,7,0,315,322,7
HP1BP3,10,3,309,322,7
PERCC1,9,2,311,322,7
HOXD3,9,2,311,322,7
PEX10,11,4,307,322,7
TPRA1,8,1,313,322,7
TMBIM1,11,4,307,322,7
ZZZ3,7,0,315,322,7
CCDC126,9,2,311,322,7
CENATAC,13,6,303,322,7
FAM193B,8,1,313,322,7
CDV3,11,4,307,322,7
EFNA5,9,2,311,322,7
EFR3B,7,0,315,322,7
DCP1A,8,1,313,322,7
CEACAM5,7,0,315,322,7
FAM189A2,8,1,313,322,7
DCHS1,8,1,313,322,7
EFTUD2,10,3,309,322,7
ACTR3,10,3,309,322,7
FCGR2B,10,3,309,322,7
FAM189A1,8,1,313,322,7
FCHSD1,11,4,307,322,7
ALDH3B1,9,2,311,322,7
ACTN4,10,3,309,322,7
ACTN1,10,3,309,322,7
CEND1,15,8,299,322,7
EHD2,9,2,311,322,7
BCR,8,1,313,322,7
EHMT1,8,1,313,322,7
EID1,9,2,311,322,7
ACTG1,10,3,309,322,7
ACTA2,19,12,291,322,7
ACSS2,11,4,307,322,7
DCAF1,7,0,315,322,7
EIF1AX,9,2,311,322,7
ACVR2A,8,1,313,322,7
EFHC1,10,3,309,322,7
CLCC1,9,2,311,322,7
FBXO7,10,3,309,322,7
ADAM9,8,1,313,322,7
ECPAS,9,2,311,322,7
ECRG4,11,4,307,322,7
BPNT1,10,3,309,322,7
CDH15,7,0,315,322,7
DDX42,9,2,311,322,7
CDH3,11,4,307,322,7
FBXO46,14,7,301,322,7
EDF1,10,3,309,322,7
DDX24,9,2,311,322,7
DDX23,9,2,311,322,7
ADAM11,8,1,313,322,7
BOLA1,17,10,295,322,7
CDR2,11,4,307,322,7
CDK4,10,3,309,322,7
ALDH18A1,9,2,311,322,7
DDOST,8,1,313,322,7
CDK6,7,0,315,322,7
DDHD1,8,1,313,322,7
EEPD1,15,8,299,322,7
FBXW2,8,1,313,322,7
CDKL5,9,2,311,322,7
DDB1,10,3,309,322,7
BMP2K,8,1,313,322,7
BMI1,10,3,309,322,7
ALDH2,10,3,309,322,7
EIF1AY,9,2,311,322,7
CEP104,8,1,313,322,7
FDFT1,9,2,311,322,7
CXorf58,14,7,301,322,7
CHMP4B,10,3,309,322,7
B3GALNT2,8,1,313,322,7
CHPT1,10,3,309,322,7
CHRD,8,1,313,322,7
ANAPC11,10,3,309,322,7
AUP1,9,2,311,322,7
ANAPC13,10,3,309,322,7
CHST3,11,4,307,322,7
ATXN7L3B,8,1,313,322,7
CHSY1,10,3,309,322,7
EML2,9,2,311,322,7
ATXN1L,7,0,315,322,7
EML3,12,5,305,322,7
CEP152,8,1,313,322,7
CXCR5,10,3,309,322,7
ATP8B1,10,3,309,322,7
FAM124A,7,0,315,322,7
CISD2,9,2,311,322,7
FGFBP3,10,3,309,322,7
FGFR1OP2,9,2,311,322,7
ATP6V1C1,8,1,313,322,7
ACACA,10,3,309,322,7
ATP6AP2,9,2,311,322,7
ACAA1,11,4,307,322,7
CUL5,10,3,309,322,7
ATP5F1A,12,5,305,322,7
CYLD,11,4,307,322,7
ELP2,11,4,307,322,7
CHGB,7,0,315,322,7
AMMECR1L,9,2,311,322,7
CEP170,11,4,307,322,7
BCL2L2,9,2,311,322,7
ACSL3,10,3,309,322,7
EIF2S2,9,2,311,322,7
ALKAL1,15,8,299,322,7
CEP57,10,3,309,322,7
BCAT2,10,3,309,322,7
EIF3J,9,2,311,322,7
FAM171B,9,2,311,322,7
DAP3,9,2,311,322,7
EIF3M,11,4,307,322,7
EIF4G1,9,2,311,322,7
EIF4G3,9,2,311,322,7
CFAP251,8,1,313,322,7
CYTH1,12,5,305,322,7
ELAVL1,10,3,309,322,7
ELAVL4,10,3,309,322,7
ACOT8,12,5,305,322,7
ELFN1,12,5,305,322,7
CGB7,14,7,301,322,7
BACE1,7,0,315,322,7
CGN,16,9,297,322,7
ELMOD1,8,1,313,322,7
B4GALNT1,13,6,303,322,7
FAM162A,10,3,309,322,7
DDX56,9,2,311,322,7
BRAF,10,3,309,322,7
CDC42SE2,15,8,299,322,7
FANCM,10,3,309,322,7
DNAJA2,9,2,311,322,7
FAM72C,24,17,281,322,7
DNAH11,9,2,311,322,7
DNAAF5,10,3,309,322,7
DNAAF3,15,8,299,322,7
ADNP2,14,7,301,322,7
ADK,10,3,309,322,7
CC2D1A,12,5,305,322,7
ADIRF,36,29,257,322,7
C2orf72,8,1,313,322,7
CCDC102A,8,1,313,322,7
CCDC102B,27,20,275,322,7
CCDC122,9,2,311,322,7
C1QBP,10,3,309,322,7
DRGX,7,0,315,322,7
DMKN,26,19,277,322,7
CCDC134,9,2,311,322,7
FARS2,9,2,311,322,7
CCDC142,9,2,311,322,7
DLX3,8,1,313,322,7
ADH4,9,2,311,322,7
DST,9,2,311,322,7
C21orf62,10,3,309,322,7
DKK4,11,4,307,322,7
C2,15,8,299,322,7
CCDC25,10,3,309,322,7
CAV1,13,6,303,322,7
CASP7,9,2,311,322,7
CASC3,10,3,309,322,7
C9orf78,9,2,311,322,7
CALM3,10,3,309,322,7
DOC2A,20,13,289,322,7
CAD,9,2,311,322,7
CACNG7,10,3,309,322,7
AGPAT3,12,5,305,322,7
CALU,9,2,311,322,7
CAMK2B,20,13,289,322,7
DOCK4,8,1,313,322,7
AGAP5,9,2,311,322,7
DNM2,10,3,309,322,7
CACNG4,10,3,309,322,7
FAM90A26,7,0,315,322,7
CAMK2D,10,3,309,322,7
CACHD1,7,0,315,322,7
CAMSAP2,10,3,309,322,7
FAM83G,9,2,311,322,7
DOK6,18,11,293,322,7
CAPN15,15,8,299,322,7
CAAP1,9,2,311,322,7
FAM91A1,8,1,313,322,7
CAPRIN1,9,2,311,322,7
CAPS,10,3,309,322,7
AFF2,7,0,315,322,7
CARHSP1,8,1,313,322,7
DPEP2,18,11,293,322,7
AK4,10,3,309,322,7
CCDC42,8,1,313,322,7
CDC42,9,2,311,322,7
CD276,9,2,311,322,7
DUSP3,9,2,311,322,7
ADD1,10,3,309,322,7
DERA,9,2,311,322,7
FAM237A,8,1,313,322,7
DVL3,9,2,311,322,7
DYDC1,23,16,283,322,7
CD1A,7,0,315,322,7
AKR1B1,11,4,307,322,7
CD200,20,13,289,322,7
FBXL7,8,1,313,322,7
ADCY9,11,4,307,322,7
DEK,9,2,311,322,7
DEFB4A,9,2,311,322,7
FAM3C,9,2,311,322,7
BTG3,12,5,305,322,7
BTBD19,12,5,305,322,7
DEFB130B,16,9,297,322,7
FBXO30,7,0,315,322,7
DEFB123,10,3,309,322,7
BROX,7,0,315,322,7
ADAR,9,2,311,322,7
BRMS1,11,4,307,322,7
FAM219B,13,6,303,322,7
CDC23,12,5,305,322,7
DEFB1,16,9,297,322,7
CDC25B,10,3,309,322,7
FBXL20,11,4,307,322,7
C11orf54,9,2,311,322,7
DESI2,8,1,313,322,7
C11orf86,11,4,307,322,7
AKAIN1,10,3,309,322,7
DTX3,16,9,297,322,7
CCDC7,9,2,311,322,7
C1orf43,9,2,311,322,7
CCDC88C,9,2,311,322,7
FAM3A,9,2,311,322,7
FAM25G,36,29,257,322,7
FAXC,7,0,315,322,7
FAM246A,10,3,309,322,7
DHRS9,11,4,307,322,7
CCL16,15,8,299,322,7
CCL24,17,10,295,322,7
C16orf89,9,2,311,322,7
DUS1L,10,3,309,322,7
C16orf72,9,2,311,322,7
CCN4,13,6,303,322,7
CCNB1IP1,9,2,311,322,7
AKAP6,12,5,305,322,7
CCNB2,8,1,313,322,7
C16orf70,8,1,313,322,7
FBRS,8,1,313,322,7
CCNG1,11,4,307,322,7
CCNH,8,1,313,322,7
CCNL1,9,2,311,322,7
ADD3,10,3,309,322,7
ABR,7,0,315,322,7
DOCK3,15,8,299,322,7
COMMD6,10,3,309,322,7
ASS1,15,8,299,322,7
API5,11,4,307,322,7
ARPC4,9,2,311,322,7
COPE,10,3,309,322,7
ATAD3A,9,2,311,322,7
CTNNA1,11,4,307,322,7
CTIF,9,2,311,322,7
CRKL,10,3,309,322,7
ARHGAP19,9,2,311,322,7
ABCC5,10,3,309,322,7
CTDSPL,13,6,303,322,7
EPHX2,10,3,309,322,7
FKBP1A,8,1,313,322,7
FMNL3,9,2,311,322,7
FAIM2,14,7,301,322,7
CMTR1,10,3,309,322,7
EPN2,11,4,307,322,7
ABCA3,13,6,303,322,7
ABHD11,9,2,311,322,7
CSH2,8,1,313,322,7
ARMT1,10,3,309,322,7
ANKRD54,9,2,311,322,7
COPS7B,11,4,307,322,7
ARHGAP33,14,7,301,322,7
COPS8,9,2,311,322,7
ATF2,9,2,311,322,7
ARMC9,11,4,307,322,7
FIBP,13,6,303,322,7
ARMC7,10,3,309,322,7
AOAH,13,6,303,322,7
ABHD14A-ACY1,26,19,277,322,7
ARL8A,11,4,307,322,7
CTDNEP1,10,3,309,322,7
FAM110B,8,1,313,322,7
ATF6,8,1,313,322,7
CLK3,10,3,309,322,7
ANPEP,13,6,303,322,7
ARFIP2,9,2,311,322,7
CLPSL1,19,12,291,322,7
CLIC1,10,3,309,322,7
ASH1L,8,1,313,322,7
CLIP1,9,2,311,322,7
ANP32A,10,3,309,322,7
CPSF4,11,4,307,322,7
ARFGEF1,9,2,311,322,7
ABCF1,9,2,311,322,7
ESRP1,19,12,291,322,7
ASCL3,14,7,301,322,7
ASB8,9,2,311,322,7
ESRP2,21,14,287,322,7
ARCN1,8,1,313,322,7
ARAP2,9,2,311,322,7
ABCF3,12,5,305,322,7
ART3,14,7,301,322,7
AAMP,11,4,307,322,7
CLPTM1L,9,2,311,322,7
CST9,9,2,311,322,7
FIS1,11,4,307,322,7
FLII,13,6,303,322,7
EPHB1,16,9,297,322,7
ARRDC5,8,1,313,322,7
ANTXR1,8,1,313,322,7
ETFB,12,5,305,322,7
CTBP2,10,3,309,322,7
CSNK2A1,9,2,311,322,7
AQP4,12,5,305,322,7
APPL2,12,5,305,322,7
ATF4,12,5,305,322,7
COL17A1,14,7,301,322,7
CLN8,9,2,311,322,7
ARHGEF17,7,0,315,322,7
ATP13A3,8,1,313,322,7
EXT1,8,1,313,322,7
FGL1,8,1,313,322,7
ATG9A,11,4,307,322,7
CRYZL1,8,1,313,322,7
CTSV,8,1,313,322,7
FLOT2,9,2,311,322,7
ANKRD11,11,4,307,322,7
A3GALT2,18,11,293,322,7
AP3B1,8,1,313,322,7
ARIH2,8,1,313,322,7
CNTROB,10,3,309,322,7
EP300,9,2,311,322,7
COX15,7,0,315,322,7
AP3B2,11,4,307,322,7
ABI2,9,2,311,322,7
AAAS,9,2,311,322,7
FLNB,9,2,311,322,7
ATF7,8,1,313,322,7
CLDN10,8,1,313,322,7
COX16,10,3,309,322,7
FAM114A2,9,2,311,322,7
AP1G1,9,2,311,322,7
CLDN12,11,4,307,322,7
FAM117B,7,0,315,322,7
ERBIN,9,2,311,322,7
ARHGAP45,9,2,311,322,7
COA8,11,4,307,322,7
CNTN2,11,4,307,322,7
ARID1A,11,4,307,322,7
AOX1,13,6,303,322,7
CTR9,10,3,309,322,7
COX5B,10,3,309,322,7
ARL6IP5,7,0,315,322,7
CTXND2,8,1,313,322,7
SLC35E3,7,1,314,322,6
ERVV-1,10,4,308,322,6
SND1,9,3,310,322,6
TMEM94,11,5,306,322,6
ARHGEF26,6,0,316,322,6
HSPBAP1,6,0,316,322,6
KLHDC8B,12,6,304,322,6
HSPBP1,12,6,304,322,6
DTYMK,8,2,312,322,6
SNAPC5,9,3,310,322,6
SNAPC4,8,2,312,322,6
TMPO,8,2,312,322,6
SLC29A4,8,2,312,322,6
BTBD16,10,4,308,322,6
DZANK1,9,3,310,322,6
KLHDC10,6,0,316,322,6
SLC2A12,11,5,306,322,6
C18orf54,6,0,316,322,6
IDS,9,3,310,322,6
SNAPC1,6,0,316,322,6
SNAP91,11,5,306,322,6
BTF3L4,8,2,312,322,6
KLC1,9,3,310,322,6
IDNK,9,3,310,322,6
SNAI2,21,15,286,322,6
SLC30A5,10,4,308,322,6
SLC38A10,7,1,314,322,6
HYOU1,9,3,310,322,6
SLC40A1,12,6,304,322,6
TMEM80,11,5,306,322,6
SMG7,8,2,312,322,6
SLFN11,11,5,306,322,6
KNG1,6,0,316,322,6
TMEM238L,7,1,314,322,6
TMEM245,7,1,314,322,6
SLIRP,10,4,308,322,6
SLC27A4,7,1,314,322,6
ERLIN1,6,0,316,322,6
KMT2B,13,7,302,322,6
DYDC2,11,5,306,322,6
ERI3,9,3,310,322,6
IAH1,10,4,308,322,6
DUXB,11,5,306,322,6
C10orf90,10,4,308,322,6
ARHGAP4,19,13,290,322,6
SLX4IP,7,1,314,322,6
TMEM258,11,5,306,322,6
KLRK1,13,7,302,322,6
SLURP2,9,3,310,322,6
DYNC1LI2,11,5,306,322,6
TMEM39B,11,5,306,322,6
KPNA3,7,1,314,322,6
TMEM222,9,3,310,322,6
ID4,11,5,306,322,6
TMEM70,8,2,312,322,6
SLC44A4,9,3,310,322,6
C12orf75,13,7,302,322,6
TMEM67,10,4,308,322,6
KRT18,9,3,310,322,6
SLC6A15,10,4,308,322,6
DYNLL2,7,1,314,322,6
DYNC2I2,12,6,304,322,6
SMIM11B,40,34,248,322,6
TMEM50B,10,4,308,322,6
C12orf50,14,8,300,322,6
SLC6A9,11,5,306,322,6
SLC8B1,7,1,314,322,6
SLC9A5,9,3,310,322,6
KLHL3,11,5,306,322,6
TMEM44,10,4,308,322,6
ICE1,6,0,316,322,6
SMIM22,27,21,274,322,6
TBCCD1,9,3,310,322,6
KRTAP2-2,11,5,306,322,6
AP5Z1,11,5,306,322,6
TRAPPC6B,10,4,308,322,6
SELENOS,9,3,310,322,6
DONSON,10,4,308,322,6
AP3S1,8,2,312,322,6
TRAPPC2L,13,7,302,322,6
SEMA3F,11,5,306,322,6
LGALS3BP,12,6,304,322,6
TRAK1,9,3,310,322,6
TRAFD1,10,4,308,322,6
SEMA4B,12,6,304,322,6
SEMA4F,7,1,314,322,6
EXD2,10,4,308,322,6
SEMG1,6,0,316,322,6
SLC25A23,10,4,308,322,6
SENP1,8,2,312,322,6
SENP2,7,1,314,322,6
LEMD2,11,5,306,322,6
C8orf34,9,3,310,322,6
SERINC2,10,4,308,322,6
C7orf57,9,3,310,322,6
LDLRAD1,6,0,316,322,6
HOXC11,10,4,308,322,6
SERPINB5,10,4,308,322,6
SERTAD2,6,0,316,322,6
SESTD1,14,8,300,322,6
LCOR,27,21,274,322,6
TRARG1,7,1,314,322,6
LGI3,7,1,314,322,6
SELENOH,8,2,312,322,6
SELENOF,8,2,312,322,6
SCRG1,8,2,312,322,6
CAGE1,7,1,314,322,6
CADM4,12,6,304,322,6
SCYGR1,9,3,310,322,6
AP2S1,10,4,308,322,6
HNRNPA3,8,2,312,322,6
HNRNPAB,8,2,312,322,6
TRBV10-1,6,0,316,322,6
SCYGR8,7,1,314,322,6
HNRNPD,9,3,310,322,6
LIN52,9,3,310,322,6
EXOSC10,9,3,310,322,6
HNRNPH2,7,1,314,322,6
EXOSC1,10,4,308,322,6
LIMS1,7,1,314,322,6
DOCK7,12,6,304,322,6
LILRB3,7,1,314,322,6
SEC13,8,2,312,322,6
SEC22C,11,5,306,322,6
SEC24A,6,0,316,322,6
SEC24C,9,3,310,322,6
CACNA1A,12,6,304,322,6
HNRNPR,9,3,310,322,6
CABYR,16,10,296,322,6
AP3M1,7,1,314,322,6
C5orf63,9,3,310,322,6
APELA,15,9,298,322,6
SETD3,8,2,312,322,6
SHLD2,7,1,314,322,6
C2CD2L,7,1,314,322,6
C22orf23,18,12,292,322,6
TNK2,14,8,300,322,6
C20orf96,8,2,312,322,6
SIRPB2,9,3,310,322,6
C20orf173,10,4,308,322,6
KTN1,12,6,304,322,6
C1QTNF9B,14,8,300,322,6
SLA,9,3,310,322,6
SLAMF7,8,2,312,322,6
ARAF,10,4,308,322,6
ETDA,15,9,298,322,6
KRTAP6-1,14,8,300,322,6
DTX2,11,5,306,322,6
ARF3,7,1,314,322,6
HSFX2,29,23,270,322,6
C1orf21,6,0,316,322,6
C1orf194,22,16,284,322,6
ARF5,11,5,306,322,6
C1orf109,9,3,310,322,6
TMUB1,11,5,306,322,6
SLC25A14,7,1,314,322,6
KRTAP21-3,9,3,310,322,6
SLC25A19,10,4,308,322,6
ESRRB,7,1,314,322,6
SHOC2,10,4,308,322,6
APOO,9,3,310,322,6
C5orf51,7,1,314,322,6
TNRC6A,8,2,312,322,6
C5orf47,7,1,314,322,6
APEX1,9,3,310,322,6
C4orf48,23,17,282,322,6
SFN,17,11,294,322,6
EVI5,8,2,312,322,6
SFRP1,7,1,314,322,6
DRAP1,9,3,310,322,6
SGCE,8,2,312,322,6
TPM1,10,4,308,322,6
C4B,28,22,272,322,6
LATS1,7,1,314,322,6
C2orf78,8,2,312,322,6
APMAP,9,3,310,322,6
TOR1B,8,2,312,322,6
TOP2B,9,3,310,322,6
TOMM70,7,1,314,322,6
C2orf68,9,3,310,322,6
TOMM40,11,5,306,322,6
TNS2,8,2,312,322,6
LAMTOR1,11,5,306,322,6
HRK,6,0,316,322,6
LAMP5,8,2,312,322,6
LAMP3,8,2,312,322,6
LAMP1,9,3,310,322,6
LAMC3,8,2,312,322,6
SNRNP40,7,1,314,322,6
SOCS6,8,2,312,322,6
SNRPB,10,4,308,322,6
B4GAT1,9,3,310,322,6
B4GALT1,9,3,310,322,6
SUCO,7,1,314,322,6
TEP1,9,3,310,322,6
ATAT1,10,4,308,322,6
IQCC,9,3,310,322,6
SULF2,16,10,296,322,6
ELOC,9,3,310,322,6
SULT1A1,14,8,300,322,6
SULT1C2,10,4,308,322,6
IPO9,9,3,310,322,6
IPO8,12,6,304,322,6
IPO7,9,3,310,322,6
ATF1,8,2,312,322,6
IPO5,9,3,310,322,6
IPMK,7,1,314,322,6
SUMO3,8,2,312,322,6
SUN3,12,6,304,322,6
INTS5,10,4,308,322,6
ELP1,7,1,314,322,6
INTS2,7,1,314,322,6
INTS10,11,5,306,322,6
SUPT20H,8,2,312,322,6
SUPT3H,7,1,314,322,6
SUPT5H,9,3,310,322,6
INSM2,7,1,314,322,6
STXBP1,13,7,302,322,6
BABAM2,8,2,312,322,6
SURF2,12,6,304,322,6
ASZ1,8,2,312,322,6
ITPR2,10,4,308,322,6
TEX52,12,6,304,322,6
EPG5,6,0,316,322,6
ITPKC,11,5,306,322,6
EIF3K,10,4,308,322,6
ITLN2,10,4,308,322,6
BBS9,8,2,312,322,6
STAT2,8,2,312,322,6
ASPHD2,8,2,312,322,6
ITGAM,14,8,300,322,6
BARX2,7,1,314,322,6
ITFG2,16,10,296,322,6
STK35,8,2,312,322,6
STK4,10,4,308,322,6
TEX35,8,2,312,322,6
ISLR2,9,3,310,322,6
STK40,11,5,306,322,6
STMND1,18,12,292,322,6
ASRGL1,8,2,312,322,6
BANF2,14,8,300,322,6
IRX5,11,5,306,322,6
STOX2,14,8,300,322,6
STRBP,10,4,308,322,6
STRIT1,23,17,282,322,6
ASXL2,8,2,312,322,6
INSL6,12,6,304,322,6
TEFM,9,3,310,322,6
TF,10,4,308,322,6
TACO1,8,2,312,322,6
TADA3,8,2,312,322,6
ENDOV,15,9,298,322,6
ATP7B,9,3,310,322,6
TAF4,9,3,310,322,6
TAF6,8,2,312,322,6
TCL1B,10,4,308,322,6
ATP7A,9,3,310,322,6
ENOPH1,8,2,312,322,6
TAGAP,6,0,316,322,6
TAGLN2,13,7,302,322,6
IL1RL2,11,5,306,322,6
TANK,8,2,312,322,6
ATP6V0A2,7,1,314,322,6
TCEAL2,6,0,316,322,6
ATP5PF,10,4,308,322,6
IL17RE,9,3,310,322,6
ATP5PB,11,5,306,322,6
IGLV5-48,8,2,312,322,6
IL17D,20,14,288,322,6
ATP5MC3,10,4,308,322,6
ATP5MC1,11,5,306,322,6
IL11RA,9,3,310,322,6
IKZF2,11,5,306,322,6
TBC1D15,6,0,316,322,6
ENY2,8,2,312,322,6
TACR2,9,3,310,322,6
ATPAF1,8,2,312,322,6
SURF6,7,1,314,322,6
TACC1,9,3,310,322,6
EMC1,7,1,314,322,6
SVBP,9,3,310,322,6
INPP4B,7,1,314,322,6
AXL,9,3,310,322,6
AVPR1B,6,0,316,322,6
AVP,12,6,304,322,6
EMD,10,4,308,322,6
SYNCRIP,8,2,312,322,6
IGKV3D-7,6,0,316,322,6
TECPR2,6,0,316,322,6
INAFM1,13,7,302,322,6
SYNJ2BP-COX16,20,14,288,322,6
ATF7IP,11,5,306,322,6
IMPDH2,12,6,304,322,6
IMPDH1,10,4,308,322,6
SYT1,17,11,294,322,6
TCTN3,8,2,312,322,6
ILKAP,8,2,312,322,6
ATXN7,6,0,316,322,6
TCTEX1D4,22,16,284,322,6
IL9R,8,2,312,322,6
TCTA,8,2,312,322,6
ATG3,9,3,310,322,6
TCP11L1,8,2,312,322,6
ATRAID,10,4,308,322,6
IGHV7-81,7,1,314,322,6
ST6GALNAC1,20,14,288,322,6
TMEM184B,10,4,308,322,6
TMEM116,12,6,304,322,6
KIAA0100,10,4,308,322,6
SOST,11,5,306,322,6
EDARADD,9,3,310,322,6
EDDM13,19,13,290,322,6
SOX1,6,0,316,322,6
TMEM11,15,9,298,322,6
EDEM1,6,0,316,322,6
ARL6IP4,9,3,310,322,6
BORCS8,7,1,314,322,6
SOX5,12,6,304,322,6
EDEM3,8,2,312,322,6
IFNL4,6,0,316,322,6
TMED9,12,6,304,322,6
SP3,6,0,316,322,6
SP7,7,1,314,322,6
ARMCX6,9,3,310,322,6
EEF1AKMT1,15,9,298,322,6
SPAG7,8,2,312,322,6
BOC,13,7,302,322,6
BNIP3L,9,3,310,322,6
BNC2,8,2,312,322,6
IGF2BP1,7,1,314,322,6
TM4SF19-DYNLT2B,33,27,262,322,6
SPATA21,15,9,298,322,6
TLR2,10,4,308,322,6
SOGA3,23,17,282,322,6
SOGA1,8,2,312,322,6
KCNV2,8,2,312,322,6
ECT2L,10,4,308,322,6
EBNA1BP2,10,4,308,322,6
EBP,12,6,304,322,6
SNRPD1,10,4,308,322,6
SNU13,11,5,306,322,6
SNW1,8,2,312,322,6
IER3IP1,9,3,310,322,6
BRI3,8,2,312,322,6
TMEM178A,15,9,298,322,6
KIF1C,8,2,312,322,6
SNX18,11,5,306,322,6
ECI1,8,2,312,322,6
SNX2,8,2,312,322,6
BRD8,12,6,304,322,6
SNX27,7,1,314,322,6
KIAA2013,10,4,308,322,6
TMEM174,6,0,316,322,6
KIAA2012,10,4,308,322,6
KIAA1958,7,1,314,322,6
IFI6,11,5,306,322,6
SNX7,7,1,314,322,6
IFITM10,8,2,312,322,6
ARL5A,7,1,314,322,6
KIAA1549,6,0,316,322,6
ARL5B,7,1,314,322,6
IFNE,9,3,310,322,6
SPATA4,14,8,300,322,6
BMPER,8,2,312,322,6
EIF3I,7,1,314,322,6
SRI,10,4,308,322,6
THAP4,9,3,310,322,6
BCORL1,9,3,310,322,6
TGIF2,10,4,308,322,6
SRSF10,8,2,312,322,6
TGFB2,9,3,310,322,6
KANK2,9,3,310,322,6
BCL7B,8,2,312,322,6
BCL7A,7,1,314,322,6
ASGR2,8,2,312,322,6
TFIP11,11,5,306,322,6
EIF1B,9,3,310,322,6
EIF2AK1,8,2,312,322,6
TFF1,19,13,290,322,6
EIF2AK2,7,1,314,322,6
SS18L2,8,2,312,322,6
TFDP2,11,5,306,322,6
EIF2B2,10,4,308,322,6
EIF2B4,10,4,308,322,6
TFAP4,10,4,308,322,6
SSR1,9,3,310,322,6
SSR3,9,3,310,322,6
SSX4B,6,0,316,322,6
EIF3C,12,6,304,322,6
TFAP2A,9,3,310,322,6
LIPA,7,1,314,322,6
THAP5,9,3,310,322,6
SRGN,13,7,302,322,6
SPATA46,13,7,302,322,6
BECN1,8,2,312,322,6
SPATA6L,6,0,316,322,6
BMP5,6,0,316,322,6
TLK2,8,2,312,322,6
ARRB2,11,5,306,322,6
EFHD2,8,2,312,322,6
BLVRB,12,6,304,322,6
ARRDC1,12,6,304,322,6
KCNJ12,7,1,314,322,6
BHLHB9,12,6,304,322,6
ARRDC4,11,5,306,322,6
TKFC,10,4,308,322,6
TJP3,15,9,298,322,6
SPRR2E,6,0,316,322,6
KCNE2,13,7,302,322,6
TJP1,8,2,312,322,6
EPHB2,7,1,314,322,6
SPTLC1,8,2,312,322,6
SPZ1,8,2,312,322,6
KCNA7,7,1,314,322,6
SRCAP,11,5,306,322,6
ART4,6,0,316,322,6
SRD5A1,9,3,310,322,6
THOC5,12,6,304,322,6
THBS4,9,3,310,322,6
BEND3,7,1,314,322,6
ST3GAL3,9,3,310,322,6
FNTA,8,2,312,322,6
SCOC,9,3,310,322,6
SCNM1,8,2,312,322,6
CWC15,7,1,314,322,6
CLASP2,8,2,312,322,6
CLASRP,12,6,304,322,6
CUL4A,9,3,310,322,6
NAT10,8,2,312,322,6
PIK3C3,9,3,310,322,6
NAT8L,6,0,316,322,6
PIH1D2,11,5,306,322,6
NBAS,7,1,314,322,6
NBDY,15,9,298,322,6
NBEA,7,1,314,322,6
PIGG,10,4,308,322,6
NBPF4,14,8,300,322,6
CTXN1,15,9,298,322,6
CTU2,14,8,300,322,6
NAP1L1,8,2,312,322,6
NANOS2,9,3,310,322,6
PINK1,11,5,306,322,6
NAA60,9,3,310,322,6
CIAO2A,9,3,310,322,6
MYT1,14,8,300,322,6
PLAC9,23,17,282,322,6
CXCR3,9,3,310,322,6
PLA1A,10,4,308,322,6
PKP2,7,1,314,322,6
CISD1,7,1,314,322,6
PIP5K1A,8,2,312,322,6
PKD2L2,12,6,304,322,6
CIZ1,8,2,312,322,6
PITPNM1,10,4,308,322,6
NAGK,8,2,312,322,6
PITPNA,8,2,312,322,6
CKAP4,9,3,310,322,6
PIAS2,12,6,304,322,6
PHYKPL,13,7,302,322,6
CTSL,8,2,312,322,6
CLEC19A,9,3,310,322,6
PHF5A,8,2,312,322,6
NDRG4,16,10,296,322,6
NDUFA10,10,4,308,322,6
CLDND1,10,4,308,322,6
CTDP1,11,5,306,322,6
PHACTR1,14,8,300,322,6
PGK1,9,3,310,322,6
NDFIP2,7,1,314,322,6
PGGHG,8,2,312,322,6
PGBD5,7,1,314,322,6
NDUFB8,11,5,306,322,6
NDUFS2,9,3,310,322,6
PGAP2,11,5,306,322,6
NDUFS6,10,4,308,322,6
NDN,6,0,316,322,6
PHF6,9,3,310,322,6
PHTF1,7,1,314,322,6
NCLN,8,2,312,322,6
CTSH,9,3,310,322,6
CTSF,10,4,308,322,6
CTSD,13,7,302,322,6
CTSB,8,2,312,322,6
CTSA,9,3,310,322,6
NCL,9,3,310,322,6
CTRL,18,12,292,322,6
NDE1,8,2,312,322,6
PHLDA2,13,7,302,322,6
NCOA3,7,1,314,322,6
PHKG2,9,3,310,322,6
CLDN2,12,6,304,322,6
CTNND2,7,1,314,322,6
PHKA1,6,0,316,322,6
CHUK,8,2,312,322,6
MYOZ2,7,1,314,322,6
MYOT,9,3,310,322,6
MTNR1A,11,5,306,322,6
POTEB3,6,0,316,322,6
CHCHD1,9,3,310,322,6
CYP3A43,13,7,302,322,6
MTMR14,10,4,308,322,6
POMGNT1,9,3,310,322,6
POM121,8,2,312,322,6
CHD8,9,3,310,322,6
POU2AF1,11,5,306,322,6
MTRF1L,7,1,314,322,6
POLR2M,10,4,308,322,6
POLR2J3,8,2,312,322,6
POLR2F,11,5,306,322,6
CYP2A7,10,4,308,322,6
POLR1A,8,2,312,322,6
POTEI,8,2,312,322,6
MTHFD1L,8,2,312,322,6
MTX2,8,2,312,322,6
PPIP5K1,12,6,304,322,6
MSR1,20,14,288,322,6
PPP1R14D,20,14,288,322,6
PPP1R11,7,1,314,322,6
MT-CYB,12,6,304,322,6
PPM1B,9,3,310,322,6
MT1B,21,15,286,322,6
MT1X,18,12,292,322,6
POU3F3,7,1,314,322,6
CFHR3,9,3,310,322,6
PPIA,9,3,310,322,6
CYP4F2,12,6,304,322,6
MTERF2,15,9,298,322,6
MTFR1L,9,3,310,322,6
POU5F1,10,4,308,322,6
POLG,16,10,296,322,6
PODXL2,11,5,306,322,6
MYOD1,6,0,316,322,6
MYO19,9,3,310,322,6
MYL12B,11,5,306,322,6
CYB5D2,10,4,308,322,6
PLLP,10,4,308,322,6
PLK5,12,6,304,322,6
CHRND,10,4,308,322,6
PLEKHF2,8,2,312,322,6
MYO1B,10,4,308,322,6
PLPP7,9,3,310,322,6
PLEKHB2,7,1,314,322,6
PLEKHA6,17,11,294,322,6
MYO5A,7,1,314,322,6
PLCXD2,7,1,314,322,6
PLCL2,8,2,312,322,6
MYOCD,8,2,312,322,6
MYL12A,12,6,304,322,6
MYH9,10,4,308,322,6
MUC6,15,9,298,322,6
PMS2,7,1,314,322,6
POC1A,11,5,306,322,6
CHM,8,2,312,322,6
CHML,8,2,312,322,6
PNMA8C,7,1,314,322,6
CHMP3,7,1,314,322,6
CHMP4A,7,1,314,322,6
CHP2,7,1,314,322,6
PLRG1,9,3,310,322,6
CHPF,8,2,312,322,6
PLXNB2,17,11,294,322,6
MYH15,6,0,316,322,6
PLTP,8,2,312,322,6
PLS1,10,4,308,322,6
MYH7B,17,11,294,322,6
PFKP,9,3,310,322,6
NECAP2,12,6,304,322,6
NECTIN2,10,4,308,322,6
OR2S2,10,4,308,322,6
OR56A4,8,2,312,322,6
OR52L1,8,2,312,322,6
CRACD,18,12,292,322,6
NR2F6,10,4,308,322,6
NR3C2,6,0,316,322,6
OR51E2,8,2,312,322,6
COMMD9,8,2,312,322,6
OR5B12,6,0,316,322,6
COMP,6,0,316,322,6
NRP1,12,6,304,322,6
OR1M1,6,0,316,322,6
OR1J2,6,0,316,322,6
NSF,8,2,312,322,6
OR1A1,9,3,310,322,6
NR1D1,13,7,302,322,6
COMMD10,8,2,312,322,6
NSMCE2,9,3,310,322,6
OS9,9,3,310,322,6
OTUD4,6,0,316,322,6
COL6A1,8,2,312,322,6
COL6A5,6,0,316,322,6
COL9A1,7,1,314,322,6
OSBPL10,9,3,310,322,6
OSBP,7,1,314,322,6
ORC5,9,3,310,322,6
NPY,13,7,302,322,6
OR7G2,7,1,314,322,6
NPLOC4,8,2,312,322,6
NPPA,15,9,298,322,6
CREG1,9,3,310,322,6
NPRL2,10,4,308,322,6
OR5P3,9,3,310,322,6
COP 1,8,2,312,322,6
NSMCE3,6,0,316,322,6
CRLF1,21,15,286,322,6
NXPH3,11,5,306,322,6
CPA5,29,23,270,322,6
OBI1,7,1,314,322,6
COX14,12,6,304,322,6
COX8A,11,5,306,322,6
NYNRIN,7,1,314,322,6
COX7C,13,7,302,322,6
NUP210L,11,5,306,322,6
ODC1,10,4,308,322,6
COX20,10,4,308,322,6
NUP62,9,3,310,322,6
NUP62CL,8,2,312,322,6
NWD1,9,3,310,322,6
NVL,8,2,312,322,6
COX7A2,9,3,310,322,6
OCEL1,13,7,302,322,6
OGA,10,4,308,322,6
NSMF,12,6,304,322,6
NTAQ1,9,3,310,322,6
COPB1,8,2,312,322,6
COPB2,8,2,312,322,6
COPG1,10,4,308,322,6
OR10G3,7,1,314,322,6
NT5C2,6,0,316,322,6
NT5DC2,10,4,308,322,6
OOSP3,19,13,290,322,6
OGG1,9,3,310,322,6
NTRK2,8,2,312,322,6
NTS,9,3,310,322,6
NUBP2,11,5,306,322,6
NUCKS1,10,4,308,322,6
OLA1,7,1,314,322,6
OGT,8,2,312,322,6
OTUD6A,14,8,300,322,6
COL20A1,10,4,308,322,6
PEPD,10,4,308,322,6
NHLH2,6,0,316,322,6
NFKB1,7,1,314,322,6
PDE3B,6,0,316,322,6
CMC1,12,6,304,322,6
PDE12,8,2,312,322,6
PDCD5,10,4,308,322,6
PDCD11,7,1,314,322,6
PCNX1,8,2,312,322,6
CSNK1E,10,4,308,322,6
PCMT1,9,3,310,322,6
CSHL1,9,3,310,322,6
CNGA1,12,6,304,322,6
NIPA2,8,2,312,322,6
NIPAL3,6,0,316,322,6
CSH1,11,5,306,322,6
NFIX,8,2,312,322,6
CSNK1G2,11,5,306,322,6
NKAPD1,7,1,314,322,6
CSTB,10,4,308,322,6
PEG3,7,1,314,322,6
CT45A3,28,22,272,322,6
NEK6,10,4,308,322,6
CSTF3,12,6,304,322,6
NELFB,10,4,308,322,6
CSTF2T,7,1,314,322,6
PDZD2,6,0,316,322,6
NFAT5,8,2,312,322,6
CLOCK,7,1,314,322,6
PDS5A,8,2,312,322,6
NEU1,11,5,306,322,6
PDLIM2,11,5,306,322,6
NEUROD2,8,2,312,322,6
PDK3,8,2,312,322,6
CNIH1,8,2,312,322,6
PCDHA13,6,0,316,322,6
NOSTRIN,17,11,294,322,6
COA3,9,3,310,322,6
NMT1,9,3,310,322,6
NMT2,6,0,316,322,6
CRTC1,10,4,308,322,6
CRTAP,7,1,314,322,6
PAK1,7,1,314,322,6
COA1,9,3,310,322,6
PACSIN2,11,5,306,322,6
CNTNAP3,6,0,316,322,6
NOL3,14,8,300,322,6
NOL4L,12,6,304,322,6
COG4,10,4,308,322,6
NOP10,10,4,308,322,6
PA2G4,8,2,312,322,6
NOP9,9,3,310,322,6
PAM,10,4,308,322,6
CRYBB2,12,6,304,322,6
PCDHA11,13,7,302,322,6
CRYL1,6,0,316,322,6
CSDE1,8,2,312,322,6
CNKSR2,8,2,312,322,6
CNKSR3,9,3,310,322,6
NKX1-1,6,0,316,322,6
NKX2-4,9,3,310,322,6
CNNM3,7,1,314,322,6
NLGN1,14,8,300,322,6
PARG,7,1,314,322,6
NLGN4X,10,4,308,322,6
CNOT8,10,4,308,322,6
PAX6,16,10,296,322,6
PARVB,7,1,314,322,6
PARVA,7,1,314,322,6
CNR2,8,2,312,322,6
CFAP157,14,8,300,322,6
PPP1R9A,10,4,308,322,6
PPP2CA,7,1,314,322,6
CCDC93,7,1,314,322,6
MAN2B1,11,5,306,322,6
DICER1,9,3,310,322,6
MAP1LC3B,13,7,302,322,6
CCDC92,10,4,308,322,6
DHX38,10,4,308,322,6
MAP3K10,12,6,304,322,6
CCK,19,13,290,322,6
CCDC77,7,1,314,322,6
RHOBTB3,9,3,310,322,6
MAP3K7CL,11,5,306,322,6
DHX16,12,6,304,322,6
RHNO1,7,1,314,322,6
RHCG,8,2,312,322,6
CCL19,13,7,302,322,6
RNASE13,7,1,314,322,6
RNF103,7,1,314,322,6
MAPK14,9,3,310,322,6
RNH1,10,4,308,322,6
LYRM4,9,3,310,322,6
RPL15,10,4,308,322,6
ROCK2,8,2,312,322,6
MAEA,10,4,308,322,6
CCDC184,8,2,312,322,6
RNPEPL1,9,3,310,322,6
RNFT2,6,0,316,322,6
MAMDC2,8,2,312,322,6
RNF227,9,3,310,322,6
CCDC40,12,6,304,322,6
RNF185,7,1,314,322,6
RNF152,8,2,312,322,6
MAGEF1,8,2,312,322,6
MAGI2,10,4,308,322,6
RHBDD1,9,3,310,322,6
RGS12,10,4,308,322,6
RPL32,10,4,308,322,6
MCF2L2,7,1,314,322,6
MBLAC1,13,7,302,322,6
MBOAT4,9,3,310,322,6
RBMX2,8,2,312,322,6
RBMX,10,4,308,322,6
RBM8A,9,3,310,322,6
RBM6,7,1,314,322,6
MCHR1,6,0,316,322,6
DFFA,7,1,314,322,6
CCT8L2,7,1,314,322,6
RBM19,7,1,314,322,6
RBBP7,8,2,312,322,6
RBBP5,6,0,316,322,6
RAX,7,1,314,322,6
CD1D,8,2,312,322,6
DEXI,13,7,302,322,6
CCNT1,10,4,308,322,6
MAPK8IP3,10,4,308,322,6
RETREG2,9,3,310,322,6
DHPS,13,7,302,322,6
CCM2,10,4,308,322,6
CCN2,19,13,290,322,6
RFLNB,6,0,316,322,6
DGKZ,12,6,304,322,6
RFC1,9,3,310,322,6
CCNDBP1,9,3,310,322,6
RCL1,12,6,304,322,6
RERG,16,10,296,322,6
REPIN1,10,4,308,322,6
REEP2,12,6,304,322,6
REELD1,13,7,302,322,6
MAT2A,10,4,308,322,6
REC8,17,11,294,322,6
RPL31,10,4,308,322,6
LYPLA1,10,4,308,322,6
CD24,11,5,306,322,6
SAMD7,6,0,316,322,6
LPIN1,8,2,312,322,6
CAMSAP3,9,3,310,322,6
CAMTA2,8,2,312,322,6
CAND1,7,1,314,322,6
SAR1A,9,3,310,322,6
SAMHD1,7,1,314,322,6
SAMD12,11,5,306,322,6
DNASE2,7,1,314,322,6
CAPN8,26,20,276,322,6
LRP11,9,3,310,322,6
CARD14,10,4,308,322,6
S100B,16,10,296,322,6
CARM1,9,3,310,322,6
CARMIL2,19,13,290,322,6
SAT2,10,4,308,322,6
SBF1,9,3,310,322,6
CARTPT,7,1,314,322,6
CALR,11,5,306,322,6
SCN3A,7,1,314,322,6
SCML1,7,1,314,322,6
SCGB1D1,16,10,296,322,6
DNTTIP2,9,3,310,322,6
SCGB1C2,11,5,306,322,6
LMBRD1,11,5,306,322,6
CAMK1,12,6,304,322,6
LONP1,8,2,312,322,6
SCAMP2,8,2,312,322,6
DNM1,10,4,308,322,6
LMOD3,8,2,312,322,6
DND1,15,9,298,322,6
SCAF8,8,2,312,322,6
SCAF1,14,8,300,322,6
RXRB,10,4,308,322,6
CASP10,7,1,314,322,6
LYPD6B,17,11,294,322,6
RPP30,7,1,314,322,6
RPS27,12,6,304,322,6
LTC4S,31,25,266,322,6
LTN1,8,2,312,322,6
CC2D2A,9,3,310,322,6
CCAR2,11,5,306,322,6
CCBE1,8,2,312,322,6
AP1M2,17,11,294,322,6
RPS28,10,4,308,322,6
CCDC130,12,6,304,322,6
DMC1,7,1,314,322,6
DMAP1,11,5,306,322,6
LYPD2,12,6,304,322,6
RPL36A,12,6,304,322,6
RPL35A,11,5,306,322,6
CBWD5,7,1,314,322,6
DNA2,8,2,312,322,6
DNAJC11,8,2,312,322,6
DNAH8,7,1,314,322,6
RTL5,7,1,314,322,6
CASQ1,15,9,298,322,6
DNAJB12,8,2,312,322,6
RSRC2,11,5,306,322,6
CASTOR1,27,21,274,322,6
CAT,9,3,310,322,6
RRAGC,7,1,314,322,6
LSP1,9,3,310,322,6
RPS6KA4,9,3,310,322,6
LSM2,8,2,312,322,6
LSM3,8,2,312,322,6
RPS6,13,7,302,322,6
CBR3,11,5,306,322,6
LSM8,11,5,306,322,6
CD200R1,9,3,310,322,6
RASAL2,6,0,316,322,6
PPP2R2D,12,6,304,322,6
DCAF6,9,3,310,322,6
CEBPG,10,4,308,322,6
MOV10,10,4,308,322,6
DCBLD2,6,0,316,322,6
MPC1,9,3,310,322,6
MPDZ,12,6,304,322,6
PRR14L,9,3,310,322,6
PRR14,9,3,310,322,6
PRTFDC1,10,4,308,322,6
PRR13,9,3,310,322,6
PRR11,7,1,314,322,6
CENPA,9,3,310,322,6
PRPH,16,10,296,322,6
PRPF6,10,4,308,322,6
MPV17L2,12,6,304,322,6
CEBPD,19,13,290,322,6
CEACAM20,7,1,314,322,6
PRPF38B,8,2,312,322,6
PSMD1,9,3,310,322,6
PSMD4,9,3,310,322,6
MMP24OS,8,2,312,322,6
CDON,9,3,310,322,6
MMP28,17,11,294,322,6
PSMD12,6,0,316,322,6
CDR2L,8,2,312,322,6
PSMC4,9,3,310,322,6
MOB3B,7,1,314,322,6
MNAT1,9,3,310,322,6
PSMC2,9,3,310,322,6
CDS2,9,3,310,322,6
PSMB6,10,4,308,322,6
MOAP1,8,2,312,322,6
MOB1A,8,2,312,322,6
PRPF40A,8,2,312,322,6
PRPF38A,7,1,314,322,6
DCUN1D4,8,2,312,322,6
PPT2,8,2,312,322,6
MRPL58,11,5,306,322,6
MRPS16,7,1,314,322,6
CEP70,11,5,306,322,6
DAPK2,11,5,306,322,6
PRCC,11,5,306,322,6
MRPS30,12,6,304,322,6
PPT1,11,5,306,322,6
MRPL54,15,9,298,322,6
PPP4R1,10,4,308,322,6
CERK,7,1,314,322,6
PPP3CA,7,1,314,322,6
PPP2R5C,9,3,310,322,6
DAD1,10,4,308,322,6
MSANTD3,8,2,312,322,6
DARS1,11,5,306,322,6
MRPL50,7,1,314,322,6
MRAS,15,9,298,322,6
PRKAG1,8,2,312,322,6
PRPF19,9,3,310,322,6
CENPK,11,5,306,322,6
MRM2,13,7,302,322,6
CEP131,8,2,312,322,6
PRKCB,8,2,312,322,6
MRPL14,9,3,310,322,6
DAZAP1,7,1,314,322,6
PRDX3,8,2,312,322,6
MRPL27,11,5,306,322,6
MRPL36,13,7,302,322,6
MRPL37,8,2,312,322,6
PRG2,12,6,304,322,6
PRELID1,12,6,304,322,6
CEP350,7,1,314,322,6
MMP2,13,7,302,322,6
DCXR,16,10,296,322,6
CD27,8,2,312,322,6
MEST,7,1,314,322,6
MEIOC,10,4,308,322,6
RABL2B,9,3,310,322,6
RABIF,8,2,312,322,6
RAB9A,11,5,306,322,6
CD96,15,9,298,322,6
RAB5A,7,1,314,322,6
RAB3IP,9,3,310,322,6
RACGAP1,12,6,304,322,6
RAB3GAP1,8,2,312,322,6
RAB21,6,0,316,322,6
RAB1A,8,2,312,322,6
RAB19,7,1,314,322,6
METTL7A,6,0,316,322,6
RAB10,7,1,314,322,6
RABL6,7,1,314,322,6
RAD23B,8,2,312,322,6
R3HDM1,8,2,312,322,6
RAMACL,17,11,294,322,6
ME2,7,1,314,322,6
MED11,11,5,306,322,6
RAP1A,7,1,314,322,6
MED14,8,2,312,322,6
MED16,9,3,310,322,6
MED17,7,1,314,322,6
RALY,8,2,312,322,6
RAD50,7,1,314,322,6
DEFB129,8,2,312,322,6
RALGPS1,11,5,306,322,6
RALB,9,3,310,322,6
RAI14,9,3,310,322,6
MEF2A,7,1,314,322,6
CD53,10,4,308,322,6
MFAP1,10,4,308,322,6
R3HCC1,14,8,300,322,6
PSMG2,9,3,310,322,6
MITD1,10,4,308,322,6
MIEF1,8,2,312,322,6
PTPN2,9,3,310,322,6
MIGA1,6,0,316,322,6
MIOX,11,5,306,322,6
PTK6,7,1,314,322,6
CDK18,10,4,308,322,6
MKRN1,9,3,310,322,6
PTPRN2,7,1,314,322,6
PTGIR,13,7,302,322,6
MLF1,9,3,310,322,6
CDK5,11,5,306,322,6
MLH1,9,3,310,322,6
MMADHC,7,1,314,322,6
MME,8,2,312,322,6
PTPN7,10,4,308,322,6
DDX43,12,6,304,322,6
CDC42SE1,8,2,312,322,6
MGAT2,8,2,312,322,6
QPRT,8,2,312,322,6
MFSD10,11,5,306,322,6
CDC73,8,2,312,322,6
PXYLP1,10,4,308,322,6
MGA,7,1,314,322,6
PXMP2,10,4,308,322,6
PVALEF,8,2,312,322,6
DDX46,8,2,312,322,6
DDX51,7,1,314,322,6
MGAT5B,10,4,308,322,6
PUF60,11,5,306,322,6
MGP,16,10,296,322,6
MGRN1,8,2,312,322,6
PTPRZ1,9,3,310,322,6
HNRNPA0,7,1,314,322,6
COX6B1,11,5,306,322,6
AP1M1,10,4,308,322,6
ZC3H15,11,5,306,322,6
ADAM10,12,6,304,322,6
FBXO8,8,2,312,322,6
ADAL,13,7,302,322,6
ADAD1,6,0,316,322,6
GJA9,13,7,302,322,6
GIT1,10,4,308,322,6
TTC9C,8,2,312,322,6
FBXW8,6,0,316,322,6
GINS2,8,2,312,322,6
ACVR1C,9,3,310,322,6
ZDHHC8,13,7,302,322,6
ZDHHC9,10,4,308,322,6
GID8,7,1,314,322,6
FCGR3B,7,1,314,322,6
FCRL6,10,4,308,322,6
ZFYVE26,9,3,310,322,6
ANKLE1,9,3,310,322,6
ZHX1,8,2,312,322,6
ZIC3,6,0,316,322,6
TTC29,8,2,312,322,6
ZKSCAN3,7,1,314,322,6
ACSL4,8,2,312,322,6
FDX2,12,6,304,322,6
GET3,9,3,310,322,6
ZKSCAN8,7,1,314,322,6
HCRTR2,6,0,316,322,6
ZMAT3,8,2,312,322,6
ZC3H4,10,4,308,322,6
ZC3H10,10,4,308,322,6
ZMIZ2,9,3,310,322,6
GLB1,9,3,310,322,6
GNE,6,0,316,322,6
GNB4,8,2,312,322,6
FBXL17,6,0,316,322,6
GNAZ,8,2,312,322,6
XKR9,8,2,312,322,6
AMY1A,14,8,300,322,6
GNAO1,10,4,308,322,6
GNAI2,7,1,314,322,6
TUT7,9,3,310,322,6
FAM149B1,12,6,304,322,6
TUT4,12,6,304,322,6
FAM13B,9,3,310,322,6
XRCC5,9,3,310,322,6
HAND2,7,1,314,322,6
GLUD1,9,3,310,322,6
HAP1,15,9,298,322,6
FAM135A,9,3,310,322,6
GLS,8,2,312,322,6
GLRX,14,8,300,322,6
YTHDF1,9,3,310,322,6
YWHAZ,8,2,312,322,6
GLO1,9,3,310,322,6
GLIPR1L2,13,7,302,322,6
ANGPTL2,7,1,314,322,6
GLE1,9,3,310,322,6
ZBTB44,6,0,316,322,6
ZBTB7B,6,0,316,322,6
HDAC2,7,1,314,322,6
TTC21A,15,9,298,322,6
ZNF623,6,0,316,322,6
HERC4,7,1,314,322,6
ACADL,11,5,306,322,6
GALP,11,5,306,322,6
ACAD8,11,5,306,322,6
ANKRD46,11,5,306,322,6
FAHD2A,11,5,306,322,6
FGFR2,12,6,304,322,6
TRPV4,9,3,310,322,6
ZNF501,8,2,312,322,6
ANKS1A,9,3,310,322,6
GAL,14,8,300,322,6
ZNF526,11,5,306,322,6
GAGE1,10,4,308,322,6
GADD45A,9,3,310,322,6
ZNF544,8,2,312,322,6
ZNF550,7,1,314,322,6
ZNF562,9,3,310,322,6
ZNF565,10,4,308,322,6
ZNF570,9,3,310,322,6
GABPB2,6,0,316,322,6
GABPB1,9,3,310,322,6
ZNF578,6,0,316,322,6
HHAT,8,2,312,322,6
FABP2,7,1,314,322,6
G2E3,11,5,306,322,6
ZNF608,11,5,306,322,6
TRMT2A,10,4,308,322,6
ZNF616,8,2,312,322,6
HERC5,6,0,316,322,6
TSFM,7,1,314,322,6
TTC19,9,3,310,322,6
ACAT1,9,3,310,322,6
HDAC6,13,7,302,322,6
HDDC3,8,2,312,322,6
FER1L5,12,6,304,322,6
ZNF131,9,3,310,322,6
HDGFL2,9,3,310,322,6
GDF1,17,11,294,322,6
ZNF169,9,3,310,322,6
HDHD2,7,1,314,322,6
ZNF207,9,3,310,322,6
GCK,9,3,310,322,6
TSSK6,19,13,290,322,6
ZNF254,12,6,304,322,6
ANKRD18B,25,19,278,322,6
ACO1,7,1,314,322,6
GCFC2,10,4,308,322,6
FFAR4,8,2,312,322,6
ZNF280A,7,1,314,322,6
HECTD3,9,3,310,322,6
FAM107B,11,5,306,322,6
FGD2,7,1,314,322,6
ZNF330,9,3,310,322,6
ZNF337,10,4,308,322,6
ACE2,7,1,314,322,6
ZNF354B,10,4,308,322,6
GAS6,8,2,312,322,6
GARS1,9,3,310,322,6
ZNF398,8,2,312,322,6
ADGB,11,5,306,322,6
XAB2,9,3,310,322,6
H4C8,16,10,296,322,6
USP31,9,3,310,322,6
GRIFIN,7,1,314,322,6
GRIA4,15,9,298,322,6
AK1,9,3,310,322,6
USP37,8,2,312,322,6
USP38,6,0,316,322,6
USP7,11,5,306,322,6
GRB7,19,13,290,322,6
GYG1,7,1,314,322,6
FAM205A,6,0,316,322,6
ALDH3A2,8,2,312,322,6
AIFM3,12,6,304,322,6
UTRN,10,4,308,322,6
GPX2,20,14,288,322,6
GPSM2,7,1,314,322,6
VAMP1,8,2,312,322,6
GPS1,13,7,302,322,6
VAMP2,8,2,312,322,6
VAMP5,13,7,302,322,6
VAPA,8,2,312,322,6
VASH1,8,2,312,322,6
VASP,9,3,310,322,6
VAT1L,6,0,316,322,6
AHDC1,9,3,310,322,6
AHCTF1,7,1,314,322,6
VBP1,10,4,308,322,6
VCAN,8,2,312,322,6
VCX3B,17,11,294,322,6
GUCY2C,6,0,316,322,6
USP3,11,5,306,322,6
GNG7,9,3,310,322,6
AK6,10,4,308,322,6
GSTZ1,15,9,298,322,6
FAM227A,7,1,314,322,6
AKR1C8P,12,6,304,322,6
UNC13A,6,0,316,322,6
GSTO1,8,2,312,322,6
GTF2F1,10,4,308,322,6
UHRF2,8,2,312,322,6
GTF2IRD1,9,3,310,322,6
GSR,7,1,314,322,6
AKT1S1,7,1,314,322,6
UQCC2,12,6,304,322,6
UQCC3,7,1,314,322,6
AKIRIN2,8,2,312,322,6
UQCRC1,11,5,306,322,6
UQCRH,9,3,310,322,6
GSC2,6,0,316,322,6
UQCRQ,10,4,308,322,6
GTPBP10,11,5,306,322,6
AKAP9,7,1,314,322,6
FAM240C,14,8,300,322,6
USB1,8,2,312,322,6
USF1,11,5,306,322,6
GTPBP8,10,4,308,322,6
USH1G,7,1,314,322,6
GRM4,7,1,314,322,6
UFM1,10,4,308,322,6
USP17L17,13,7,302,322,6
VDAC3,9,3,310,322,6
ALDH5A1,6,0,316,322,6
AGR2,8,2,312,322,6
VIL1,12,6,304,322,6
GP2,9,3,310,322,6
FARP2,8,2,312,322,6
WDR53,12,6,304,322,6
WDR55,7,1,314,322,6
WDR5B,7,1,314,322,6
GON7,12,6,304,322,6
UBE2E3,9,3,310,322,6
FASN,20,14,288,322,6
FASTKD1,7,1,314,322,6
H3-2,12,6,304,322,6
H3-3B,10,4,308,322,6
GOLM1,9,3,310,322,6
ALS2,8,2,312,322,6
UBAP2L,11,5,306,322,6
WFIKKN1,13,7,302,322,6
ADGRG1,14,8,300,322,6
FAT2,9,3,310,322,6
FAT3,7,1,314,322,6
AMBRA1,14,8,300,322,6
WNT3,7,1,314,322,6
GOLGA3,10,4,308,322,6
TYRO3,8,2,312,322,6
WSB2,11,5,306,322,6
FAM156B,24,18,280,322,6
ADGRB2,14,8,300,322,6
ADGRB1,8,2,312,322,6
GNG8,37,31,254,322,6
WDR45B,9,3,310,322,6
UBE2G1,10,4,308,322,6
UBE2K,9,3,310,322,6
AGAP2,17,11,294,322,6
ALDH9A1,7,1,314,322,6
AGGF1,9,3,310,322,6
VPS13A,10,4,308,322,6
ALG1,7,1,314,322,6
VPS28,9,3,310,322,6
FAM90A23P,10,4,308,322,6
VPS37C,8,2,312,322,6
FAM90A8P,7,1,314,322,6
VPS37D,15,9,298,322,6
VPS41,9,3,310,322,6
GPR156,9,3,310,322,6
ALG13,10,4,308,322,6
ALG1L,15,9,298,322,6
ADNP,7,1,314,322,6
AFMID,7,1,314,322,6
UBE4B,7,1,314,322,6
UBE4A,8,2,312,322,6
UBE3D,13,7,302,322,6
GPNMB,9,3,310,322,6
ADRA2A,6,0,316,322,6
UBE2S,11,5,306,322,6
GPHA2,25,19,278,322,6
WDFY1,9,3,310,322,6
GPC5,14,8,300,322,6
ALKBH7,13,7,302,322,6
WDR11,7,1,314,322,6
ZNF618,9,3,310,322,6
ZCCHC2,9,3,310,322,6
FOXG1,8,2,312,322,6
ZNF835,9,3,310,322,6
FXN,7,1,314,322,6
HMGB1,10,4,308,322,6
HMGN2,9,3,310,322,6
ZNF823,12,6,304,322,6
AACS,8,2,312,322,6
HMGN4,9,3,310,322,6
ZP3,11,5,306,322,6
ZNF74,8,2,312,322,6
AP1B1,9,3,310,322,6
FRMD4A,28,22,272,322,6
FOXJ2,8,2,312,322,6
HMCN1,12,6,304,322,6
TRIM31,10,4,308,322,6
FSTL1,15,9,298,322,6
HIGD1A,8,2,312,322,6
ANO6,7,1,314,322,6
FOXF1,14,8,300,322,6
ANXA11,7,1,314,322,6
TRDV3,13,7,302,322,6
ZNF766,10,4,308,322,6
ZNF683,14,8,300,322,6
ZNF768,9,3,310,322,6
FOXP4,11,5,306,322,6
ZNF770,8,2,312,322,6
ZNF845,7,1,314,322,6
HLA-E,7,1,314,322,6
ZNF844,10,4,308,322,6
ABCA5,10,4,308,322,6
HK1,9,3,310,322,6
HMGCS1,12,6,304,322,6
ZNF76,9,3,310,322,6
TRIP10,9,3,310,322,6
FNDC3A,7,1,314,322,6
ZNF776,9,3,310,322,6
FMO3,6,0,316,322,6
FN3KRP,12,6,304,322,6
ZNF652,7,1,314,322,6
HLA-DPB1,9,3,310,322,6
ANP32B,7,1,314,322,6
EZH2,7,1,314,322,6
FLT1,8,2,312,322,6
TRIM11,8,2,312,322,6
FRG1,10,4,308,322,6
ZNF91,10,4,308,322,6
ZNF790,9,3,310,322,6
TRIM4,13,7,302,322,6
HIVEP1,8,2,312,322,6
TRIM68,8,2,312,322,6
ZZEF1,7,1,314,322,6
RRAGA,9,4,309,322,5
RRAS,12,7,303,322,5
ADRB1,9,4,309,322,5
LRRN2,9,4,309,322,5
CBFA2T2,7,2,313,322,5
DNASE2B,8,3,311,322,5
RRP7A,7,2,313,322,5
SAXO2,29,24,269,322,5
GPKOW,12,7,303,322,5
SATB2,7,2,313,322,5
NRAP,6,1,315,322,5
VPS4B,8,3,311,322,5
RSPO2,10,5,307,322,5
CBLL1,9,4,309,322,5
FAN1,7,2,313,322,5
WASF1,9,4,309,322,5
NRAS,7,2,313,322,5
NRBP2,7,2,313,322,5
DNAJB14,11,6,305,322,5
RPUSD3,8,3,311,322,5
NRM,9,4,309,322,5
FOXO4,8,3,311,322,5
LUC7L2,8,3,311,322,5
CBY1,12,7,303,322,5
GPATCH11,6,1,315,322,5
RPS23,11,6,305,322,5
SC5D,8,3,311,322,5
LTBP4,11,6,305,322,5
RPS25,13,8,301,322,5
ADM2,7,2,313,322,5
OR51M1,5,0,317,322,5
RPS27L,7,2,313,322,5
CBWD2,7,2,313,322,5
NRN1,10,5,307,322,5
LONRF2,9,4,309,322,5
GPBP1L1,6,1,315,322,5
LSS,10,5,307,322,5
WDFY3,13,8,301,322,5
LORICRIN,8,3,311,322,5
ZNF888,6,1,315,322,5
OR51B2,5,0,317,322,5
WBP1L,7,2,313,322,5
LSM11,6,1,315,322,5
RTL8A,10,5,307,322,5
LPCAT4,8,3,311,322,5
OR2G2,5,0,317,322,5
RTN1,7,2,313,322,5
CASP2,6,1,315,322,5
S100A10,10,5,307,322,5
CAPN10,13,8,301,322,5
CAPN13,7,2,313,322,5
LRRC14B,10,5,307,322,5
S100A13,10,5,307,322,5
FAM98C,13,8,301,322,5
LRPPRC,9,4,309,322,5
LRPAP1,8,3,311,322,5
S100A9,13,8,301,322,5
GPR119,6,1,315,322,5
SACS,7,2,313,322,5
AFF3,14,9,299,322,5
FAM95C,11,6,305,322,5
LRP1B,7,2,313,322,5
DNAJC9,7,2,313,322,5
CAPN9,7,2,313,322,5
CAPN5,10,5,307,322,5
FOXP1,8,3,311,322,5
DNAJC8,7,2,313,322,5
SAMM50,10,5,307,322,5
LRIG1,9,4,309,322,5
DNAJC5B,8,3,311,322,5
OR2L2,8,3,311,322,5
RYK,7,2,313,322,5
AEBP2,8,3,311,322,5
SAP30,7,2,313,322,5
LRRC39,11,6,305,322,5
GPR142,6,1,315,322,5
RTN4RL1,5,0,317,322,5
FAM9B,11,6,305,322,5
LRRC4B,10,5,307,322,5
LRRC47,7,2,313,322,5
LRRC46,11,6,305,322,5
LRRC45,12,7,303,322,5
LRRC41,9,4,309,322,5
VPS50,8,3,311,322,5
LRRC3B,8,3,311,322,5
DNAJC14,8,3,311,322,5
RXRA,9,4,309,322,5
CAMLG,7,2,313,322,5
VPS52,8,3,311,322,5
VPS53,7,2,313,322,5
LRRC37A2,6,1,315,322,5
GPN3,13,8,301,322,5
COMMD7,10,5,307,322,5
LUC7L3,10,5,307,322,5
RUVBL1,7,2,313,322,5
OR2H1,6,1,315,322,5
RWDD4,13,8,301,322,5
ZNF630,8,3,311,322,5
CCDC127,9,4,309,322,5
DMRTC1B,10,5,307,322,5
COLGALT1,8,3,311,322,5
ZNF814,10,5,307,322,5
DHRSX,10,5,307,322,5
RHO,7,2,313,322,5
MAP4K2,8,3,311,322,5
MAP4K1,9,4,309,322,5
DHX15,6,1,315,322,5
MAP3K7,7,2,313,322,5
DHX29,7,2,313,322,5
RHOU,9,4,309,322,5
FBF1,11,6,305,322,5
CREM,10,5,307,322,5
WNT1,7,2,313,322,5
DHX36,7,2,313,322,5
RIMBP3C,15,10,297,322,5
CCDC91,11,6,305,322,5
NPL,7,2,313,322,5
WLS,11,6,305,322,5
ABCA1,8,3,311,322,5
RINT1,12,7,303,322,5
RIPPLY3,8,3,311,322,5
RIT2,7,2,313,322,5
MANEAL,11,6,305,322,5
WIPI2,9,4,309,322,5
DIP2A,6,1,315,322,5
RNF112,9,4,309,322,5
NPM1,9,4,309,322,5
MALT1,7,2,313,322,5
RHEX,7,2,313,322,5
MAP7D1,7,2,313,322,5
FANCL,7,2,313,322,5
RHBDL3,9,4,309,322,5
XAGE2,9,4,309,322,5
DGKB,7,2,313,322,5
OSBPL11,6,1,315,322,5
REL,7,2,313,322,5
MARVELD2,6,1,315,322,5
NPIPA1,12,7,303,322,5
DGKD,9,4,309,322,5
ORMDL3,9,4,309,322,5
RETREG3,11,6,305,322,5
REXO2,8,3,311,322,5
WTIP,10,5,307,322,5
ORC4,7,2,313,322,5
ADGRB3,7,2,313,322,5
NPIPB15,8,3,311,322,5
GNPAT,8,3,311,322,5
NPIPB3,20,15,287,322,5
RGL1,5,0,317,322,5
MAPKAPK5,6,1,315,322,5
RGPD2,11,6,305,322,5
GNPTG,10,5,307,322,5
NPIPB5,7,2,313,322,5
DHRS1,8,3,311,322,5
MAPK8,9,4,309,322,5
RGS17,5,0,317,322,5
CCL22,6,1,315,322,5
MAPK12,13,8,301,322,5
GOLGA1,7,2,313,322,5
MALSU1,7,2,313,322,5
RNF115,6,1,315,322,5
CCDC63,5,0,317,322,5
MAK,6,1,315,322,5
RPL28,13,8,301,322,5
CCDC148,8,3,311,322,5
RPL3,13,8,301,322,5
ZNF841,6,1,315,322,5
OR5B2,7,2,313,322,5
AASDH,6,1,315,322,5
LYPLAL1,9,4,309,322,5
NQO2,8,3,311,322,5
WDR59,6,1,315,322,5
LYPD6,8,3,311,322,5
CRBN,11,6,305,322,5
NR1H2,10,5,307,322,5
DMBX1,8,3,311,322,5
RPL38,10,5,307,322,5
WDR46,9,4,309,322,5
OR52I1,6,1,315,322,5
RPL41,9,4,309,322,5
COMT,9,4,309,322,5
CRACR2A,8,3,311,322,5
RPL7L1,7,2,313,322,5
RPLP1,14,9,299,322,5
LY6G6F,7,2,313,322,5
DMPK,8,3,311,322,5
LY6G5C,21,16,285,322,5
DMRTA1,6,1,315,322,5
ZNF875,8,3,311,322,5
RPS10,10,5,307,322,5
CCDC149,5,0,317,322,5
RPL23,11,6,305,322,5
AASDHPPT,10,5,307,322,5
ADGRG5,6,1,315,322,5
MAGOH,7,2,313,322,5
CCDC58,10,5,307,322,5
RNF150,5,0,317,322,5
CCDC47,6,1,315,322,5
DIS3L,7,2,313,322,5
DISC1,7,2,313,322,5
ZNF829,7,2,313,322,5
RNF183,12,7,303,322,5
RNF19B,6,1,315,322,5
RNF2,7,2,313,322,5
CCDC34,8,3,311,322,5
CCDC30,7,2,313,322,5
RNF7,8,3,311,322,5
LYZL4,9,4,309,322,5
GOLGA8S,8,3,311,322,5
NPTN,8,3,311,322,5
NPTXR,6,1,315,322,5
CCDC183,11,6,305,322,5
WDR76,6,1,315,322,5
ROPN1B,16,11,295,322,5
CCDC18,8,3,311,322,5
DLGAP2,12,7,303,322,5
OR5K2,8,3,311,322,5
RPF1,8,3,311,322,5
RPGRIP1,26,21,275,322,5
LZIC,6,1,315,322,5
LNPK,8,3,311,322,5
VPS13C,6,1,315,322,5
NRXN1,9,4,309,322,5
NUP155,6,1,315,322,5
KRT83,7,2,313,322,5
SLC35G3,7,2,313,322,5
GRM6,6,1,315,322,5
C16orf90,7,2,313,322,5
COX10,7,2,313,322,5
SLC39A6,8,3,311,322,5
OAZ1,11,6,305,322,5
AAGAB,8,3,311,322,5
FAM241A,7,2,313,322,5
SLC43A1,8,3,311,322,5
NUP153,6,1,315,322,5
KRT27,6,1,315,322,5
KRT26,5,0,317,322,5
KRT17,15,10,297,322,5
ODF1,10,5,307,322,5
C12orf60,11,6,305,322,5
AKAP8,6,1,315,322,5
SLC7A11,8,3,311,322,5
KRCC1,8,3,311,322,5
SLC7A6OS,11,6,305,322,5
DUSP15,21,16,285,322,5
C11orf98,12,7,303,322,5
ZSWIM4,9,4,309,322,5
ZSWIM9,8,3,311,322,5
UQCRC2,9,4,309,322,5
SLIT1,8,3,311,322,5
ZUP1,9,4,309,322,5
SLU7,7,2,313,322,5
SLC35A2,8,3,311,322,5
SLC30A6,7,2,313,322,5
USP1,5,0,317,322,5
USP10,9,4,309,322,5
ZRANB2,8,3,311,322,5
SLAIN1,14,9,299,322,5
SLAMF8,6,1,315,322,5
CORO6,15,10,297,322,5
FNDC11,13,8,301,322,5
C1orf87,5,0,317,322,5
SLC14A2,7,2,313,322,5
SLC16A11,8,3,311,322,5
SLC16A2,7,2,313,322,5
USP18,8,3,311,322,5
SLC18A1,5,0,317,322,5
AKAP10,11,6,305,322,5
AKAP11,6,1,315,322,5
C1orf141,18,13,291,322,5
SLC25A10,7,2,313,322,5
GRINA,9,4,309,322,5
SLC25A18,14,9,299,322,5
AKAP13,9,4,309,322,5
SLC25A20,6,1,315,322,5
SLC25A22,9,4,309,322,5
SLC25A26,7,2,313,322,5
USP15,7,2,313,322,5
SLC25A46,6,1,315,322,5
SLC25A51,8,3,311,322,5
SLC25A53,5,0,317,322,5
C19orf44,11,6,305,322,5
SLC26A3,9,4,309,322,5
AKIRIN1,9,4,309,322,5
NXPH1,10,5,307,322,5
KMO,11,6,305,322,5
DYNLT1,10,5,307,322,5
DYNLT3,10,5,307,322,5
SMIM27,16,11,295,322,5
BTG4,13,8,301,322,5
UNC93A,8,3,311,322,5
FAM229A,22,17,283,322,5
SMIM4,12,7,303,322,5
COX7B,9,4,309,322,5
SMIM41,13,8,301,322,5
UNC5C,6,1,315,322,5
NUP98,10,5,307,322,5
SMPD1,10,5,307,322,5
KLF7,10,5,307,322,5
DZIP3,10,5,307,322,5
KLF3,10,5,307,322,5
SMPDL3A,7,2,313,322,5
NUTM2F,6,1,315,322,5
BSPRY,5,0,317,322,5
SMUG1,8,3,311,322,5
SMURF2,7,2,313,322,5
KLF12,5,0,317,322,5
SMYD1,6,1,315,322,5
FAM227B,10,5,307,322,5
BSCL2,16,11,295,322,5
SNAP47,9,4,309,322,5
ZYX,11,6,305,322,5
NUSAP1,11,6,305,322,5
SNAPC3,9,4,309,322,5
BTN3A2,8,3,311,322,5
KLHL22,11,6,305,322,5
NUP42,10,5,307,322,5
UNK,9,4,309,322,5
COX4I2,14,9,299,322,5
GSK3B,13,8,301,322,5
AKR1A1,10,5,307,322,5
ZW10,6,1,315,322,5
SMARCA4,9,4,309,322,5
GSPT1,7,2,313,322,5
KLK8,19,14,289,322,5
ZWINT,8,3,311,322,5
DYM,8,3,311,322,5
KLK4,16,11,295,322,5
DYNAP,7,2,313,322,5
DYNC1I2,9,4,309,322,5
ZXDB,6,1,315,322,5
SMARCB1,10,5,307,322,5
SMARCC1,8,3,311,322,5
COX6C,12,7,303,322,5
BVES,5,0,317,322,5
ZXDC,10,5,307,322,5
BUB3,9,4,309,322,5
KLHL42,10,5,307,322,5
SMCO4,12,7,303,322,5
SMCR8,6,1,315,322,5
UPF3A,6,1,315,322,5
KLHL36,7,2,313,322,5
UPF2,6,1,315,322,5
SMIM12,7,2,313,322,5
SMIM13,7,2,313,322,5
C1QTNF3,9,4,309,322,5
SKI,10,5,307,322,5
CPT1A,8,3,311,322,5
AGXT,7,2,313,322,5
CACNB4,7,2,313,322,5
LIMA1,12,7,303,322,5
SDF2,9,4,309,322,5
OR13C2,7,2,313,322,5
SDF4,9,4,309,322,5
CACNB2,8,3,311,322,5
SDR9C7,8,3,311,322,5
SEBOX,12,7,303,322,5
SEC14L5,7,2,313,322,5
SEC23A,7,2,313,322,5
AGTPBP1,6,1,315,322,5
NSUN5,9,4,309,322,5
LHX5,6,1,315,322,5
LHX1,12,7,303,322,5
KRTCAP2,10,5,307,322,5
COPRS,9,4,309,322,5
FOXI3,6,1,315,322,5
SELENOI,7,2,313,322,5
OPN3,11,6,305,322,5
GPRASP2,13,8,301,322,5
ZP2,5,0,317,322,5
DPAGT1,8,3,311,322,5
NTHL1,12,7,303,322,5
CPNE7,19,14,289,322,5
SEMG2,5,0,317,322,5
CPNE4,12,7,303,322,5
SENP6,9,4,309,322,5
SEPSECS,8,3,311,322,5
DOCK6,22,17,283,322,5
DOCK5,6,1,315,322,5
LIMS4,18,13,291,322,5
AGPS,7,2,313,322,5
NSA2,8,3,311,322,5
SCAMP1,9,4,309,322,5
LMO3,11,6,305,322,5
LMNTD1,10,5,307,322,5
CAMK1D,5,0,317,322,5
VPS26A,7,2,313,322,5
LMNA,10,5,307,322,5
VPS13D,5,0,317,322,5
MAU2,11,6,305,322,5
LMBRD2,7,2,313,322,5
LMBR1L,18,13,291,322,5
CALML6,17,12,293,322,5
FOXN3,10,5,307,322,5
OR14J1,7,2,313,322,5
AGER,15,10,297,322,5
LLPH,5,0,317,322,5
SCGB1D4,7,2,313,322,5
LIX1L,6,1,315,322,5
GPR32,8,3,311,322,5
CALCOCO2,10,5,307,322,5
NSL1,8,3,311,322,5
LINGO1,7,2,313,322,5
LINC00672,8,3,311,322,5
FAM8A1,6,1,315,322,5
NSMAF,7,2,313,322,5
CACNG8,7,2,313,322,5
ZNHIT6,5,0,317,322,5
DPH7,8,3,311,322,5
SEPTIN1,8,3,311,322,5
DPM1,8,3,311,322,5
COQ3,9,4,309,322,5
USP9X,7,2,313,322,5
SHC2,10,5,307,322,5
COQ6,10,5,307,322,5
SHH,6,1,315,322,5
FN1,6,1,315,322,5
NUDCD1,8,3,311,322,5
GREM1,10,5,307,322,5
C2CD4A,6,1,315,322,5
AIP,10,5,307,322,5
DSE,7,2,313,322,5
AIRE,5,0,317,322,5
SHROOM1,6,1,315,322,5
SHTN1,5,0,317,322,5
SIDT1,5,0,317,322,5
SIGLEC11,7,2,313,322,5
CPEB1,7,2,313,322,5
ZPR1,10,5,307,322,5
L3MBTL2,13,8,301,322,5
SIM2,10,5,307,322,5
SIN3B,8,3,311,322,5
C20orf27,13,8,301,322,5
L1CAM,12,7,303,322,5
ZRANB1,6,1,315,322,5
SIRT1,5,0,317,322,5
AK2,8,3,311,322,5
USP32,8,3,311,322,5
ODF4,11,6,305,322,5
LARP4B,8,3,311,322,5
SH3PXD2B,14,9,299,322,5
SEPTIN8,7,2,313,322,5
SH3D19,10,5,307,322,5
CPNE2,13,8,301,322,5
LDOC1,5,0,317,322,5
C8orf33,9,4,309,322,5
C7,5,0,317,322,5
C6orf89,8,3,311,322,5
LDHA,10,5,307,322,5
LDB3,8,3,311,322,5
C6orf120,8,3,311,322,5
LCN6,7,2,313,322,5
GPX7,9,4,309,322,5
CPN1,7,2,313,322,5
DPYSL3,10,5,307,322,5
DRAM2,8,3,311,322,5
C5orf46,20,15,287,322,5
C4orf46,6,1,315,322,5
GRAMD1C,7,2,313,322,5
SFPQ,7,2,313,322,5
LCE2A,9,4,309,322,5
C4orf3,7,2,313,322,5
SFXN1,6,1,315,322,5
NUAK2,8,3,311,322,5
C4orf17,5,0,317,322,5
NUBP1,13,8,301,322,5
GRAMD4,20,15,287,322,5
SGPL1,8,3,311,322,5
SH2D1A,6,1,315,322,5
UTP11,8,3,311,322,5
RDH5,19,14,289,322,5
OSTC,8,3,311,322,5
DGCR2,10,5,307,322,5
NIFK,10,5,307,322,5
GAS7,5,0,317,322,5
ACBD3,7,2,313,322,5
CHRNB4,10,5,307,322,5
PLOD2,8,3,311,322,5
CYB5D1,8,3,311,322,5
PLPP2,12,7,303,322,5
ACBD5,6,1,315,322,5
ACBD6,9,4,309,322,5
GATA1,8,3,311,322,5
CYB5R4,7,2,313,322,5
GATA2,7,2,313,322,5
CNDP2,9,4,309,322,5
MYH6,5,0,317,322,5
CHRAC1,6,1,315,322,5
PKP4,10,5,307,322,5
GATC,7,2,313,322,5
PML,9,4,309,322,5
MYCT1,11,6,305,322,5
PMP22,7,2,313,322,5
MYCBP2,7,2,313,322,5
CYFIP1,11,6,305,322,5
MYBPHL,10,5,307,322,5
MYBL1,6,1,315,322,5
PNKD,9,4,309,322,5
MYADML2,6,1,315,322,5
PNMA6F,5,0,317,322,5
ACER1,8,3,311,322,5
PCDHGC3,10,5,307,322,5
PLIN5,10,5,307,322,5
FUT1,7,2,313,322,5
PLEKHH1,6,1,315,322,5
PLEKHG5,13,8,301,322,5
CMTM4,10,5,307,322,5
PCSK4,15,10,297,322,5
N4BP2,6,1,315,322,5
PCSK1,7,2,313,322,5
PLA2G15,10,5,307,322,5
PLAAT2,19,14,289,322,5
ACADS,13,8,301,322,5
ACADVL,10,5,307,322,5
PLCD3,7,2,313,322,5
ZNF417,7,2,313,322,5
CHTOP,8,3,311,322,5
MYORG,7,2,313,322,5
PLCE1,6,1,315,322,5
CHTF8,10,5,307,322,5
ZNF41,7,2,313,322,5
PCNT,7,2,313,322,5
MYO9A,8,3,311,322,5
MYO7B,11,6,305,322,5
CNBP,9,4,309,322,5
CXXC1,10,5,307,322,5
CSK,9,4,309,322,5
PLEK2,14,9,299,322,5
CHST6,6,1,315,322,5
PLEKHA4,13,8,301,322,5
ZNF395,15,10,297,322,5
ZNF394,6,1,315,322,5
PLEKHG2,10,5,307,322,5
PNN,7,2,313,322,5
CHMP1B,6,1,315,322,5
MVD,15,10,297,322,5
PCDHGA12,7,2,313,322,5
MTMR10,6,1,315,322,5
MTMR1,9,4,309,322,5
NIPSNAP3A,8,3,311,322,5
PCDHA8,5,0,317,322,5
POPDC3,14,9,299,322,5
GCH1,11,6,305,322,5
POTEF,6,1,315,322,5
ZNF250,8,3,311,322,5
ZNF699,6,1,315,322,5
POU2F1,9,4,309,322,5
FEZF2,10,5,307,322,5
PPA2,8,3,311,322,5
PPEF1,14,9,299,322,5
CGB1,31,26,265,322,5
PCDHA1,6,1,315,322,5
GCOM1,10,5,307,322,5
ZNF195,9,4,309,322,5
PPM1F,7,2,313,322,5
CFAP97,7,2,313,322,5
MT-ND2,10,5,307,322,5
ZNF18,11,6,305,322,5
CYTH3,7,2,313,322,5
PPP1R12C,9,4,309,322,5
PCDH9,8,3,311,322,5
CFAP54,8,3,311,322,5
ZNF70,7,2,313,322,5
PPP1R26,9,4,309,322,5
FUCA2,7,2,313,322,5
FUNDC1,8,3,311,322,5
CHMP1A,11,6,305,322,5
MTMR2,6,1,315,322,5
MUCL3,7,2,313,322,5
ZNF322,9,4,309,322,5
CHIC1,9,4,309,322,5
CYP20A1,7,2,313,322,5
POLB,11,6,305,322,5
POLD4,9,4,309,322,5
GBP3,13,8,301,322,5
CHFR,12,7,303,322,5
ZNF318,6,1,315,322,5
ZNF316,10,5,307,322,5
POLK,8,3,311,322,5
ZNF302,12,7,303,322,5
PCDHGB1,5,0,317,322,5
ZNF286A,8,3,311,322,5
PCDHGA8,6,1,315,322,5
POLR2C,8,3,311,322,5
POLR2E,7,2,313,322,5
POLR2G,12,7,303,322,5
FNTB,9,4,309,322,5
ACLY,10,5,307,322,5
PCDHGA7,6,1,315,322,5
CYP2W1,5,0,317,322,5
POLR3E,8,3,311,322,5
MTOR,9,4,309,322,5
FUOM,12,7,303,322,5
CHD4,8,3,311,322,5
MTMR3,10,5,307,322,5
PLA2G12A,6,1,315,322,5
NAA15,7,2,313,322,5
MAZ,9,4,309,322,5
PHF21A,7,2,313,322,5
NDUFB10,10,5,307,322,5
CTCF,6,1,315,322,5
ZNF584,9,4,309,322,5
CTCFL,8,3,311,322,5
NDUFAF1,8,3,311,322,5
NDUFA8,10,5,307,322,5
PGPEP1L,17,12,293,322,5
PDHX,8,3,311,322,5
FIG4,8,3,311,322,5
CTDSP2,9,4,309,322,5
PHACTR4,6,1,315,322,5
PDGFRA,16,11,295,322,5
PHF20L1,10,5,307,322,5
PHF23,10,5,307,322,5
NAA30,8,3,311,322,5
NFAM1,6,1,315,322,5
CSPP1,7,2,313,322,5
PDE6B,13,8,301,322,5
PHIP,6,1,315,322,5
CTNNBIP1,11,6,305,322,5
NCS1,9,4,309,322,5
CLVS2,6,1,315,322,5
NCOR1,10,5,307,322,5
CSNK2B,9,4,309,322,5
GABRR2,5,0,317,322,5
GAD1,17,12,293,322,5
PDE4C,11,6,305,322,5
ZNF527,7,2,313,322,5
ZNF585A,7,2,313,322,5
NDUFB2,8,3,311,322,5
CLEC2A,8,3,311,322,5
NDUFB6,9,4,309,322,5
FYB1,13,8,301,322,5
ZNF620,5,0,317,322,5
PDPN,10,5,307,322,5
PDLIM7,12,7,303,322,5
FZD5,6,1,315,322,5
PDZK1IP1,12,7,303,322,5
NEK8,11,6,305,322,5
FKBP10,11,6,305,322,5
PEBP1,10,5,307,322,5
ZNF610,7,2,313,322,5
CT45A6,18,13,291,322,5
PDLIM1,6,1,315,322,5
ZNF607,10,5,307,322,5
CLINT1,6,1,315,322,5
PEX1,8,3,311,322,5
CLIC5,5,0,317,322,5
NEUROD1,8,3,311,322,5
PEX26,7,2,313,322,5
PFDN1,10,5,307,322,5
CLECL1,11,6,305,322,5
ABCD3,8,3,311,322,5
CTAG1B,16,11,295,322,5
ZNF594,6,1,315,322,5
NDUFS3,7,2,313,322,5
NDUFS1,9,4,309,322,5
ZNF586,8,3,311,322,5
GAB3,21,16,285,322,5
CLDN19,8,3,311,322,5
CLDN18,6,1,315,322,5
GADL1,7,2,313,322,5
ZNF471,8,3,311,322,5
GALNT10,6,1,315,322,5
CUL4B,7,2,313,322,5
GALNT11,10,5,307,322,5
PIK3CG,5,0,317,322,5
ZNF468,6,1,315,322,5
PIKFYVE,8,3,311,322,5
FGFR4,9,4,309,322,5
CKLF-CMTM1,24,19,279,322,5
PDCD6IP,9,4,309,322,5
CKAP5,9,4,309,322,5
NANOGNB,19,14,289,322,5
NANOG,11,6,305,322,5
GALNT3,12,7,303,322,5
CMC4,15,10,297,322,5
PIP5K1B,9,4,309,322,5
PITPNB,9,4,309,322,5
CXADR,8,3,311,322,5
PDCD4,9,4,309,322,5
NADK2,11,6,305,322,5
CMSS1,7,2,313,322,5
NABP2,7,2,313,322,5
ACAD9,7,2,313,322,5
PCYOX1,8,3,311,322,5
NAAA,9,4,309,322,5
PKIB,11,6,305,322,5
PKIG,13,8,301,322,5
NAA38,9,4,309,322,5
NAT16,11,6,305,322,5
PIK3C2B,7,2,313,322,5
NCF4,9,4,309,322,5
ZNF483,8,3,311,322,5
CSNK1G3,8,3,311,322,5
ZNF654,5,0,317,322,5
ZNF519,5,0,317,322,5
PHTF2,6,1,315,322,5
ZNF513,13,8,301,322,5
PHYH,7,2,313,322,5
ABI3BP,26,21,275,322,5
PHYHIPL,8,3,311,322,5
ZNF511-PRAP1,10,5,307,322,5
PI16,9,4,309,322,5
PI4KA,10,5,307,322,5
CLCN4,6,1,315,322,5
CTTNBP2NL,7,2,313,322,5
PID1,9,4,309,322,5
NBPF26,10,5,307,322,5
CLCN3,8,3,311,322,5
ZNF660,8,3,311,322,5
NBPF11,7,2,313,322,5
PIGK,5,0,317,322,5
NFRKB,9,4,309,322,5
ZNF484,10,5,307,322,5
NAXE,10,5,307,322,5
NAXD,10,5,307,322,5
PDCL,11,6,305,322,5
PIGU,7,2,313,322,5
PIGX,8,3,311,322,5
GALK2,9,4,309,322,5
CSDC2,15,10,297,322,5
PCDH7,7,2,313,322,5
MSL2,11,6,305,322,5
ZAP70,12,7,303,322,5
NOMO3,13,8,301,322,5
ZBTB34,12,7,303,322,5
PWWP2A,8,3,311,322,5
MGAT3,18,13,291,322,5
ZBTB21,10,5,307,322,5
ZBTB11,6,1,315,322,5
ZNF777,13,8,301,322,5
MFSD12,10,5,307,322,5
NOP14,7,2,313,322,5
CDC5L,7,2,313,322,5
MFRP,8,3,311,322,5
MFHAS1,6,1,315,322,5
DEAF1,9,4,309,322,5
YY2,8,3,311,322,5
CES5A,7,2,313,322,5
NOP53,9,4,309,322,5
NOP58,8,3,311,322,5
CDC37,9,4,309,322,5
RAB12,9,4,309,322,5
RAB15,7,2,313,322,5
COL13A1,6,1,315,322,5
GLRA3,5,0,317,322,5
DEFB103B,18,13,291,322,5
CDC14B,7,2,313,322,5
P3R3URF,13,8,301,322,5
RAB4A,7,2,313,322,5
GLRX5,10,5,307,322,5
P3H2,14,9,299,322,5
GLB1L3,8,3,311,322,5
PABPC4,10,5,307,322,5
GLB1L,9,4,309,322,5
NOLC1,7,2,313,322,5
CDK2AP1,9,4,309,322,5
PTGFR,10,5,307,322,5
PTGFRN,9,4,309,322,5
PAG1,6,1,315,322,5
MKKS,8,3,311,322,5
PTGS1,8,3,311,322,5
ZC4H2,8,3,311,322,5
MISP3,19,14,289,322,5
PTK7,8,3,311,322,5
PTN,9,4,309,322,5
CDK12,7,2,313,322,5
NOL10,6,1,315,322,5
ZC3H7A,8,3,311,322,5
CDK10,12,7,303,322,5
MINDY1,7,2,313,322,5
MINAR2,6,1,315,322,5
PTPN12,10,5,307,322,5
PACRGL,13,8,301,322,5
PTPN18,6,1,315,322,5
MIER1,7,2,313,322,5
MID1,8,3,311,322,5
PTPN9,7,2,313,322,5
CDH5,10,5,307,322,5
MICOS10-NBL1,23,18,281,322,5
CDH4,9,4,309,322,5
PTPRK,6,1,315,322,5
PABPN1,10,5,307,322,5
MEPCE,10,5,307,322,5
CD9,9,4,309,322,5
RAB8B,9,4,309,322,5
DENND11,7,2,313,322,5
COL27A1,5,0,317,322,5
DENND1B,6,1,315,322,5
XPOT,7,2,313,322,5
MCUR1,7,2,313,322,5
XPO5,6,1,315,322,5
RBBP4,8,3,311,322,5
FLRT3,6,1,315,322,5
RBM10,9,4,309,322,5
CCT2,11,6,305,322,5
MCEE,12,7,303,322,5
RBM33,9,4,309,322,5
FBXL22,12,7,303,322,5
GNAT1,10,5,307,322,5
MC2R,6,1,315,322,5
OTUD3,9,4,309,322,5
OTOP1,11,6,305,322,5
OTOF,6,1,315,322,5
FYN,8,3,311,322,5
RBMXL2,6,1,315,322,5
OST4,8,3,311,322,5
CCR10,17,12,293,322,5
MBD6,14,9,299,322,5
CCNY,7,2,313,322,5
FBXL16,12,7,303,322,5
ADD2,10,5,307,322,5
OSBPL2,9,4,309,322,5
XCL1,10,5,307,322,5
CD247,10,5,307,322,5
XRCC4,6,1,315,322,5
CD8B,5,0,317,322,5
OXCT2,11,6,305,322,5
RABGAP1,8,3,311,322,5
MELTF,6,1,315,322,5
NOTCH2NLA,13,8,301,322,5
ADAMTSL2,6,1,315,322,5
GLT8D2,10,5,307,322,5
RAD1,6,1,315,322,5
RAD18,8,3,311,322,5
P2RX3,20,15,287,322,5
ADCK2,7,2,313,322,5
CD55,5,0,317,322,5
CD48,5,0,317,322,5
RADIL,8,3,311,322,5
CD46,6,1,315,322,5
GLYATL1B,10,5,307,322,5
DEFB126,13,8,301,322,5
COL23A1,18,13,291,322,5
MED29,9,4,309,322,5
MED28,8,3,311,322,5
YES1,7,2,313,322,5
RAMAC,9,4,309,322,5
YBX3,8,3,311,322,5
FBXO22,8,3,311,322,5
XYLB,8,3,311,322,5
MED1,5,0,317,322,5
RAP2C,9,4,309,322,5
RAPGEF4,8,3,311,322,5
ME3,7,2,313,322,5
FBXO9,6,1,315,322,5
ZCCHC18,8,3,311,322,5
GSX1,6,1,315,322,5
CNOT10,7,2,313,322,5
PBXIP1,10,5,307,322,5
CRYGC,11,6,305,322,5
CEP43,6,1,315,322,5
MRPL44,6,1,315,322,5
ZMAT2,8,3,311,322,5
MRPL41,11,6,305,322,5
MRPL4,10,5,307,322,5
MRPL39,9,4,309,322,5
ZNF726,10,5,307,322,5
CNPPD1,11,6,305,322,5
MRPL34,9,4,309,322,5
PRICKLE4,18,13,291,322,5
PRIMA1,6,1,315,322,5
PATE1,6,1,315,322,5
PRKAB2,6,1,315,322,5
PARP3,9,4,309,322,5
PRKAG2,6,1,315,322,5
CEP162,6,1,315,322,5
PRKAR1B,12,7,303,322,5
DBNDD1,13,8,301,322,5
PRKAR2A,6,1,315,322,5
PARP16,7,2,313,322,5
NLRP9,5,0,317,322,5
PRKCA,6,1,315,322,5
PARN,8,3,311,322,5
DBNL,6,1,315,322,5
PRKX,7,2,313,322,5
ZMPSTE24,6,1,315,322,5
MRPL51,11,6,305,322,5
PRM2,8,3,311,322,5
CEP44,7,2,313,322,5
DACH2,6,1,315,322,5
CES2,8,3,311,322,5
MSANTD2,7,2,313,322,5
ZNF14,8,3,311,322,5
MS4A7,6,1,315,322,5
PPP3R2,7,2,313,322,5
PCDH12,12,7,303,322,5
NKX2-3,6,1,315,322,5
PPP4R3A,9,4,309,322,5
MS4A14,5,0,317,322,5
CEP97,5,0,317,322,5
FLAD1,7,2,313,322,5
MS4A10,7,2,313,322,5
CEP89,7,2,313,322,5
CEP85L,6,1,315,322,5
GDI2,9,4,309,322,5
MRPS35,9,4,309,322,5
PRAC1,26,21,275,322,5
PRC1,10,5,307,322,5
ACP2,10,5,307,322,5
MRPS21,7,2,313,322,5
ZNF117,7,2,313,322,5
FLCN,10,5,307,322,5
MRPS17,7,2,313,322,5
PRDM16,11,6,305,322,5
ZNF112,9,4,309,322,5
PRDM7,9,4,309,322,5
PRLH,8,3,311,322,5
PARD6G,8,3,311,322,5
CRTAM,6,1,315,322,5
MOGAT2,5,0,317,322,5
DCSTAMP,8,3,311,322,5
PALM,12,7,303,322,5
CNTNAP3B,6,1,315,322,5
ZDHHC6,5,0,317,322,5
ACVR2B,7,2,313,322,5
DCTN2,9,4,309,322,5
ZDHHC2,17,12,293,322,5
NMUR2,6,1,315,322,5
ZDHHC17,9,4,309,322,5
DCTN5,8,3,311,322,5
PSMD8,9,4,309,322,5
DCUN1D1,7,2,313,322,5
ZNF761,10,5,307,322,5
PSME1,8,3,311,322,5
DCUN1D2,7,2,313,322,5
DCX,7,2,313,322,5
ZDHHC1,7,2,313,322,5
PSME4,5,0,317,322,5
ACYP2,10,5,307,322,5
FRY,9,4,309,322,5
DDB2,11,6,305,322,5
MMAB,10,5,307,322,5
PTAR1,8,3,311,322,5
MLST8,11,6,305,322,5
DDIAS,9,4,309,322,5
CDK5RAP2,9,4,309,322,5
FBXW11,9,4,309,322,5
PSG11,11,6,305,322,5
FCER2,8,3,311,322,5
PROK1,8,3,311,322,5
FCF1,7,2,313,322,5
PROM1,7,2,313,322,5
PAQR6,13,8,301,322,5
PRPF18,9,4,309,322,5
DCAF10,6,1,315,322,5
DCAF12,6,1,315,322,5
ZFYVE1,9,4,309,322,5
CENPF,7,2,313,322,5
PRPF4B,6,1,315,322,5
ZFP82,8,3,311,322,5
GGH,7,2,313,322,5
ZFP41,10,5,307,322,5
MPLKIP,5,0,317,322,5
CELF5,11,6,305,322,5
DCAKD,11,6,305,322,5
MPHOSPH9,9,4,309,322,5
PRR32,6,1,315,322,5
GGTLC2,30,25,267,322,5
MPDU1,6,1,315,322,5
NMRAL1,18,13,291,322,5
CELA2A,12,7,303,322,5
FCGR3A,8,3,311,322,5
ZFC3H1,6,1,315,322,5
DCD,17,12,293,322,5
PRSS33,6,1,315,322,5
DCDC2,11,6,305,322,5
CEACAM8,9,4,309,322,5
PRSS57,8,3,311,322,5
KISS1R,15,10,297,322,5
BZW1,7,2,313,322,5
TBC1D22B,6,1,315,322,5
UACA,6,1,315,322,5
IK,8,3,311,322,5
ISOC1,10,5,307,322,5
SPDYE16,14,9,299,322,5
ATCAY,8,3,311,322,5
INCA1,13,8,301,322,5
TMEM42,13,8,301,322,5
BCL7C,7,2,313,322,5
ELMOD2,10,5,307,322,5
ERN2,15,10,297,322,5
TRIP4,10,5,307,322,5
STK38,6,1,315,322,5
SUGP2,7,2,313,322,5
IKBKB,9,4,309,322,5
SPCS1,8,3,311,322,5
SPATS2L,9,4,309,322,5
TMEM50A,7,2,313,322,5
HTR1D,5,0,317,322,5
UBE2E2,11,6,305,322,5
U2AF1L4,13,8,301,322,5
H2AC17,26,21,275,322,5
ELOB,11,6,305,322,5
ANKHD1,8,3,311,322,5
TMEM9,9,4,309,322,5
TYW5,5,0,317,322,5
ANO8,8,3,311,322,5
ENTPD5,8,3,311,322,5
TLL1,10,5,307,322,5
KCNMB2,18,13,291,322,5
B4GALT2,10,5,307,322,5
TRIM73,11,6,305,322,5
TMEM39A,9,4,309,322,5
UBE2D2,9,4,309,322,5
TRMT10B,8,3,311,322,5
TMEM263,9,4,309,322,5
SPEGNB,26,21,275,322,5
B4GALT5,8,3,311,322,5
SPEG,15,10,297,322,5
TENM3,10,5,307,322,5
IGFBP2,17,12,293,322,5
STXBP5,8,3,311,322,5
TBC1D3B,19,14,289,322,5
TRMT1,12,7,303,322,5
TBC1D24,6,1,315,322,5
ERLEC1,8,3,311,322,5
TMEM270,11,6,305,322,5
IGSF6,6,1,315,322,5
TFB2M,8,3,311,322,5
KCNK5,7,2,313,322,5
ERMAP,7,2,313,322,5
ATE1,7,2,313,322,5
TBC1D22A,8,3,311,322,5
TTC39C,8,3,311,322,5
KANSL2,7,2,313,322,5
TMEM30A,9,4,309,322,5
TMEM38B,7,2,313,322,5
ERMP1,9,4,309,322,5
HTR3D,5,0,317,322,5
TBC1D14,9,4,309,322,5
TLK1,7,2,313,322,5
BMP8B,8,3,311,322,5
TMEM256-PLSCR3,43,38,241,322,5
B3GNT5,10,5,307,322,5
HIVEP2,5,0,317,322,5
SUMF2,6,1,315,322,5
TMTC1,7,2,313,322,5
SS18L1,7,2,313,322,5
EEF1AKMT4-ECE2,5,0,317,322,5
ATP5MD,11,6,305,322,5
ANKRD36C,10,5,307,322,5
ATP5MF,10,5,307,322,5
STK10,7,2,313,322,5
TIPRL,7,2,313,322,5
HCAR2,11,6,305,322,5
IGKV1D-33,27,22,273,322,5
TRIM56,8,3,311,322,5
TMX3,8,3,311,322,5
INTS7,6,1,315,322,5
EIF2B1,6,1,315,322,5
UCP2,11,6,305,322,5
IL17RB,15,10,297,322,5
ANTKMT,12,7,303,322,5
HSDL2,7,2,313,322,5
TRIM49,6,1,315,322,5
ITGA6,8,3,311,322,5
TIMP1,15,10,297,322,5
INTS6,9,4,309,322,5
ALCAM,6,1,315,322,5
TTL,6,1,315,322,5
IGKV1D-17,9,4,309,322,5
KCTD6,12,7,303,322,5
KCTD3,8,3,311,322,5
B3GNT8,13,8,301,322,5
TASOR2,11,6,305,322,5
TBC1D10B,8,3,311,322,5
TMEM97,8,3,311,322,5
ARRB1,11,6,305,322,5
TMOD2,8,3,311,322,5
ESD,10,5,307,322,5
ATP5F1D,12,7,303,322,5
ENTPD4,6,1,315,322,5
ALDH1A2,19,14,289,322,5
TMOD3,6,1,315,322,5
TSC22D4,11,6,305,322,5
EIF5AL1,6,1,315,322,5
TAX1BP3,11,6,305,322,5
BMPR2,6,1,315,322,5
EFCAB1,15,10,297,322,5
GUK1,9,4,309,322,5
TXNL1,8,3,311,322,5
TMPRSS12,10,5,307,322,5
BMS1,6,1,315,322,5
TAX1BP1,7,2,313,322,5
KCTD17,9,4,309,322,5
SPART,6,1,315,322,5
HIRIP3,6,1,315,322,5
IL12RB2,10,5,307,322,5
ESRRA,13,8,301,322,5
ELOF1,9,4,309,322,5
TKT,10,5,307,322,5
BNIP3,9,4,309,322,5
SPEM2,8,3,311,322,5
SPHK1,10,5,307,322,5
GUCD1,9,4,309,322,5
TMEM14C,11,6,305,322,5
TTC28,9,4,309,322,5
KBTBD6,5,0,317,322,5
TMED10,6,1,315,322,5
SPRYD7,7,2,313,322,5
UBAC2,9,4,309,322,5
BEAN1,9,4,309,322,5
IGLV2-23,11,6,305,322,5
FAM189B,7,2,313,322,5
FADS1,7,2,313,322,5
IRF7,15,10,297,322,5
KCNG2,7,2,313,322,5
HDAC8,7,2,313,322,5
ATIC,7,2,313,322,5
EHBP1L1,6,1,315,322,5
ALG11,7,2,313,322,5
UBAC1,8,3,311,322,5
TMEM170B,6,1,315,322,5
TCF15,5,0,317,322,5
BACE2,6,1,315,322,5
TCF12,10,5,307,322,5
TCEAL6,6,1,315,322,5
ERAP1,6,1,315,322,5
SPRR2F,7,2,313,322,5
UBXN11,12,7,303,322,5
TMEM178B,6,1,315,322,5
SPRR2D,12,7,303,322,5
ARID4A,6,1,315,322,5
SPTB,7,2,313,322,5
BFAR,8,3,311,322,5
HDAC9,10,5,307,322,5
EPS15,7,2,313,322,5
ARL6IP6,9,4,309,322,5
HEXIM2,17,12,293,322,5
H1-8,7,2,313,322,5
EPB41L2,9,4,309,322,5
FAF1,6,1,315,322,5
FADS3,11,6,305,322,5
IFNGR1,6,1,315,322,5
TEAD4,11,6,305,322,5
H1-7,7,2,313,322,5
IFT172,9,4,309,322,5
STON2,12,7,303,322,5
FADS2,11,6,305,322,5
FAM166C,10,5,307,322,5
ATG13,11,6,305,322,5
SRA1,11,6,305,322,5
IFT43,12,7,303,322,5
IFNA6,5,0,317,322,5
TRPC7,7,2,313,322,5
KCNC1,23,18,281,322,5
TECRL,5,0,317,322,5
ARL3,6,1,315,322,5
TMEM132E,5,0,317,322,5
KCND1,13,8,301,322,5
FAM168B,7,2,313,322,5
TMEM134,7,2,313,322,5
TMEM141,13,8,301,322,5
ARMC5,9,4,309,322,5
GZMH,7,2,313,322,5
HGS,11,6,305,322,5
KARS1,9,4,309,322,5
TMEM237,7,2,313,322,5
SPINK9,13,8,301,322,5
EHF,8,3,311,322,5
IGKV3-11,5,0,317,322,5
SPINK8,16,11,295,322,5
TBCA,9,4,309,322,5
STKLD1,11,6,305,322,5
SRRM1,7,2,313,322,5
BIRC2,8,3,311,322,5
ICAM3,15,10,297,322,5
KAT5,12,7,303,322,5
IRAK1,8,3,311,322,5
IRAG2,11,6,305,322,5
ICA1,9,4,309,322,5
ANKRD13C,6,1,315,322,5
BIRC6,6,1,315,322,5
TMEM248,7,2,313,322,5
ATP13A5,11,6,305,322,5
IGKV2D-29,6,1,315,322,5
ANKRD45,10,5,307,322,5
ATP1A2,7,2,313,322,5
ERH,8,3,311,322,5
STX5,11,6,305,322,5
BLM,5,0,317,322,5
TM4SF18,16,11,295,322,5
HIF1A,6,1,315,322,5
BCLAF1,9,4,309,322,5
FAM169A,10,5,307,322,5
IGLV7-43,10,5,307,322,5
BICRAL,5,0,317,322,5
ARID3A,8,3,311,322,5
TRMU,8,3,311,322,5
UBA52,10,5,307,322,5
TRNT1,6,1,315,322,5
ARHGEF7,9,4,309,322,5
ANKRD55,9,4,309,322,5
HES6,18,13,291,322,5
BGN,5,0,317,322,5
STMN2,7,2,313,322,5
H2AC11,8,3,311,322,5
GZMA,6,1,315,322,5
SRP19,10,5,307,322,5
ARHGEF6,7,2,313,322,5
TBX20,5,0,317,322,5
SRP54,9,4,309,322,5
HDC,6,1,315,322,5
TMEM208,11,6,305,322,5
BCS1L,10,5,307,322,5
STT3B,6,1,315,322,5
FAHD1,7,2,313,322,5
SPPL2B,8,3,311,322,5
ATP13A4,5,0,317,322,5
TM9SF4,10,5,307,322,5
UBP1,7,2,313,322,5
TTC1,10,5,307,322,5
BICD1,8,3,311,322,5
KAT8,5,0,317,322,5
STUB1,8,3,311,322,5
EPB41L5,5,0,317,322,5
EIF2B3,8,3,311,322,5
ATP5MPL,9,4,309,322,5
TAF11L13,9,4,309,322,5
ASB17,9,4,309,322,5
FAM214B,6,1,315,322,5
TPSD1,6,1,315,322,5
HOXB6,8,3,311,322,5
KIAA1549L,9,4,309,322,5
EMP2,6,1,315,322,5
BRAP,5,0,317,322,5
EIF4E2,9,4,309,322,5
FAM171A1,8,3,311,322,5
THAP6,9,4,309,322,5
UHMK1,5,0,317,322,5
TRAF7,9,4,309,322,5
EXT2,8,3,311,322,5
FAM131C,8,3,311,322,5
GTF2IRD2B,11,6,305,322,5
SNX32,13,8,301,322,5
ECM2,9,4,309,322,5
H2BC11,12,7,303,322,5
AP4S1,6,1,315,322,5
INO80E,10,5,307,322,5
ECI2,10,5,307,322,5
KIF13A,6,1,315,322,5
BRD1,8,3,311,322,5
ANGPT2,7,2,313,322,5
ATRN,6,1,315,322,5
ITIH2,8,3,311,322,5
SWI5,9,4,309,322,5
IGHV3-38,10,5,307,322,5
GTF3C5,9,4,309,322,5
EWSR1,7,2,313,322,5
H2BC12,15,10,297,322,5
APC,10,5,307,322,5
FAM126B,7,2,313,322,5
THRAP3,10,5,307,322,5
TRIM34,11,6,305,322,5
KIAA0513,6,1,315,322,5
GTPBP2,9,4,309,322,5
INPPL1,10,5,307,322,5
SSTR2,8,3,311,322,5
KIAA0753,8,3,311,322,5
SOD2,8,3,311,322,5
EPHA2,8,3,311,322,5
TPD52L1,11,6,305,322,5
TPD52L3,6,1,315,322,5
ECT2,7,2,313,322,5
ECSCR,12,7,303,322,5
HOXD13,5,0,317,322,5
KIAA1109,6,1,315,322,5
EYS,9,4,309,322,5
ITGB4,22,17,283,322,5
INPP5F,8,3,311,322,5
HLA-DMA,20,15,287,322,5
BCKDK,8,3,311,322,5
TAF11,6,1,315,322,5
ALG8,6,1,315,322,5
IGHV3-11,9,4,309,322,5
EVPLL,12,7,303,322,5
TEX10,9,4,309,322,5
TEX11,5,0,317,322,5
SNX22,6,1,315,322,5
TRAPPC5,8,3,311,322,5
TAF15,9,4,309,322,5
ITPK1,9,4,309,322,5
TGFBR3L,8,3,311,322,5
AKR1D1,8,3,311,322,5
UNC119,12,7,303,322,5
ANKRD28,6,1,315,322,5
ASF1A,9,4,309,322,5
TRBJ1-1,7,2,313,322,5
ST8SIA4,6,1,315,322,5
HAPLN4,7,2,313,322,5
IMPG1,8,3,311,322,5
EXOSC3,10,5,307,322,5
EXPH5,5,0,317,322,5
ST8SIA2,8,3,311,322,5
SNRNP35,8,3,311,322,5
TRBV23-1,8,3,311,322,5
ING1,9,4,309,322,5
EXOSC6,7,2,313,322,5
HMGN5,12,7,303,322,5
TFG,7,2,313,322,5
HECTD1,9,4,309,322,5
SNPH,8,3,311,322,5
TUBGCP3,8,3,311,322,5
AP2B1,11,6,305,322,5
BRSK2,14,9,299,322,5
TFAP2E,10,5,307,322,5
TRBV6-5,9,4,309,322,5
TRBV6-7,7,2,313,322,5
HMMR,8,3,311,322,5
ANAPC1,8,3,311,322,5
UBE2N,10,5,307,322,5
GTF2H5,8,3,311,322,5
TEX37,20,15,287,322,5
STAM,6,1,315,322,5
TRIAP1,7,2,313,322,5
HOOK3,7,2,313,322,5
BRF1,9,4,309,322,5
ANAPC2,9,4,309,322,5
ITSN1,9,4,309,322,5
SNX12,8,3,311,322,5
SNX11,8,3,311,322,5
UBE2Q1,7,2,313,322,5
SYDE2,5,0,317,322,5
SYT4,5,0,317,322,5
EXOC3L1,8,3,311,322,5
ULK3,13,8,301,322,5
BCAN,17,12,293,322,5
GTF2F2,7,2,313,322,5
BCAR3,10,5,307,322,5
HMGB3,10,5,307,322,5
FAM171A2,13,8,301,322,5
HNRNPUL1,7,2,313,322,5
TSTD1,15,10,297,322,5
SNTN,9,4,309,322,5
ASCL1,6,1,315,322,5
EMC9,11,6,305,322,5
TRAV41,9,4,309,322,5
THADA,6,1,315,322,5
HDX,7,2,313,322,5
BRINP3,11,6,305,322,5
TOX3,6,1,315,322,5
TDRP,7,2,313,322,5
H2AZ1,9,4,309,322,5
TOR1AIP2,6,1,315,322,5
INSYN1,8,3,311,322,5
TNKS,7,2,313,322,5
TNKS2,6,1,315,322,5
UGDH,8,3,311,322,5
TNNI3K,12,7,303,322,5
TIMM13,10,5,307,322,5
TAOK2,11,6,305,322,5
FAM122A,7,2,313,322,5
SOX21,8,3,311,322,5
SOX11,6,1,315,322,5
JARID2,6,1,315,322,5
AMT,36,31,255,322,5
SSH2,9,4,309,322,5
ITGAX,5,0,317,322,5
ENOX1,6,1,315,322,5
ITGB1,10,5,307,322,5
TSNAX,8,3,311,322,5
UBE3A,13,8,301,322,5
ITGB1BP1,11,6,305,322,5
TAFA5,11,6,305,322,5
TAFA4,10,5,307,322,5
TNPO2,10,5,307,322,5
ELP6,8,3,311,322,5
IGHV1-18,8,3,311,322,5
TAPBP,7,2,313,322,5
SUPT20HL2,5,0,317,322,5
FAM124B,7,2,313,322,5
TNFSF9,9,4,309,322,5
SPACA5,12,7,303,322,5
TRIM45,6,1,315,322,5
KDM4C,5,0,317,322,5
JMJD1C,6,1,315,322,5
BOLA3,12,7,303,322,5
HBP1,6,1,315,322,5
BBOF1,13,8,301,322,5
AQP2,7,2,313,322,5
AMOT,8,3,311,322,5
UFD1,9,4,309,322,5
UFL1,6,1,315,322,5
ARSJ,5,0,317,322,5
AMPH,7,2,313,322,5
TARS3,7,2,313,322,5
SP2,8,3,311,322,5
TARS1,9,4,309,322,5
TIMM23B-AGAP6,7,2,313,322,5
JDP2,10,5,307,322,5
APPL1,7,2,313,322,5
HSD11B1,10,5,307,322,5
AMPD2,9,4,309,322,5
BORCS7,8,3,311,322,5
SSH1,5,0,317,322,5
TESK2,9,4,309,322,5
UGP2,7,2,313,322,5
TNNT1,10,5,307,322,5
HAX1,10,5,307,322,5
ARX,18,13,291,322,5
TIAF1,6,1,315,322,5
IL2RA,7,2,313,322,5
BBS10,5,0,317,322,5
TAF2,7,2,313,322,5
UGT1A8,11,6,305,322,5
SOWAHC,6,1,315,322,5
TOMM5,9,4,309,322,5
SORCS1,7,2,313,322,5
INS-IGF2,5,0,317,322,5
UBE2J1,6,1,315,322,5
ENKUR,11,6,305,322,5
HPS3,6,1,315,322,5
HPSE,7,2,313,322,5
KHDRBS3,11,6,305,322,5
HLA-DQB1,5,0,317,322,5
EDC3,9,4,309,322,5
ALG5,7,2,313,322,5
BCL2,7,2,313,322,5
HPS4,8,3,311,322,5
APOC4-APOC2,7,2,313,322,5
TAF3,6,1,315,322,5
INSIG1,9,4,309,322,5
TOMM22,7,2,313,322,5
TAF1D,11,6,305,322,5
TOP3B,11,6,305,322,5
TAF5L,10,5,307,322,5
SORBS3,10,5,307,322,5
GCDH,13,9,300,322,4
TEX9,7,3,312,322,4
DAND5,7,3,312,322,4
HDGFL3,5,1,316,322,4
CYP51A1,8,4,310,322,4
PQBP1,13,9,300,322,4
PRCD,11,7,304,322,4
POP5,8,4,310,322,4
MRPS9,6,2,314,322,4
POM121L2,17,13,292,322,4
MRPS36,7,3,312,322,4
ZNF146,7,3,312,322,4
ASXL3,5,1,316,322,4
TESK1,10,6,306,322,4
ASNSD1,10,6,306,322,4
MT-ATP8,14,10,298,322,4
CYTH2,10,6,306,322,4
MT2A,16,12,294,322,4
PPIG,8,4,310,322,4
MTO1,7,3,312,322,4
ZNF12,8,4,310,322,4
ZNF142,8,4,310,322,4
ZNF182,7,3,312,322,4
FEM1A,5,1,316,322,4
MRPS23,10,6,306,322,4
PPP1R10,9,5,308,322,4
ZNF138,8,4,310,322,4
DAP,7,3,312,322,4
CEP76,7,3,312,322,4
IGKV1D-13,12,8,302,322,4
ZNF124,6,2,314,322,4
ACOX2,17,13,292,322,4
PRAF2,9,5,308,322,4
PPIF,6,2,314,322,4
TERF2,7,3,312,322,4
MRPS33,7,3,312,322,4
ANKRD16,4,0,318,322,4
TEX264,8,4,310,322,4
GDAP1L1,17,13,292,322,4
EPC1,7,3,312,322,4
IGKV2-30,6,2,314,322,4
HDHD5,9,5,308,322,4
MSH3,5,1,316,322,4
DACH1,5,1,316,322,4
TENT5B,16,12,294,322,4
MTFR1,8,4,310,322,4
CGGBP1,10,6,306,322,4
TTC13,12,8,302,322,4
IGKV2-24,4,0,318,322,4
DAB2,7,3,312,322,4
PPP6C,7,3,312,322,4
PPP1R16A,11,7,304,322,4
CERCAM,9,5,308,322,4
CETN2,9,5,308,322,4
TET2,5,1,316,322,4
ZNF148,8,4,310,322,4
ACOT4,7,3,312,322,4
IGKV2-28,7,3,312,322,4
ZNF213,8,4,310,322,4
PP2D1,10,6,306,322,4
PPIL1,8,4,310,322,4
CETN1,5,1,316,322,4
CES3,6,2,314,322,4
MRTO4,7,3,312,322,4
ACOT13,6,2,314,322,4
CFAP161,27,23,272,322,4
CZIB,7,3,312,322,4
PPM1E,5,1,316,322,4
TEX28,6,2,314,322,4
PPA1,7,3,312,322,4
GDF6,4,0,318,322,4
PPIC,6,2,314,322,4
CYP4V2,6,2,314,322,4
ATAD5,7,3,312,322,4
MSANTD5,12,8,302,322,4
FER,6,2,314,322,4
CFAP36,6,2,314,322,4
CFHR5,4,0,318,322,4
CYP46A1,7,3,312,322,4
TEX15,4,0,318,322,4
IGKV1D-43,20,16,286,322,4
ASTN1,6,2,314,322,4
ANKRD13D,12,8,302,322,4
GDE1,9,5,308,322,4
PPP3R1,7,3,312,322,4
CFLAR,7,3,312,322,4
DAG1,13,9,300,322,4
MT-CO1,11,7,304,322,4
SNAPIN,10,6,306,322,4
DAPK3,16,12,294,322,4
FAM126A,6,2,314,322,4
PTP4A1,16,12,294,322,4
MINDY3,11,7,304,322,4
MINDY2,5,1,316,322,4
TAF9B,10,6,306,322,4
MIF4GD,9,5,308,322,4
BRWD3,5,1,316,322,4
DDX27,6,2,314,322,4
FBXO48,5,1,316,322,4
MID1IP1,8,4,310,322,4
PTPRC,12,8,302,322,4
CDH6,5,1,316,322,4
TAF1B,13,9,300,322,4
HBD,12,8,302,322,4
MICAL3,6,2,314,322,4
CDH24,9,5,308,322,4
MICAL1,9,5,308,322,4
ZBTB9,8,4,310,322,4
PTPRS,11,7,304,322,4
TAF12,7,3,312,322,4
PTRHD1,7,3,312,322,4
CDH20,8,4,310,322,4
TTYH3,11,7,304,322,4
ZBTB48,11,7,304,322,4
MGME1,6,2,314,322,4
MIOS,9,5,308,322,4
FAM122C,8,4,310,322,4
ATG101,11,7,304,322,4
CDK8,8,4,310,322,4
PSMF1,10,6,306,322,4
IL17RD,6,2,314,322,4
GIT2,6,2,314,322,4
GJA10,5,1,316,322,4
PSTPIP1,19,15,288,322,4
ZCWPW1,8,4,310,322,4
MMACHC,8,4,310,322,4
TTLL12,10,6,306,322,4
MLYCD,11,7,304,322,4
PTBP1,9,5,308,322,4
PTBP2,5,1,316,322,4
PTDSS1,6,2,314,322,4
PTGR1,5,1,316,322,4
MLLT3,10,6,306,322,4
MLLT11,7,3,312,322,4
CDK5RAP3,10,6,306,322,4
IL19,9,5,308,322,4
CDK5RAP1,8,4,310,322,4
ATP6V0E1,9,5,308,322,4
ATP6V1A,6,2,314,322,4
TARBP2,10,6,306,322,4
MLEC,6,2,314,322,4
IL1RAP,8,4,310,322,4
TTLL3,9,5,308,322,4
ANGPTL4,21,17,284,322,4
PUS3,8,4,310,322,4
HAUS6,6,2,314,322,4
CDC14A,5,1,316,322,4
METTL2A,5,1,316,322,4
YRDC,7,3,312,322,4
RAB23,6,2,314,322,4
METTL21C,9,5,308,322,4
FBXO38,4,0,318,322,4
TUBE1,10,6,306,322,4
RAB34,9,5,308,322,4
RAB3D,6,2,314,322,4
RAB3GAP2,9,5,308,322,4
YPEL5,8,4,310,322,4
METAP1D,6,2,314,322,4
GLRX3,9,5,308,322,4
HAUS5,7,3,312,322,4
IMMT,7,3,312,322,4
SYP,10,6,306,322,4
RAB8A,10,6,306,322,4
SYNPO,7,3,312,322,4
YPEL4,12,8,302,322,4
CD82,8,4,310,322,4
RABGGTB,8,4,310,322,4
GLT8D1,11,7,304,322,4
MEIOSIN,8,4,310,322,4
YIPF6,6,2,314,322,4
GLTPD2,10,6,306,322,4
ADAMTS7,6,2,314,322,4
ILK,15,11,296,322,4
RAB14,5,1,316,322,4
ADAMTS3,6,2,314,322,4
FBXO41,10,6,306,322,4
PWWP2B,7,3,312,322,4
ZBTB22,9,5,308,322,4
MFSD9,9,5,308,322,4
PXT1,7,3,312,322,4
ADAM8,8,4,310,322,4
PYCARD,17,13,292,322,4
MFSD4B,6,2,314,322,4
MFSD4A,5,1,316,322,4
PYCR2,9,5,308,322,4
CDCA3,8,4,310,322,4
ADAMTS10,9,5,308,322,4
QDPR,7,3,312,322,4
ZBED9,4,0,318,322,4
ZBED1,7,3,312,322,4
DECR1,11,7,304,322,4
SYTL3,7,3,312,322,4
TUBB4B,9,5,308,322,4
ADAMTS19,10,6,306,322,4
DEDD,9,5,308,322,4
ILDR2,9,5,308,322,4
RAB11B,11,7,304,322,4
SYT17,5,1,316,322,4
IL17RA,6,2,314,322,4
TAS2R4,7,3,312,322,4
ACYP1,7,3,312,322,4
PRODH,11,7,304,322,4
ATP10B,4,0,318,322,4
MRPL1,8,4,310,322,4
PRKCE,10,6,306,322,4
ZGPAT,12,8,302,322,4
PRKCI,5,1,316,322,4
MROH6,12,8,302,322,4
CEP128,8,4,310,322,4
IGLV4-60,14,10,298,322,4
ZFYVE27,11,7,304,322,4
TBX18,5,1,316,322,4
PRMT3,8,4,310,322,4
HCN3,4,0,318,322,4
DCAF13,11,7,304,322,4
CENPM,12,8,302,322,4
PROS1,5,1,316,322,4
TBKBP1,9,5,308,322,4
PROSER3,6,2,314,322,4
TBCEL,7,3,312,322,4
TTC37,8,4,310,322,4
PRPF3,6,2,314,322,4
ZFYVE16,10,6,306,322,4
PRPF31,10,6,306,322,4
ANKIB1,9,5,308,322,4
FCRL3,4,0,318,322,4
MRPL12,11,7,304,322,4
MRPL20,9,5,308,322,4
MRPL21,9,5,308,322,4
TCF24,7,3,312,322,4
CEP55,4,0,318,322,4
MRPL9,10,6,306,322,4
ZNF100,7,3,312,322,4
TDP2,7,3,312,322,4
ZMYM5,6,2,314,322,4
DARS2,8,4,310,322,4
ATG14,6,2,314,322,4
ATG2A,10,6,306,322,4
ATG2B,4,0,318,322,4
MRPL48,5,1,316,322,4
MRPL45,10,6,306,322,4
ATG4B,9,5,308,322,4
EPB41L1,15,11,296,322,4
CEP250,10,6,306,322,4
TCN2,9,5,308,322,4
IGLV1-47,13,9,300,322,4
PRG4,10,6,306,322,4
ATG7,9,5,308,322,4
PRICKLE1,6,2,314,322,4
IGLV2-18,9,5,308,322,4
PRKAA2,6,2,314,322,4
MRPL3,8,4,310,322,4
PRKAB1,12,8,302,322,4
PRPF4,5,1,316,322,4
ACTL6A,7,3,312,322,4
PSME2,9,5,308,322,4
TAZ,11,7,304,322,4
MOGS,10,6,306,322,4
IKZF5,6,2,314,322,4
IL10,10,6,306,322,4
PSD3,11,7,304,322,4
DCST1,6,2,314,322,4
PSG6,9,5,308,322,4
ZER1,9,5,308,322,4
PSIP1,9,5,308,322,4
PSMA5,9,5,308,322,4
CDX2,4,0,318,322,4
FAM118A,8,4,310,322,4
MMUT,8,4,310,322,4
MPV17L,8,4,310,322,4
CDRT15L2,7,3,312,322,4
CDRT15,17,13,292,322,4
ZDHHC21,7,3,312,322,4
FCAMR,6,2,314,322,4
ZDHHC20,5,1,316,322,4
TTC8,10,6,306,322,4
PSMD14,9,5,308,322,4
IL15,12,8,302,322,4
GINS4,6,2,314,322,4
GIP,16,12,294,322,4
IL16,12,8,302,322,4
DCLRE1C,6,2,314,322,4
ATP5F1C,11,7,304,322,4
IKZF1,10,6,306,322,4
MORC2,9,5,308,322,4
TBC1D8B,9,5,308,322,4
ZFP69B,7,3,312,322,4
TBC1D7,7,3,312,322,4
ZFP64,8,4,310,322,4
ACTR10,9,5,308,322,4
CELF6,24,20,278,322,4
MPO,6,2,314,322,4
MPND,15,11,296,322,4
ATP2A1,31,27,264,322,4
MPL,7,3,312,322,4
MPHOSPH6,13,9,300,322,4
MPG,11,7,304,322,4
PRRC1,7,3,312,322,4
ENTPD6,9,5,308,322,4
ACTR1A,11,7,304,322,4
PRRT1B,8,4,310,322,4
DCC,17,13,292,322,4
TBC1D13,9,5,308,322,4
PRRT3,6,2,314,322,4
PRSS16,6,2,314,322,4
IKBKG,10,6,306,322,4
ZFAND2B,8,4,310,322,4
MORC3,6,2,314,322,4
TSPO,14,10,298,322,4
PKP1,5,1,316,322,4
MTR,8,4,310,322,4
ZNF749,9,5,308,322,4
NOL7,6,2,314,322,4
TRIM47,14,10,298,322,4
ZNF772,8,4,310,322,4
COBL,5,1,316,322,4
TRIM48,4,0,318,322,4
COA5,9,5,308,322,4
ARAP3,5,1,316,322,4
AREG,10,6,306,322,4
FLRT1,12,8,302,322,4
ZNF765,7,3,312,322,4
TMX4,7,3,312,322,4
PALM2AKAP2,6,2,314,322,4
ZNF740,5,1,316,322,4
NOM1,4,0,318,322,4
NMNAT2,4,0,318,322,4
PAPOLB,5,1,316,322,4
TMTC3,6,2,314,322,4
ARF6,7,3,312,322,4
CNTN1,17,13,292,322,4
CNST,8,4,310,322,4
PARD6A,9,5,308,322,4
CNRIP1,11,7,304,322,4
CRYBA1,14,10,298,322,4
ABCA7,15,11,296,322,4
ZNF736,5,1,316,322,4
TMPRSS4,6,2,314,322,4
NOL8,6,2,314,322,4
NOMO1,11,7,304,322,4
CMAS,8,4,310,322,4
COL22A1,5,1,316,322,4
HS3ST3B1,8,4,310,322,4
NPBWR1,4,0,318,322,4
COL4A3,7,3,312,322,4
FRK,7,3,312,322,4
OTUD7A,5,1,316,322,4
COL25A1,8,4,310,322,4
COL24A1,8,4,310,322,4
OXA1L,8,4,310,322,4
ETS2,8,4,310,322,4
NOVA2,7,3,312,322,4
NOVA1,10,6,306,322,4
OXNAD1,5,1,316,322,4
CRMP1,10,6,306,322,4
TNFSF11,4,0,318,322,4
P2RY14,8,4,310,322,4
ZNF787,9,5,308,322,4
NOSIP,10,6,306,322,4
COL16A1,7,3,312,322,4
TRIM44,4,0,318,322,4
HSD17B10,11,7,304,322,4
ZNF781,6,2,314,322,4
TNFSF15,6,2,314,322,4
COL11A1,4,0,318,322,4
ZNF780B,6,2,314,322,4
HSD17B13,11,7,304,322,4
TNFSF12,9,5,308,322,4
CNPY3,9,5,308,322,4
PARPBP,6,2,314,322,4
FST,8,4,310,322,4
NHEJ1,7,3,312,322,4
TRIML1,5,1,316,322,4
ERV3-1,5,1,316,322,4
ERP44,5,1,316,322,4
PCDHGA9,5,1,316,322,4
TMEM82,13,9,300,322,4
ZNF695,10,6,306,322,4
CNDP1,7,3,312,322,4
ZNF688,9,5,308,322,4
TMEM45B,5,1,316,322,4
FUT11,8,4,310,322,4
CMTM5,8,4,310,322,4
ZNF679,18,14,290,322,4
TMEM41A,5,1,316,322,4
HSPA13,7,3,312,322,4
NGLY1,7,3,312,322,4
PCSK6,5,1,316,322,4
PCTP,9,5,308,322,4
NGEF,15,11,296,322,4
HIGD2A,10,6,306,322,4
NFYB,5,1,316,322,4
PDCL2,13,9,300,322,4
PDE10A,4,0,318,322,4
CMBL,6,2,314,322,4
NFKB2,12,8,302,322,4
HTR7,6,2,314,322,4
ERLIN2,6,2,314,322,4
PCDHGA5,8,4,310,322,4
FKBP7,7,3,312,322,4
ARHGAP12,11,7,304,322,4
TRIM9,8,4,310,322,4
PATE3,6,2,314,322,4
CNPY1,13,9,300,322,4
PAWR,7,3,312,322,4
CNOT9,6,2,314,322,4
PAX7,6,2,314,322,4
PAXBP1,8,4,310,322,4
CNOT7,9,5,308,322,4
NLGN2,10,6,306,322,4
ESPN,16,12,294,322,4
NKX6-3,6,2,314,322,4
ZNF708,7,3,312,322,4
PCARE,6,2,314,322,4
CNNM4,7,3,312,322,4
ZNF705E,6,2,314,322,4
PCDH1,11,7,304,322,4
ARGFX,6,2,314,322,4
FTSJ1,7,3,312,322,4
ARHGAP10,5,1,316,322,4
ZNF7,8,4,310,322,4
ANOS1,7,3,312,322,4
PCDHAC1,5,1,316,322,4
PCDHAC2,7,3,312,322,4
PCDHB11,4,0,318,322,4
NIT1,5,1,316,322,4
PCDHB5,7,3,312,322,4
TNNT3,7,3,312,322,4
OTOGL,6,2,314,322,4
HS3ST2,4,0,318,322,4
ONECUT2,6,2,314,322,4
CPLANE1,4,0,318,322,4
FN3K,14,10,298,322,4
EXOC3L2,8,4,310,322,4
FMR1,8,4,310,322,4
TRAV14DV4,4,0,318,322,4
HOMER2,10,6,306,322,4
OLIG2,7,3,312,322,4
HMGB2,7,3,312,322,4
FOXF2,5,1,316,322,4
NTRK1,11,7,304,322,4
NTNG2,7,3,312,322,4
TRAPPC8,7,3,312,322,4
NTM,7,3,312,322,4
TRAF6,7,3,312,322,4
TRAPPC3L,7,3,312,322,4
FOXI1,5,1,316,322,4
HMG20B,9,5,308,322,4
NT5E,7,3,312,322,4
TRAPPC13,7,3,312,322,4
AP4E1,4,0,318,322,4
TRAM2,6,2,314,322,4
FMO4,7,3,312,322,4
OR11H6,9,5,308,322,4
NSUN4,5,1,316,322,4
HOXA7,14,10,298,322,4
ZNRF2,7,3,312,322,4
TRGV9,4,0,318,322,4
EXOC4,8,4,310,322,4
NUDT13,13,9,300,322,4
HNRNPLL,7,3,312,322,4
TRBV5-7,8,4,310,322,4
TRBV5-6,7,3,312,322,4
TRBV4-1,4,0,318,322,4
FNDC9,11,7,304,322,4
COX18,5,1,316,322,4
NUP210,6,2,314,322,4
TRDMT1,7,3,312,322,4
NYAP1,10,6,306,322,4
ZSCAN30,7,3,312,322,4
TRBJ2-3,11,7,304,322,4
FNDC3B,6,2,314,322,4
NUGGC,6,2,314,322,4
AAK1,5,1,316,322,4
ZRANB3,6,2,314,322,4
OBP2A,9,5,308,322,4
HNRNPH1,9,5,308,322,4
HMGCR,13,9,300,322,4
NUDT3,5,1,316,322,4
NUDT22,10,6,306,322,4
NUDT2,10,6,306,322,4
AP1G2,10,6,306,322,4
CORO2A,4,0,318,322,4
ODF3B,21,17,284,322,4
NUDT16L1,8,4,310,322,4
NUDT16,8,4,310,322,4
AP1AR,8,4,310,322,4
NSFL1C,7,3,312,322,4
ZNF791,5,1,316,322,4
NPM3,11,7,304,322,4
CREB3,10,6,306,322,4
TOR1AIP1,6,2,314,322,4
CREB3L2,6,2,314,322,4
OR6B2,4,0,318,322,4
COMMD1,10,6,306,322,4
OR6C4,4,0,318,322,4
OR6C75,5,1,316,322,4
FLT4,4,0,318,322,4
CREBRF,7,3,312,322,4
CREBZF,10,6,306,322,4
HPS5,5,1,316,322,4
OR7A17,7,3,312,322,4
TRIM39-RPP21,15,11,296,322,4
TRAF3IP1,5,1,316,322,4
TOMM7,11,7,304,322,4
APOBEC3F,7,3,312,322,4
NPIPB4,10,6,306,322,4
ZNF805,6,2,314,322,4
ETV3L,5,1,316,322,4
EZHIP,4,0,318,322,4
TNRC18,11,7,304,322,4
OSBPL9,8,4,310,322,4
OSGEP,9,5,308,322,4
ZNF8,5,1,316,322,4
HS2ST1,7,3,312,322,4
TNPO1,9,5,308,322,4
HPF1,12,8,302,322,4
TOX2,8,4,310,322,4
OR5AS1,6,2,314,322,4
APOA4,4,0,318,322,4
OR1D2,5,1,316,322,4
FOXN4,7,3,312,322,4
OR1J4,6,2,314,322,4
OR1L6,5,1,316,322,4
OR2A12,4,0,318,322,4
ZNF92,10,6,306,322,4
TPR,8,4,310,322,4
NRIP1,10,6,306,322,4
OR2L8,9,5,308,322,4
NRF1,8,4,310,322,4
ZNF90,13,9,300,322,4
OR3A2,6,2,314,322,4
COMMD4,7,3,312,322,4
OR4C3,8,4,310,322,4
OR4D9,7,3,312,322,4
OR4E1,4,0,318,322,4
APH1A,8,4,310,322,4
OR4F15,6,2,314,322,4
OR4K17,6,2,314,322,4
OR4S1,5,1,316,322,4
TPCN2,5,1,316,322,4
CRACDL,14,10,298,322,4
COMMD2,8,4,310,322,4
OR52E4,6,2,314,322,4
NR2C1,8,4,310,322,4
ZNF653,15,11,296,322,4
PDE6A,6,2,314,322,4
MTREX,8,4,310,322,4
PLCH1,4,0,318,322,4
MZF1,13,9,300,322,4
ACADM,6,2,314,322,4
PLAGL1,7,3,312,322,4
PLB1,6,2,314,322,4
CIAO1,5,1,316,322,4
GAPDH,10,6,306,322,4
CXorf51B,9,5,308,322,4
HERC1,9,5,308,322,4
TLCD5,6,2,314,322,4
ZNF415,16,12,294,322,4
MYOM3,7,3,312,322,4
HEPHL1,4,0,318,322,4
PLCL1,5,1,316,322,4
TLL2,4,0,318,322,4
TSG101,7,3,312,322,4
ZNF407,4,0,318,322,4
MYO9B,9,5,308,322,4
MYO6,5,1,316,322,4
ZNF397,6,2,314,322,4
TINCR,9,5,308,322,4
ARSG,7,3,312,322,4
ANKRD36,7,3,312,322,4
MYO1F,8,4,310,322,4
PLEKHA5,5,1,316,322,4
ZNF396,10,6,306,322,4
FGF23,5,1,316,322,4
GAN,4,0,318,322,4
ANKRD44,6,2,314,322,4
TMEM268,5,1,316,322,4
CIT,7,3,312,322,4
ARMH3,8,4,310,322,4
ARMH4,6,2,314,322,4
ZNF442,9,5,308,322,4
PISD,10,6,306,322,4
PITHD1,7,3,312,322,4
ZNF441,9,5,308,322,4
ZNF44,7,3,312,322,4
NAF1,7,3,312,322,4
PITX1,11,7,304,322,4
TM6SF1,18,14,290,322,4
CXCL1,21,17,284,322,4
PIWIL3,6,2,314,322,4
CISD3,5,1,316,322,4
GALT,10,6,306,322,4
ARPC1A,10,6,306,322,4
PKD2,7,3,312,322,4
TM2D2,6,2,314,322,4
TLX3,5,1,316,322,4
FAIM,7,3,312,322,4
CIP2A,8,4,310,322,4
IGFBPL1,7,3,312,322,4
NAA25,5,1,316,322,4
TLR7,5,1,316,322,4
NAA11,5,1,316,322,4
NAA10,11,7,304,322,4
ARPIN,8,4,310,322,4
CYB561,7,3,312,322,4
EPHA5,5,1,316,322,4
PLEKHH3,9,5,308,322,4
MUC4,5,1,316,322,4
IGHV3-30,11,7,304,322,4
ASB7,7,3,312,322,4
PNPLA2,7,3,312,322,4
PNPLA4,5,1,316,322,4
PNPLA5,4,0,318,322,4
THAP12,7,3,312,322,4
FGB,6,2,314,322,4
ASCC3,7,3,312,322,4
POC1B,8,4,310,322,4
PODN,6,2,314,322,4
PODXL,7,3,312,322,4
IGHV3-49,5,1,316,322,4
MUC21,5,1,316,322,4
PLG,6,2,314,322,4
POLD2,11,7,304,322,4
HEG1,10,6,306,322,4
TGIF2LY,4,0,318,322,4
CYP27B1,10,6,306,322,4
POLE4,5,1,316,322,4
MTUS1,7,3,312,322,4
CYP2A6,9,5,308,322,4
TFPT,11,7,304,322,4
POLR1B,9,5,308,322,4
CYP2B6,8,4,310,322,4
TFEB,8,4,310,322,4
ANKRD26,6,2,314,322,4
CHMP2B,6,2,314,322,4
TSPAN31,6,2,314,322,4
MXI1,11,7,304,322,4
GATM,19,15,288,322,4
MYLK3,6,2,314,322,4
MYLK2,8,4,310,322,4
TIMM10,9,5,308,322,4
ANKRD35,7,3,312,322,4
CHRNB2,12,8,302,322,4
CYB5R3,7,3,312,322,4
IGHV1-24,10,6,306,322,4
ACBD7,6,2,314,322,4
FGF19,7,3,312,322,4
GATAD1,6,2,314,322,4
PLXNA3,6,2,314,322,4
ASB11,6,2,314,322,4
MYDGF,11,7,304,322,4
THOC7,8,4,310,322,4
PMM1,11,7,304,322,4
THOC2,8,4,310,322,4
IGHV2-70D,5,1,316,322,4
PMS1,7,3,312,322,4
FGF13,7,3,312,322,4
MYBPC2,5,1,316,322,4
CHN1,9,5,308,322,4
MYB,5,1,316,322,4
TSPAN15,6,2,314,322,4
FGF12,13,9,300,322,4
PNMA2,8,4,310,322,4
TMC6,9,5,308,322,4
ACAA2,6,2,314,322,4
CWC22,5,1,316,322,4
CTBS,5,1,316,322,4
ZNF600,7,3,312,322,4
NECTIN1,7,3,312,322,4
G3BP2,12,8,302,322,4
ARHGEF2,12,8,302,322,4
NEBL,7,3,312,322,4
HHIPL1,5,1,316,322,4
PFDN4,9,5,308,322,4
NDUFV2,9,5,308,322,4
PFN2,10,6,306,322,4
IDH2,9,5,308,322,4
ZNF587,6,2,314,322,4
CTBP1,12,8,302,322,4
TMEM199,7,3,312,322,4
ABHD1,16,12,294,322,4
ANKS6,6,2,314,322,4
FABP5,14,10,298,322,4
NDUFAF8,10,6,306,322,4
FIGN,4,0,318,322,4
PGLS,11,7,304,322,4
NDUFAF5,8,4,310,322,4
PGLYRP1,12,8,302,322,4
HGSNAT,8,4,310,322,4
PGR,8,4,310,322,4
ANKS1B,17,13,292,322,4
NDUFA11,8,4,310,322,4
ABCG5,6,2,314,322,4
PES1,8,4,310,322,4
ICE2,7,3,312,322,4
PER3,7,3,312,322,4
NEFH,6,2,314,322,4
NFATC1,5,1,316,322,4
FXYD3,15,11,296,322,4
TMEM267,4,0,318,322,4
PDE8A,7,3,312,322,4
HIF3A,6,2,314,322,4
ERI2,6,2,314,322,4
TMEM255A,12,8,302,322,4
PDLIM3,11,7,304,322,4
PDP2,8,4,310,322,4
ZNF638,12,8,302,322,4
ZNF626,7,3,312,322,4
PDSS1,8,4,310,322,4
PDSS2,5,1,316,322,4
NENF,8,4,310,322,4
IARS1,7,3,312,322,4
CLNS1A,10,6,306,322,4
CLN6,9,5,308,322,4
IBTK,6,2,314,322,4
NEK5,4,0,318,322,4
ERG28,6,2,314,322,4
NEK2,8,4,310,322,4
CT45A2,14,10,298,322,4
NEK1,6,2,314,322,4
PEMT,10,6,306,322,4
TRMT9B,7,3,312,322,4
PHF19,9,5,308,322,4
TMEM170A,5,1,316,322,4
PIM1,10,6,306,322,4
EPS8,8,4,310,322,4
ZNF503,12,8,302,322,4
PIEZO2,5,1,316,322,4
NBPF19,11,7,304,322,4
PIGB,9,5,308,322,4
PIGC,6,2,314,322,4
NBPF1,7,3,312,322,4
TRPM6,5,1,316,322,4
TRPM7,6,2,314,322,4
ABLIM2,8,4,310,322,4
NAV3,8,4,310,322,4
IFT140,13,9,300,322,4
PIK3AP1,6,2,314,322,4
IFT22,5,1,316,322,4
ZNF568,8,4,310,322,4
TMED7,8,4,310,322,4
CLC,8,4,310,322,4
GALNT1,8,4,310,322,4
CLBA1,8,4,310,322,4
PIK3CD,6,2,314,322,4
NARS2,7,3,312,322,4
CUL3,10,6,306,322,4
ARMC4,14,10,298,322,4
IFT52,8,4,310,322,4
PILRB,11,7,304,322,4
GALNT14,10,6,306,322,4
NAP1L3,6,2,314,322,4
ZNF506,9,5,308,322,4
ZNF507,5,1,316,322,4
IFNG,4,0,318,322,4
IFNB1,10,6,306,322,4
TRPC5,4,0,318,322,4
PHGDH,10,6,306,322,4
ABHD12,10,6,306,322,4
NDC1,6,2,314,322,4
CTNNBL1,8,4,310,322,4
PHKB,9,5,308,322,4
ZNF551,11,7,304,322,4
ARL11,7,3,312,322,4
CTPS2,8,4,310,322,4
NCMAP,6,2,314,322,4
ABHD17A,7,3,312,322,4
ABHD2,7,3,312,322,4
TMEM147,11,7,304,322,4
TMEM143,9,5,308,322,4
GADD45GIP1,9,5,308,322,4
CTSG,5,1,316,322,4
NCEH1,6,2,314,322,4
ZNF525,9,5,308,322,4
TMEM129,13,9,300,322,4
TMEM120B,7,3,312,322,4
TRPM2,6,2,314,322,4
IFNAR1,9,5,308,322,4
NCAPD3,6,2,314,322,4
ZNF510,5,1,316,322,4
PIBF1,7,3,312,322,4
SYNGR3,14,10,298,322,4
MIF,11,7,304,322,4
ALG14,4,0,318,322,4
SRPX2,6,2,314,322,4
LOXL2,9,5,308,322,4
SBNO2,8,4,310,322,4
LOXHD1,7,3,312,322,4
CAMK2N1,6,2,314,322,4
LONRF3,6,2,314,322,4
LONP2,6,2,314,322,4
KAT2B,7,3,312,322,4
LNPEP,6,2,314,322,4
CAMK2G,10,6,306,322,4
FAM90A7P,7,3,312,322,4
DNLZ,6,2,314,322,4
DNM3,12,8,302,322,4
BCL9L,9,5,308,322,4
VPS29,7,3,312,322,4
FAM184B,4,0,318,322,4
SRP68,12,8,302,322,4
BDP1,6,2,314,322,4
DNPEP,7,3,312,322,4
SCARB2,7,3,312,322,4
SRL,4,0,318,322,4
VPS13B,5,1,316,322,4
LMAN1,6,2,314,322,4
AGFG1,6,2,314,322,4
BECN2,7,3,312,322,4
CAMK4,8,4,310,322,4
BCL9,6,2,314,322,4
DOCK1,6,2,314,322,4
SAP30L,6,2,314,322,4
LRIG2,4,0,318,322,4
JPH3,9,5,308,322,4
JPT1,11,7,304,322,4
SAMD4A,5,1,316,322,4
SAMD8,6,2,314,322,4
AFM,4,0,318,322,4
JPT2,9,5,308,322,4
SAP130,5,1,316,322,4
SS18,6,2,314,322,4
JRKL,5,1,316,322,4
JTB,7,3,312,322,4
UBL4A,14,10,298,322,4
SAXO1,6,2,314,322,4
DNALI1,13,9,300,322,4
LPO,6,2,314,322,4
SRY,6,2,314,322,4
GPR151,9,5,308,322,4
SRSF8,5,1,316,322,4
FAM177A1,7,3,312,322,4
CAMKV,10,6,306,322,4
KANK3,13,9,300,322,4
CAMKMT,8,4,310,322,4
DNASE1L1,8,4,310,322,4
SYNGR2,7,3,312,322,4
VNN2,13,9,300,322,4
LITAFD,12,8,302,322,4
VSIG10,6,2,314,322,4
KCNH6,9,5,308,322,4
LHFPL3,8,4,310,322,4
SEL1L2,7,3,312,322,4
SELE,6,2,314,322,4
SPRR2G,5,1,316,322,4
LGSN,5,1,316,322,4
CABIN1,12,8,302,322,4
SELENOO,8,4,310,322,4
SPRR2A,6,2,314,322,4
LGALSL,10,6,306,322,4
SELENOV,13,9,300,322,4
SEMA3E,6,2,314,322,4
SPRR1A,8,4,310,322,4
SEC61A2,9,5,308,322,4
FAM81A,10,6,306,322,4
BHLHA15,7,3,312,322,4
LGALS13,7,3,312,322,4
SEMA5A,6,2,314,322,4
SEMA6B,6,2,314,322,4
CA1,13,9,300,322,4
DPF3,8,4,310,322,4
C9orf85,7,3,312,322,4
DPH3,7,3,312,322,4
LEPROTL1,9,5,308,322,4
SPOPL,4,0,318,322,4
SECISBP2L,5,1,316,322,4
DOK5,7,3,312,322,4
CALM1,10,6,306,322,4
SDAD1,7,3,312,322,4
CALHM5,4,0,318,322,4
GPR27,6,2,314,322,4
SCN8A,4,0,318,322,4
VN1R1,11,7,304,322,4
SCO1,6,2,314,322,4
VMP1,8,4,310,322,4
SREK1IP1,4,0,318,322,4
SREK1,6,2,314,322,4
AGMAT,6,2,314,322,4
KCNA3,4,0,318,322,4
LINC00514,8,4,310,322,4
LIMS2,7,3,312,322,4
AGXT2,6,2,314,322,4
LIMK2,7,3,312,322,4
LIMD1,8,4,310,322,4
GPR62,9,5,308,322,4
SPTY2D1,4,0,318,322,4
BEX1,8,4,310,322,4
VEGFB,14,10,298,322,4
H1-10,8,4,310,322,4
SEC22B,6,2,314,322,4
UBXN1,8,4,310,322,4
DOK3,7,3,312,322,4
BFSP2,5,1,316,322,4
EIF2AK3,10,6,306,322,4
SALL4,5,1,316,322,4
RPA3,7,3,312,322,4
RPS4X,10,6,306,322,4
WDR3,7,3,312,322,4
RPS20,11,7,304,322,4
STAMBPL1,4,0,318,322,4
RPS24,11,7,304,322,4
STAM2,6,2,314,322,4
STAG3,11,7,304,322,4
H2BC5,14,10,298,322,4
RPS29,11,7,304,322,4
WDR1,10,6,306,322,4
GPC1,8,4,310,322,4
ITM2C,11,7,304,322,4
GPC4,6,2,314,322,4
WDR31,5,1,316,322,4
BCAS2,10,6,306,322,4
WBP4,6,2,314,322,4
ADPRH,7,3,312,322,4
RPS6KA5,8,4,310,322,4
ITPKB,9,5,308,322,4
RPS6KC1,8,4,310,322,4
LSM1,8,4,310,322,4
LSG1,8,4,310,322,4
DNAH2,6,2,314,322,4
RPS7,10,6,306,322,4
CBLN2,5,1,316,322,4
BBS7,6,2,314,322,4
LURAP1,7,3,312,322,4
FAM172A,6,2,314,322,4
GOPC,6,2,314,322,4
MAB21L3,6,2,314,322,4
RPEL1,6,2,314,322,4
RPGRIP1L,6,2,314,322,4
BARHL2,6,2,314,322,4
DLST,9,5,308,322,4
STK3,5,1,316,322,4
EIPR1,10,6,306,322,4
ITCH,8,4,310,322,4
LYRM7,10,6,306,322,4
ITFG1,8,4,310,322,4
BARX1,10,6,306,322,4
UBE2F,9,5,308,322,4
WDR35,6,2,314,322,4
ITGA2,5,1,316,322,4
LYN,6,2,314,322,4
WDR48,10,6,306,322,4
EIF4H,9,5,308,322,4
STIM2,8,4,310,322,4
DMRT2,6,2,314,322,4
RPP21,8,4,310,322,4
FAR1,6,2,314,322,4
STAT1,9,5,308,322,4
GPALPP1,4,0,318,322,4
LUZP2,4,0,318,322,4
LRTM1,4,0,318,322,4
GPD2,7,3,312,322,4
SAFB2,7,3,312,322,4
CARNMT1,8,4,310,322,4
CASKIN1,6,2,314,322,4
RUNDC3B,9,5,308,322,4
BCL11A,10,6,306,322,4
RUNX1,7,3,312,322,4
LRRC37B,8,4,310,322,4
EIF2S1,5,1,316,322,4
BCL11B,6,2,314,322,4
DNAJC15,4,0,318,322,4
BCL2L12,7,3,312,322,4
LRRC27,6,2,314,322,4
LRRC26,12,8,302,322,4
ADSS2,6,2,314,322,4
RTTN,7,3,312,322,4
ALG3,8,4,310,322,4
RYR2,5,1,316,322,4
VWA2,5,1,316,322,4
SSC4D,6,2,314,322,4
LRRC1,5,1,316,322,4
CARD8,10,6,306,322,4
JHY,4,0,318,322,4
JKAMP,9,5,308,322,4
UBE3C,5,1,316,322,4
LRP12,7,3,312,322,4
VSNL1,14,10,298,322,4
ADRM1,10,6,306,322,4
ALG9,9,5,308,322,4
ITPR3,5,1,316,322,4
CATSPERD,4,0,318,322,4
WASHC5,6,2,314,322,4
RRAS2,5,1,316,322,4
ST8SIA1,7,3,312,322,4
RREB1,8,4,310,322,4
CBFB,9,5,308,322,4
CAVIN1,9,5,308,322,4
ITPRIPL1,6,2,314,322,4
WASHC4,8,4,310,322,4
CATSPERE,4,0,318,322,4
LRRC8E,8,4,310,322,4
RSPH1,4,0,318,322,4
WASF3,8,4,310,322,4
RTN4RL2,20,16,286,322,4
ST6GAL1,14,10,298,322,4
DNAJB13,17,13,292,322,4
RTCB,7,3,312,322,4
GPM6B,18,14,290,322,4
EIF3E,12,8,302,322,4
LRRC59,6,2,314,322,4
RTL8C,10,6,306,322,4
ST20-MTHFS,18,14,290,322,4
CASP3,8,4,310,322,4
IZUMO2,13,9,300,322,4
IZUMO3,6,2,314,322,4
BHLHE41,7,3,312,322,4
BHMT2,6,2,314,322,4
SENP5,6,2,314,322,4
C12orf43,6,2,314,322,4
C14orf119,7,3,312,322,4
SLC5A12,7,3,312,322,4
SLC5A2,12,8,302,322,4
C12orf76,9,5,308,322,4
UROS,10,6,306,322,4
C12orf66,4,0,318,322,4
C12orf65,6,2,314,322,4
SLC6A20,4,0,318,322,4
URM1,11,7,304,322,4
SLC7A10,7,3,312,322,4
KREMEN1,7,3,312,322,4
KRBA1,13,9,300,322,4
SLC4A2,6,2,314,322,4
GTPBP1,10,6,306,322,4
UGT3A1,6,2,314,322,4
KPNA6,5,1,316,322,4
DUSP19,4,0,318,322,4
SLCO1B3,4,0,318,322,4
KIAA1217,5,1,316,322,4
SLCO4C1,5,1,316,322,4
GSDMC,5,1,316,322,4
C11orf71,5,1,316,322,4
KNCN,5,1,316,322,4
KMT5A,6,2,314,322,4
SLC4A4,11,7,304,322,4
SLC44A1,6,2,314,322,4
KLRG2,8,4,310,322,4
SLC31A1,6,2,314,322,4
SLC26A7,11,7,304,322,4
SLC27A2,4,0,318,322,4
USP14,6,2,314,322,4
FAM246B,14,10,298,322,4
SLC28A2,7,3,312,322,4
AKAP3,10,6,306,322,4
KDSR,5,1,316,322,4
SLC2A13,7,3,312,322,4
SLC2A6,12,8,302,322,4
SLC30A4,6,2,314,322,4
SLC30A9,6,2,314,322,4
SLC34A1,6,2,314,322,4
SORT1,7,3,312,322,4
ALAS1,8,4,310,322,4
SLC35D1,4,0,318,322,4
SLC35E2B,7,3,312,322,4
USO1,6,2,314,322,4
SLC35G6,10,6,306,322,4
SLC36A1,10,6,306,322,4
SLC37A3,9,5,308,322,4
KRT5,7,3,312,322,4
SLC39A7,9,5,308,322,4
SLC39A9,6,2,314,322,4
UGT1A3,7,3,312,322,4
FAM216A,6,2,314,322,4
UGT8,6,2,314,322,4
C9orf57,6,2,314,322,4
GTDC1,6,2,314,322,4
SNTA1,8,4,310,322,4
UNC5D,5,1,316,322,4
SMIM33,9,5,308,322,4
SNRPF,9,5,308,322,4
GSTM4,12,8,302,322,4
BTBD18,11,7,304,322,4
DZIP1,6,2,314,322,4
SNRPB2,7,3,312,322,4
BTAF1,5,1,316,322,4
EBF2,4,0,318,322,4
SNRNP70,8,4,310,322,4
SMS,7,3,312,322,4
DYRK2,7,3,312,322,4
SMURF1,5,1,316,322,4
EAPP,6,2,314,322,4
KLF13,13,9,300,322,4
SNRNP25,9,5,308,322,4
SNIP1,6,2,314,322,4
SNAP29,7,3,312,322,4
FAM221A,7,3,312,322,4
GSTT2B,19,15,288,322,4
SNCB,10,6,306,322,4
EAF2,13,9,300,322,4
E2F7,8,4,310,322,4
GSTK1,10,6,306,322,4
SNTG1,6,2,314,322,4
C11orf1,8,4,310,322,4
KLHL7,7,3,312,322,4
UQCC1,6,2,314,322,4
SMAGP,6,2,314,322,4
SMAP1,8,4,310,322,4
SNX30,8,4,310,322,4
C10orf53,8,4,310,322,4
SMARCAD1,6,2,314,322,4
KIF14,4,0,318,322,4
KLK15,12,8,302,322,4
DYNC1I1,8,4,310,322,4
BRD3,10,6,306,322,4
FAM217B,8,4,310,322,4
SMC3,6,2,314,322,4
KIF26B,5,1,316,322,4
AKR7A2,9,5,308,322,4
ULBP2,10,6,306,322,4
ULK1,8,4,310,322,4
SMIM10L1,5,1,316,322,4
GSTA2,7,3,312,322,4
SMIM11A,35,31,256,322,4
AKR1B10,8,4,310,322,4
BRICD5,11,7,304,322,4
SMIM15,9,5,308,322,4
DYNC2LI1,8,4,310,322,4
KIF26A,5,1,316,322,4
C19orf53,10,6,306,322,4
SLC25A48,10,6,306,322,4
DTX4,9,5,308,322,4
FAM71F2,6,2,314,322,4
SFMBT2,5,1,316,322,4
FAM200B,10,6,306,322,4
KCNK3,6,2,314,322,4
UTP23,10,6,306,322,4
SFTPA1,6,2,314,322,4
KCNK6,6,2,314,322,4
SFXN2,6,2,314,322,4
LCA5,6,2,314,322,4
GYPA,5,1,316,322,4
LAT2,7,3,312,322,4
SH3BP2,8,4,310,322,4
BMP2,7,3,312,322,4
SETX,5,1,316,322,4
USP8,7,3,312,322,4
SHCBP1L,4,0,318,322,4
DROSHA,7,3,312,322,4
DSC1,4,0,318,322,4
LAMTOR5,8,4,310,322,4
SHISA7,5,1,316,322,4
BMP8A,5,1,316,322,4
KCNRG,13,9,300,322,4
USP6NL,6,2,314,322,4
LAMP2,7,3,312,322,4
FAM205C,5,1,316,322,4
LCE3E,6,2,314,322,4
SETMAR,7,3,312,322,4
SLC25A34,6,2,314,322,4
C6orf226,21,17,284,322,4
FAM200A,5,1,316,322,4
VAC14,9,5,308,322,4
KCNJ13,18,14,290,322,4
C8orf76,10,6,306,322,4
SERF1B,21,17,284,322,4
BIN1,7,3,312,322,4
UXT,11,7,304,322,4
DPP3,9,5,308,322,4
GPT2,10,6,306,322,4
UVRAG,6,2,314,322,4
KCNJ4,8,4,310,322,4
C6orf141,7,3,312,322,4
DR1,8,4,310,322,4
LCTL,8,4,310,322,4
DPY19L1,10,6,306,322,4
BIVM,6,2,314,322,4
FAM72D,8,4,310,322,4
AIFM1,8,4,310,322,4
DPY19L3,7,3,312,322,4
UTS2,18,14,290,322,4
BLMH,10,6,306,322,4
BLOC1S1,9,5,308,322,4
LCN1,10,6,306,322,4
SETD6,9,5,308,322,4
USP51,5,1,316,322,4
USP49,6,2,314,322,4
LAMC1,6,2,314,322,4
KRTAP3-3,5,1,316,322,4
SPANXA1,23,19,280,322,4
SPAM1,7,3,312,322,4
KDF1,22,18,282,322,4
SLC16A7,5,1,316,322,4
GRIN2C,7,3,312,322,4
EEF1AKMT2,6,2,314,322,4
KRTAP4-5,4,0,318,322,4
SLC18A2,5,1,316,322,4
SLC19A1,9,5,308,322,4
SLC1A5,9,5,308,322,4
KDM2B,9,5,308,322,4
C1orf174,7,3,312,322,4
SPATA5,4,0,318,322,4
SLC22A5,8,4,310,322,4
SLC22A6,6,2,314,322,4
SLC24A3,4,0,318,322,4
KDM4B,8,4,310,322,4
BOLA2,15,11,296,322,4
GUCA2B,8,4,310,322,4
SP4,8,4,310,322,4
GRK3,5,1,316,322,4
SLC25A24,6,2,314,322,4
SLC25A25,12,8,302,322,4
C1GALT1,5,1,316,322,4
SLC10A4,9,5,308,322,4
C1QC,5,1,316,322,4
GUCY1B1,7,3,312,322,4
FAM43B,6,2,314,322,4
DSEL,5,1,316,322,4
DSG1,6,2,314,322,4
KCNT2,6,2,314,322,4
SHOX2,8,4,310,322,4
GXYLT1,6,2,314,322,4
DSG4,4,0,318,322,4
GUSB,9,5,308,322,4
DSP,4,0,318,322,4
USP39,9,5,308,322,4
DSTYK,6,2,314,322,4
EFCAB14,6,2,314,322,4
LACTB,6,2,314,322,4
SIK2,5,1,316,322,4
GUF1,4,0,318,322,4
SPATA20,10,6,306,322,4
UCP1,6,2,314,322,4
EEF1E1,7,3,312,322,4
C1QTNF9,8,4,310,322,4
SIX5,6,2,314,322,4
SKA1,7,3,312,322,4
SKA3,8,4,310,322,4
KCTD5,10,6,306,322,4
SPANXN1,11,7,304,322,4
RPAP3,5,1,316,322,4
RSAD2,4,0,318,322,4
GNAI1,4,0,318,322,4
DHRS7B,12,8,302,322,4
DEFB132,4,0,318,322,4
RNF169,6,2,314,322,4
DGLUCY,9,5,308,322,4
WNT5A,7,3,312,322,4
MARCHF3,9,5,308,322,4
IRS1,4,0,318,322,4
BAG4,5,1,316,322,4
FBN3,8,4,310,322,4
RAP1GAP2,5,1,316,322,4
CD209,5,1,316,322,4
MANF,12,8,302,322,4
ELF2,9,5,308,322,4
SULF1,13,9,300,322,4
MCFD2,8,4,310,322,4
RASGEF1C,7,3,312,322,4
FAM160B2,9,5,308,322,4
RFX1,10,6,306,322,4
SUZ12,6,2,314,322,4
SYCN,7,3,312,322,4
DEPDC4,8,4,310,322,4
SYAP1,6,2,314,322,4
STX16,7,3,312,322,4
B3GNT7,8,4,310,322,4
STRADB,8,4,310,322,4
RIPK2,6,2,314,322,4
RAN,10,6,306,322,4
B3GNT2,8,4,310,322,4
IP6K2,11,7,304,322,4
CCDC24,7,3,312,322,4
WWC3,5,1,316,322,4
XPO7,6,2,314,322,4
MBNL1,5,1,316,322,4
GMPS,8,4,310,322,4
DET1,7,3,312,322,4
WNT3A,4,0,318,322,4
WWC2,5,1,316,322,4
MARF1,8,4,310,322,4
RIMS2,6,2,314,322,4
MAP11,9,5,308,322,4
WFDC12,13,9,300,322,4
WFDC13,4,0,318,322,4
ADCY6,11,7,304,322,4
RINL,9,5,308,322,4
REXO4,8,4,310,322,4
SUSD5,8,4,310,322,4
CD302,7,3,312,322,4
MAN2C1,12,8,302,322,4
MECP2,13,9,300,322,4
DIABLO,6,2,314,322,4
RBM27,5,1,316,322,4
MAPK3,12,8,302,322,4
RNF114,11,7,304,322,4
MDFIC,6,2,314,322,4
IRF2,11,7,304,322,4
ELK1,8,4,310,322,4
RASEF,13,9,300,322,4
MAPK9,7,3,312,322,4
GOLGA8A,8,4,310,322,4
CCDC71L,12,8,302,322,4
RBM41,7,3,312,322,4
MCC,7,3,312,322,4
CCL28,7,3,312,322,4
RNF111,8,4,310,322,4
INPP5B,5,1,316,322,4
CCS,9,5,308,322,4
RBM34,9,5,308,322,4
RASA1,8,4,310,322,4
HADHA,9,5,308,322,4
EMC4,8,4,310,322,4
MDH1,8,4,310,322,4
CCL4L2,9,5,308,322,4
RASGEF1A,14,10,298,322,4
EMC7,9,5,308,322,4
WFDC6,7,3,312,322,4
RBM7,6,2,314,322,4
RNF145,5,1,316,322,4
FBXL18,6,2,314,322,4
DIPK2A,8,4,310,322,4
RBMXL1,5,1,316,322,4
CCL14,11,7,304,322,4
AXIN2,9,5,308,322,4
XRRA1,10,6,306,322,4
DERL2,7,3,312,322,4
MBTPS1,9,5,308,322,4
RNF14,11,7,304,322,4
TWNK,7,3,312,322,4
MAGT1,6,2,314,322,4
GNPNAT1,5,1,316,322,4
RGS6,11,7,304,322,4
CCDC59,9,5,308,322,4
INSM1,7,3,312,322,4
IPP,7,3,312,322,4
FBLN1,7,3,312,322,4
RAPGEF6,9,5,308,322,4
TXNRD2,7,3,312,322,4
RGPD3,6,2,314,322,4
YARS2,7,3,312,322,4
RIMS1,6,2,314,322,4
SUGCT,13,9,300,322,4
SUCLA2,8,4,310,322,4
ISG20,9,5,308,322,4
DKKL1,32,28,262,322,4
INTS13,9,5,308,322,4
MATN3,5,1,316,322,4
ING3,8,4,310,322,4
RAE1,6,2,314,322,4
FBH1,5,1,316,322,4
INTS12,7,3,312,322,4
TXN2,6,2,314,322,4
XPO6,11,7,304,322,4
GNG14,37,33,252,322,4
MATK,15,11,296,322,4
RECQL4,10,6,306,322,4
SUSD6,8,4,310,322,4
SUN5,4,0,318,322,4
MAP3K15,5,1,316,322,4
GOLIM4,8,4,310,322,4
RHOXF1,17,13,292,322,4
RILP,14,10,298,322,4
DIXDC1,7,3,312,322,4
B4GALT7,8,4,310,322,4
WNK3,5,1,316,322,4
MAP3K9,5,1,316,322,4
CD19,6,2,314,322,4
GOLM2,9,5,308,322,4
ADCY1,4,0,318,322,4
CCNL2,9,5,308,322,4
H6PD,6,2,314,322,4
DLG1,7,3,312,322,4
MACROD2,14,10,298,322,4
YIPF5,7,3,312,322,4
MCMBP,5,1,316,322,4
STXBP5L,14,10,298,322,4
RAD51AP2,4,0,318,322,4
RBCK1,11,7,304,322,4
WNT16,10,6,306,322,4
CD177,8,4,310,322,4
RHOD,9,5,308,322,4
RBL2,6,2,314,322,4
B3GAT2,9,5,308,322,4
WNT2,7,3,312,322,4
SYNE3,4,0,318,322,4
RHOG,9,5,308,322,4
CCDC182,7,3,312,322,4
MAD2L1,8,4,310,322,4
ROM1,16,12,294,322,4
CCNQ,13,9,300,322,4
MAP3K20,5,1,316,322,4
RDH11,8,4,310,322,4
CCNT2,8,4,310,322,4
TYW1,5,1,316,322,4
SUN1,9,5,308,322,4
MAP3K1,8,4,310,322,4
GNA13,7,3,312,322,4
GM2A,11,7,304,322,4
RBX1,8,4,310,322,4
HACD2,6,2,314,322,4
INHBE,11,7,304,322,4
REN,4,0,318,322,4
RASSF3,12,8,302,322,4
WNT2B,5,1,316,322,4
FAM163A,5,1,316,322,4
MAP2K1,6,2,314,322,4
STOM,8,4,310,322,4
TXNDC12,7,3,312,322,4
RNF6,7,3,312,322,4
FAT4,4,0,318,322,4
MAP2K4,8,4,310,322,4
FBXO28,4,0,318,322,4
MAP2K7,6,2,314,322,4
MARVELD3,9,5,308,322,4
MAP2K6,14,10,298,322,4
U2SURP,9,5,308,322,4
RALGAPA1,7,3,312,322,4
YIF1A,13,9,300,322,4
INVS,6,2,314,322,4
TUSC3,11,7,304,322,4
SYK,4,0,318,322,4
WDR82,8,4,310,322,4
GOLGA6L4,8,4,310,322,4
MCM2,9,5,308,322,4
SUCLG1,6,2,314,322,4
RAVER2,7,3,312,322,4
WDR77,6,2,314,322,4
CD1C,4,0,318,322,4
RCBTB2,5,1,316,322,4
RBM28,7,4,311,322,3
BOD1L1,5,2,315,322,3
PANX3,4,1,317,322,3
ADCYAP1R1,8,5,309,322,3
CDHR4,9,6,307,322,3
COG5,6,3,313,322,3
TNFRSF10B,8,5,309,322,3
SLC10A6,5,2,315,322,3
TNFAIP8L2,11,8,303,322,3
ZNF773,7,4,311,322,3
SLC10A7,5,2,315,322,3
PACS2,5,2,315,322,3
PACC1,7,4,311,322,3
RBM20,3,0,319,322,3
C1QA,6,3,313,322,3
PANK2,6,3,313,322,3
SLC22A8,5,2,315,322,3
SLC1A6,6,3,313,322,3
TRIM52,4,1,317,322,3
XPNPEP1,7,4,311,322,3
RBM12B,10,7,305,322,3
PTPN5,4,1,317,322,3
TNFRSF19,7,4,311,322,3
C1orf50,4,1,317,322,3
COA4,9,6,307,322,3
SLC17A5,4,1,317,322,3
XPO4,5,2,315,322,3
CDH8,5,2,315,322,3
AQP7,16,13,293,322,3
ADAM18,9,6,307,322,3
SLC19A2,5,2,315,322,3
PAN3,5,2,315,322,3
BOD1L2,4,1,317,322,3
USP17L15,14,11,297,322,3
TMUB2,4,1,317,322,3
PAFAH2,7,4,311,322,3
ZNF75D,5,2,315,322,3
PTPRH,4,1,317,322,3
USP2,15,12,295,322,3
CDHR3,11,8,303,322,3
C1orf54,25,22,275,322,3
ANP32D,11,8,303,322,3
SLC22A31,5,2,315,322,3
PAK6,15,12,295,322,3
CCDC180,3,0,319,322,3
SLC10A2,3,0,319,322,3
ATP6V1B1,16,13,293,322,3
SH3BGRL2,5,2,315,322,3
RCBTB1,5,2,315,322,3
SPDYC,15,12,295,322,3
SH3GLB1,5,2,315,322,3
PCSK2,5,2,315,322,3
C2orf73,15,12,295,322,3
CMTR2,8,5,309,322,3
SPCS3,6,3,313,322,3
AIG1,7,4,311,322,3
CNBD1,11,8,303,322,3
SHANK3,6,3,313,322,3
PTGER4,7,4,311,322,3
PCGF3,7,4,311,322,3
ZC3H12C,6,3,313,322,3
PTGES3L-AARSD1,18,15,289,322,3
TRIP11,6,3,313,322,3
TMEM53,7,4,311,322,3
ARHGAP23,12,9,301,322,3
ABCC4,5,2,315,322,3
CCR2,4,1,317,322,3
ANO4,4,1,317,322,3
SPATC1L,10,7,305,322,3
SHISA3,5,2,315,322,3
C2CD5,7,4,311,322,3
SHISA5,10,7,305,322,3
PCDHGA6,5,2,315,322,3
SPDYE17,13,10,299,322,3
SGPP1,6,3,313,322,3
SGMS2,10,7,305,322,3
SGMS1,5,2,315,322,3
CLUH,11,8,303,322,3
UTP25,3,0,319,322,3
SPECC1L,8,5,309,322,3
B3GAT1,6,3,313,322,3
PDE4D,4,1,317,322,3
TRIR,8,5,309,322,3
RCN2,7,4,311,322,3
UBXN2A,5,2,315,322,3
TMEM273,10,7,305,322,3
SFT2D1,7,4,311,322,3
ZNF665,6,3,313,322,3
SFTA2,27,24,271,322,3
ZNF667,4,1,317,322,3
ABCC9,6,3,313,322,3
ZNF670,7,4,311,322,3
BLZF1,5,2,315,322,3
RCC1L,9,6,307,322,3
TXLNG,5,2,315,322,3
TMEM38A,7,4,311,322,3
SPDYE2B,16,13,293,322,3
SGCB,9,6,307,322,3
ZNF674,6,3,313,322,3
UTP14A,7,4,311,322,3
ZNF678,10,7,305,322,3
SGK3,9,6,307,322,3
SHISA6,5,2,315,322,3
PCDHGA4,4,1,317,322,3
SHISA8,12,9,301,322,3
TTN,7,4,311,322,3
C22orf15,16,13,293,322,3
ZNF709,30,27,265,322,3
PTPMT1,8,5,309,322,3
ZNF71,5,2,315,322,3
ZNF720,4,1,317,322,3
TVP23C,10,7,305,322,3
SINHCAF,5,2,315,322,3
SPATA18,7,4,311,322,3
AK3,4,1,317,322,3
PAX3,5,2,315,322,3
SIRT5,6,3,313,322,3
TVP23B,6,3,313,322,3
C1R,16,13,293,322,3
BNIP2,7,4,311,322,3
ARFIP1,8,5,309,322,3
PASK,10,7,305,322,3
TTPAL,5,2,315,322,3
RBM46,3,0,319,322,3
PTPN13,7,4,311,322,3
ARFGEF3,3,0,319,322,3
PARP11,6,3,313,322,3
ARFGEF2,5,2,315,322,3
CNPY4,10,7,305,322,3
SLAMF1,5,2,315,322,3
ZNF738,8,5,309,322,3
TRIM66,8,5,309,322,3
UCHL5,6,3,313,322,3
RBP5,26,23,273,322,3
TAL1,4,1,317,322,3
PTGIS,4,1,317,322,3
SUPV3L1,4,1,317,322,3
PTGR2,4,1,317,322,3
CNIH4,6,3,313,322,3
ANK1,8,5,309,322,3
TANC1,4,1,317,322,3
PTH1R,11,8,303,322,3
CDK19,4,1,317,322,3
PCDHA9,4,1,317,322,3
SPATA6,11,8,303,322,3
PCDHA5,3,0,319,322,3
ZNF697,7,4,311,322,3
ATP6V1D,7,4,311,322,3
ATP6V1E1,6,3,313,322,3
PTH2R,4,1,317,322,3
ZC3HAV1L,7,4,311,322,3
TMEM9B,8,5,309,322,3
TMF1,4,1,317,322,3
CDK16,11,8,303,322,3
SHPK,6,3,313,322,3
ZNF700,8,5,309,322,3
ABCB7,8,5,309,322,3
TMLHE,6,3,313,322,3
CNMD,13,10,299,322,3
CNN2,10,7,305,322,3
XKR6,8,5,309,322,3
ATP8B2,5,2,315,322,3
SUV39H2,7,4,311,322,3
RAB35,10,7,305,322,3
ZNRF4,4,1,317,322,3
RAB18,5,2,315,322,3
YAP1,11,8,303,322,3
ZP1,9,6,307,322,3
OR10A5,5,2,315,322,3
OPRK1,4,1,317,322,3
COPS4,7,4,311,322,3
ADCY4,10,7,305,322,3
TRAPPC2B,11,8,303,322,3
OPN1MW2,3,0,319,322,3
ANAPC16,5,2,315,322,3
OPHN1,8,5,309,322,3
BRD3OS,5,2,315,322,3
BZW2,5,2,315,322,3
YTHDC2,8,5,309,322,3
COPS9,10,7,305,322,3
BYSL,9,6,307,322,3
RAB29,5,2,315,322,3
OOSP2,6,3,313,322,3
SYT16,6,3,313,322,3
OMG,7,4,311,322,3
BTRC,7,4,311,322,3
OMA1,9,6,307,322,3
SMIM10L2A,4,1,317,322,3
RAB33A,16,13,293,322,3
RALGPS2,5,2,315,322,3
BRI3BP,4,1,317,322,3
CDC25C,5,2,315,322,3
CD33,10,7,305,322,3
OR11L1,3,0,319,322,3
ZNF98,11,8,303,322,3
AOPEP,8,5,309,322,3
TPSAB1,5,2,315,322,3
CDC37L1,8,5,309,322,3
OR2AG1,3,0,319,322,3
OR2A5,3,0,319,322,3
SLITRK5,3,0,319,322,3
ZNF93,13,10,299,322,3
APBB2,6,3,313,322,3
RAP2B,4,1,317,322,3
ALAD,10,7,305,322,3
APAF1,3,0,319,322,3
SOAT1,4,1,317,322,3
SNX9,6,3,313,322,3
UPK1B,8,5,309,322,3
C11orf24,7,4,311,322,3
TUT1,14,11,297,322,3
ZNFX1,5,2,315,322,3
SLX4,6,3,313,322,3
RAB11FIP5,7,4,311,322,3
AAMDC,7,4,311,322,3
RAB13,9,6,307,322,3
ZNRF1,9,6,307,322,3
OR13J1,4,1,317,322,3
ZNRF3,6,3,313,322,3
SMARCA1,6,3,313,322,3
TRAJ13,3,0,319,322,3
OLIG1,5,2,315,322,3
OLFML2B,8,5,309,322,3
C1GALT1C1,7,4,311,322,3
TRAV23DV6,3,0,319,322,3
RAB5IF,8,5,309,322,3
UNC119B,7,4,311,322,3
SMPD2,12,9,301,322,3
SYNRG,6,3,313,322,3
NYX,3,0,319,322,3
SNRPA,5,2,315,322,3
SYNPO2L,5,2,315,322,3
AVL9,5,2,315,322,3
TRBV15,6,3,313,322,3
ANAPC15,6,3,313,322,3
RAD9B,5,2,315,322,3
BRPF1,7,4,311,322,3
NXPE4,6,3,313,322,3
NXPE3,4,1,317,322,3
TRBV28,7,4,311,322,3
NXPE1,8,5,309,322,3
SMYD3,7,4,311,322,3
TRBV30,20,17,285,322,3
ADCK5,8,5,309,322,3
SYNJ2BP,5,2,315,322,3
AP2A1,8,5,309,322,3
AURKAIP1,10,7,305,322,3
RAD51D,7,4,311,322,3
NUTM2G,10,7,305,322,3
TRBV6-6,12,9,301,322,3
AP1S2,5,2,315,322,3
CD63,10,7,305,322,3
SYNDIG1L,6,3,313,322,3
SMOC2,5,2,315,322,3
UNC13C,3,0,319,322,3
SNTB2,5,2,315,322,3
CDC14C,6,3,313,322,3
TRAV3,6,3,313,322,3
COQ4,9,6,307,322,3
TUBG1,7,4,311,322,3
UNC93B1,11,8,303,322,3
SMIM19,10,7,305,322,3
TRAV39,9,6,307,322,3
SYS1,5,2,315,322,3
RALGAPB,6,3,313,322,3
OGFRL1,6,3,313,322,3
COQ8B,9,6,307,322,3
SMIM23,5,2,315,322,3
RAB40A,10,7,305,322,3
OBP2B,9,6,307,322,3
SMIM29,12,9,301,322,3
SYN3,7,4,311,322,3
BTD,7,4,311,322,3
CDC123,9,6,307,322,3
TREH,10,7,305,322,3
SNRPD3,6,3,313,322,3
UMAD1,9,6,307,322,3
RALA,5,2,315,322,3
SYPL1,7,4,311,322,3
TRAV7,3,0,319,322,3
OCA2,5,2,315,322,3
TRAV8-1,7,4,311,322,3
TPRG1L,6,3,313,322,3
UQCRFS1,6,3,313,322,3
OR2J2,5,2,315,322,3
C11orf80,7,4,311,322,3
CD207,3,0,319,322,3
OSTF1,7,4,311,322,3
SLC35A3,5,2,315,322,3
C17orf50,13,10,299,322,3
C17orf49,11,8,303,322,3
BPI,5,2,315,322,3
SLC35E1,7,4,311,322,3
OSBPL5,11,8,303,322,3
CDCA7L,11,8,303,322,3
ABCA13,4,1,317,322,3
ZNF800,10,7,305,322,3
SV2C,3,0,319,322,3
SLC37A1,9,6,307,322,3
ORMDL2,8,5,309,322,3
ZNF813,9,6,307,322,3
TOLLIP,11,8,303,322,3
ORAI3,9,6,307,322,3
COLEC12,5,2,315,322,3
PXMP4,5,2,315,322,3
OR8H2,3,0,319,322,3
TOMM34,7,4,311,322,3
SLC38A1,4,1,317,322,3
UGT1A1,4,1,317,322,3
OR8H1,3,0,319,322,3
SLC38A9,9,6,307,322,3
SLC39A1,8,5,309,322,3
SLC39A3,10,7,305,322,3
C17orf75,6,3,313,322,3
ATP8B4,14,11,297,322,3
SLC33A1,7,4,311,322,3
TNIP3,4,1,317,322,3
ZBTB8B,5,2,315,322,3
ZBTB7C,28,25,269,322,3
SLC25A4,7,4,311,322,3
PTPRT,3,0,319,322,3
ZNF782,4,1,317,322,3
SP140,10,7,305,322,3
BORCS5,6,3,313,322,3
COL19A1,9,6,307,322,3
ALB,8,5,309,322,3
TNIP2,9,6,307,322,3
C19orf33,28,25,269,322,3
SLC26A6,7,4,311,322,3
SLC26A8,5,2,315,322,3
PUS7L,5,2,315,322,3
PTTG1,9,6,307,322,3
RASSF2,10,7,305,322,3
CD1E,4,1,317,322,3
OVCA2,15,12,295,322,3
OTX1,13,10,299,322,3
OTULINL,3,0,319,322,3
COL4A2,13,10,299,322,3
ZBTB46,8,5,309,322,3
SLC2A3,7,4,311,322,3
C18orf21,11,8,303,322,3
SEZ6L2,9,6,307,322,3
SLC30A8,4,1,317,322,3
USH1C,3,0,319,322,3
ANXA13,8,5,309,322,3
OR7E24,14,11,297,322,3
TUBB2B,13,10,299,322,3
PYROXD1,6,3,313,322,3
TPBG,7,4,311,322,3
ATRIP,6,3,313,322,3
AARS2,7,4,311,322,3
SLC7A5,5,2,315,322,3
SLC7A6,8,5,309,322,3
TUBB2A,12,9,301,322,3
XRN1,5,2,315,322,3
XRN2,6,3,313,322,3
URGCP,11,8,303,322,3
OR4K5,4,1,317,322,3
SLC9A3R1,7,4,311,322,3
SLC9A7,4,1,317,322,3
PYHIN1,6,3,313,322,3
TPMT,5,2,315,322,3
ANAPC7,6,3,313,322,3
ADAMTS18,5,2,315,322,3
ANXA2R,9,6,307,322,3
SLC9A8,6,3,313,322,3
BPNT2,6,3,313,322,3
OR2Y1,4,1,317,322,3
SLC9C1,3,0,319,322,3
OR2T12,6,3,313,322,3
ANXA7,7,4,311,322,3
CD28,5,2,315,322,3
TPPP,7,4,311,322,3
RARB,5,2,315,322,3
ZNF850,6,3,313,322,3
SLC39A8,4,1,317,322,3
SVEP1,3,0,319,322,3
OR6P1,3,0,319,322,3
AKAP5,4,1,317,322,3
COLQ,6,3,313,322,3
XPR1,7,4,311,322,3
BPIFB1,6,3,313,322,3
PYCR1,9,6,307,322,3
C15orf39,13,10,299,322,3
SLC49A4,6,3,313,322,3
SLC4A10,5,2,315,322,3
SLC4A11,16,13,293,322,3
TOP3A,8,5,309,322,3
TOPORS,6,3,313,322,3
OR5H15,3,0,319,322,3
OR52N1,5,2,315,322,3
OR5BS1P,4,1,317,322,3
RARS2,7,4,311,322,3
TRIM37,7,4,311,322,3
RARG,8,5,309,322,3
SLC5A6,8,5,309,322,3
OR5AU1,4,1,317,322,3
SOHLH2,10,7,305,322,3
TP53I11,15,12,295,322,3
PYGO1,4,1,317,322,3
UGT2B15,5,2,315,322,3
OR5AR1,3,0,319,322,3
TP53TG3E,5,2,315,322,3
C5orf15,6,3,313,322,3
REG4,4,1,317,322,3
ZCCHC9,5,2,315,322,3
PROZ,9,6,307,322,3
ST3GAL4,8,5,309,322,3
TSPAN32,12,9,301,322,3
CASP8AP2,6,3,313,322,3
RTKN2,6,3,313,322,3
ZNF331,5,2,315,322,3
TSPAN16,10,7,305,322,3
RNF138,9,6,307,322,3
ZKSCAN1,7,4,311,322,3
PNMA5,4,1,317,322,3
RNF126,8,5,309,322,3
CCDC66,7,4,311,322,3
TCEANC2,6,3,313,322,3
TCEANC,6,3,313,322,3
STRN4,8,5,309,322,3
THEM4,6,3,313,322,3
ST20,11,8,303,322,3
CHN2,18,15,289,322,3
TCEAL1,6,3,313,322,3
CHODL,5,2,315,322,3
RTP5,3,0,319,322,3
SSX7,6,3,313,322,3
THG1L,5,2,315,322,3
SSX2B,11,8,303,322,3
ZIC1,9,6,307,322,3
TSPAN14,8,5,309,322,3
RUFY2,7,4,311,322,3
UBA6,6,3,313,322,3
TCF25,6,3,313,322,3
BAD,15,12,295,322,3
BCCIP,7,4,311,322,3
ST7L,5,2,315,322,3
RRAGB,8,5,309,322,3
POLQ,3,0,319,322,3
ZMAT1,6,3,313,322,3
RNF165,6,3,313,322,3
RRBP1,8,5,309,322,3
TTC27,7,4,311,322,3
POLE3,4,1,317,322,3
TSPAN33,4,1,317,322,3
CHERP,9,6,307,322,3
TGIF2LX,6,3,313,322,3
RRM1,8,5,309,322,3
TCIM,14,11,297,322,3
TRBV7-6,9,6,307,322,3
ZNF329,4,1,317,322,3
POLD1,6,3,313,322,3
ASCL2,6,3,313,322,3
WFDC5,8,5,309,322,3
CAV3,13,10,299,322,3
POGLUT3,4,1,317,322,3
POFUT2,7,4,311,322,3
TCF7,12,9,301,322,3
RNF146,13,10,299,322,3
ACER3,4,1,317,322,3
RNF144B,4,1,317,322,3
CATIP,7,4,311,322,3
CASZ1,6,3,313,322,3
TBX6,8,5,309,322,3
THOP1,11,8,303,322,3
CHPF2,10,7,305,322,3
BCL2L13,6,3,313,322,3
RMND5B,8,5,309,322,3
CENPO,5,2,315,322,3
ZNF385A,6,3,313,322,3
CCDC82,4,1,317,322,3
TIMM50,7,4,311,322,3
WIZ,9,6,307,322,3
TIMM8A,8,5,309,322,3
PLEKHG1,8,5,309,322,3
ZNF385B,15,12,295,322,3
TIMM8B,10,7,305,322,3
S100A8,11,8,303,322,3
TSHZ3,13,10,299,322,3
VTA1,8,5,309,322,3
TIMM17A,6,3,313,322,3
SSBP2,7,4,311,322,3
SSBP1,6,3,313,322,3
PROKR2,4,1,317,322,3
TIMM9,9,6,307,322,3
PLEKHA1,6,3,313,322,3
RMDN3,8,5,309,322,3
RLN3,14,11,297,322,3
VSIG10L,5,2,315,322,3
RLIM,8,5,309,322,3
ARSD,6,3,313,322,3
CAPN6,3,0,319,322,3
ANKRD36B,7,4,311,322,3
S100A6,6,3,313,322,3
RNASEH2C,7,4,311,322,3
ZNF33A,5,2,315,322,3
RUSC1,7,4,311,322,3
STT3A,6,3,313,322,3
TBX4,7,4,311,322,3
PM20D1,7,4,311,322,3
ZNF34,6,3,313,322,3
CHRM1,15,12,295,322,3
CHRM4,15,12,295,322,3
ADGRF4,9,6,307,322,3
ZNF35,7,4,311,322,3
CHRM5,7,4,311,322,3
PLSCR3,8,5,309,322,3
THY1,6,3,313,322,3
CCDC69,11,8,303,322,3
CARS2,10,7,305,322,3
RXRG,3,0,319,322,3
RWDD2B,5,2,315,322,3
ARV1,7,4,311,322,3
TICRR,7,4,311,322,3
WIPF3,6,3,313,322,3
TIE1,5,2,315,322,3
PLPP5,6,3,313,322,3
CEP112,8,5,309,322,3
ZG16B,18,15,289,322,3
CENPW,9,6,307,322,3
PLP1,12,9,301,322,3
ACBD4,6,3,313,322,3
PRKRA,7,4,311,322,3
RNF166,14,11,297,322,3
ANKRD27,8,5,309,322,3
POLR2D,3,0,319,322,3
BBOX1,5,2,315,322,3
ADH6,8,5,309,322,3
PPP1R13B,10,7,305,322,3
RPL36AL,8,5,309,322,3
PPP1R12B,14,11,297,322,3
RPL37A,9,6,307,322,3
TEDC2,14,11,297,322,3
RO60,7,4,311,322,3
BAZ2B,10,7,305,322,3
ATAD2,7,4,311,322,3
CFAP77,9,6,307,322,3
STEAP1,10,7,305,322,3
CFAP92,5,2,315,322,3
PPM1L,7,4,311,322,3
WDR5,6,3,313,322,3
WDR41,8,5,309,322,3
PPM1H,6,3,313,322,3
ADI1,5,2,315,322,3
UBE2G2,7,4,311,322,3
CCDC116,12,9,301,322,3
ZNF2,5,2,315,322,3
PPM1A,9,6,307,322,3
PPIL2,8,5,309,322,3
CEP78,6,3,313,322,3
TTC14,6,3,313,322,3
ZNF200,5,2,315,322,3
RNGTT,5,2,315,322,3
PPP1R14C,8,5,309,322,3
BATF3,13,10,299,322,3
TEC,8,5,309,322,3
CCDC150,5,2,315,322,3
CEPT1,7,4,311,322,3
RPE,7,4,311,322,3
RP2,5,2,315,322,3
RPF2,6,3,313,322,3
STK39,6,3,313,322,3
CCDC181,6,3,313,322,3
TENT2,6,3,313,322,3
CCDC172,3,0,319,322,3
RPIA,5,2,315,322,3
RPL14,11,8,303,322,3
STK38L,8,5,309,322,3
CCDC152,6,3,313,322,3
RPL26,11,8,303,322,3
STK17A,7,4,311,322,3
PPP2R1B,5,2,315,322,3
ROGDI,10,7,305,322,3
BAP1,10,7,305,322,3
PPTC7,6,3,313,322,3
WDR62,8,5,309,322,3
ZNF157,7,4,311,322,3
PPY,28,25,269,322,3
CCDC144A,5,2,315,322,3
PPP1R21,7,4,311,322,3
PPP1R2,11,8,303,322,3
ROBO3,10,7,305,322,3
BASP1,10,7,305,322,3
ADIPOQ,4,1,317,322,3
STARD9,6,3,313,322,3
ZNF282,8,5,309,322,3
ZNF273,5,2,315,322,3
WDFY2,4,1,317,322,3
ALS2CL,4,1,317,322,3
ANKRD18A,4,1,317,322,3
TSR2,5,2,315,322,3
STOML3,6,3,313,322,3
ASPH,9,6,307,322,3
RPS6KA2,12,9,301,322,3
TSPYL1,4,1,317,322,3
CHD1L,4,1,317,322,3
ANKRD20A4P,19,16,287,322,3
ACRV1,13,10,299,322,3
CCDC32,5,2,315,322,3
STRA6,8,5,309,322,3
POTEE,6,3,313,322,3
POLRMT,9,6,307,322,3
RPS6KB2,7,4,311,322,3
STRA8,7,4,311,322,3
WFDC3,26,23,273,322,3
POLR3D,9,6,307,322,3
TTC25,18,15,289,322,3
ZNF277,7,4,311,322,3
ZNF28,6,3,313,322,3
ASL,9,6,307,322,3
TTC26,5,2,315,322,3
RNF17,5,2,315,322,3
ALKBH6,10,7,305,322,3
RNF222,5,2,315,322,3
CCDC22,11,8,303,322,3
ZNF202,9,6,307,322,3
RNF39,10,7,305,322,3
STN1,8,5,309,322,3
PPIAL4C,29,26,267,322,3
RNFT1,7,4,311,322,3
ACOT6,12,9,301,322,3
CFTR,4,1,317,322,3
STARD10,7,4,311,322,3
PPDPF,10,7,305,322,3
ZNF212,11,8,303,322,3
CCDC191,14,11,297,322,3
RPS19BP1,9,6,307,322,3
PPARG,11,8,303,322,3
TEAD2,9,6,307,322,3
WDR24,12,9,301,322,3
CBWD1,8,5,309,322,3
RNF32,15,12,295,322,3
POU5F2,3,0,319,322,3
BCAM,9,6,307,322,3
ACP3,6,3,313,322,3
ZNF224,8,5,309,322,3
PRDM12,6,3,313,322,3
CGRRF1,8,5,309,322,3
PRDM15,4,1,317,322,3
ZNF236,7,4,311,322,3
ADGRL3,5,2,315,322,3
CCDC201,4,1,317,322,3
CHAD,9,6,307,322,3
CCDC83,6,3,313,322,3
ACAP2,10,7,305,322,3
PDE7A,5,2,315,322,3
ACSS1,6,3,313,322,3
PHACTR3,5,2,315,322,3
ZDHHC24,4,1,317,322,3
AHI1,4,1,317,322,3
PSMC3,9,6,307,322,3
PGPEP1,10,7,305,322,3
ABCG4,6,3,313,322,3
SEMA3D,3,0,319,322,3
RFC4,6,3,313,322,3
SEMA3G,10,7,305,322,3
SULT1C4,8,5,309,322,3
CA13,3,0,319,322,3
CA11,10,7,305,322,3
TMEM191B,22,19,281,322,3
REXO5,10,7,305,322,3
ZNF585B,15,12,295,322,3
TXNDC17,9,6,307,322,3
ARHGEF4,14,11,297,322,3
ARHGEF38,6,3,313,322,3
PGBD2,5,2,315,322,3
PGBD1,4,1,317,322,3
CLEC2D,6,3,313,322,3
TMEM212,7,4,311,322,3
VAMP3,7,4,311,322,3
TTC9,3,0,319,322,3
ZNF589,10,7,305,322,3
CLEC2L,8,5,309,322,3
TMEM213,10,7,305,322,3
ANKS3,9,6,307,322,3
VAX1,3,0,319,322,3
TMEM176A,6,3,313,322,3
ZNF566,8,5,309,322,3
SPRYD4,3,0,319,322,3
ARL10,13,10,299,322,3
TMEM160,17,14,291,322,3
SPRY4,18,15,289,322,3
CDYL2,6,3,313,322,3
WNT9B,6,3,313,322,3
ZNF556,5,2,315,322,3
TMEM161B,5,2,315,322,3
ARID5B,5,2,315,322,3
SPRR4,4,1,317,322,3
TMEM167B,8,5,309,322,3
CABP4,5,2,315,322,3
TMEM169,6,3,313,322,3
ZDHHC7,6,3,313,322,3
AMIGO2,4,1,317,322,3
SEH1L,6,3,313,322,3
TMEM171,15,12,295,322,3
CLDN4,3,0,319,322,3
ZEB2,9,6,307,322,3
ZNF576,5,2,315,322,3
RFXANK,14,11,297,322,3
PHF1,14,11,297,322,3
PHEX,4,1,317,322,3
PHETA1,9,6,307,322,3
ADGRD2,3,0,319,322,3
RFX6,3,0,319,322,3
ZNF597,7,4,311,322,3
PFDN5,13,10,299,322,3
REPS1,8,5,309,322,3
SETD1A,12,9,301,322,3
TRMT1L,5,2,315,322,3
PSMG4,8,5,309,322,3
ZNF619,5,2,315,322,3
PDZD8,4,1,317,322,3
SERPINI1,13,10,299,322,3
ARHGAP44,7,4,311,322,3
RECQL5,10,7,305,322,3
PDS5B,9,6,307,322,3
TRMT13,5,2,315,322,3
TMEM251,5,2,315,322,3
TTLL1,11,8,303,322,3
ABCE1,7,4,311,322,3
ARHGAP42,5,2,315,322,3
SPINK14,7,4,311,322,3
C5orf58,12,9,301,322,3
TMEM255B,9,6,307,322,3
RDH10,5,2,315,322,3
ADA2,11,8,303,322,3
PDK2,11,8,303,322,3
CLTB,7,4,311,322,3
AIFM2,6,3,313,322,3
CCNK,6,3,313,322,3
PDGFC,6,3,313,322,3
PDGFA,7,4,311,322,3
PDE9A,10,7,305,322,3
CDKAL1,5,2,315,322,3
SPIN4,6,3,313,322,3
ADGRA3,9,6,307,322,3
SENP3,11,8,303,322,3
REG3G,6,3,313,322,3
ARHGEF25,11,8,303,322,3
ANKUB1,4,1,317,322,3
PF4V1,8,5,309,322,3
CDNF,9,6,307,322,3
TAS2R42,9,6,307,322,3
PEX12,11,8,303,322,3
TMEM236,4,1,317,322,3
SEPTIN6,6,3,313,322,3
BID,7,4,311,322,3
RELCH,7,4,311,322,3
PER1,11,8,303,322,3
RPA2,8,5,309,322,3
TRMT61A,5,2,315,322,3
TMEM247,4,1,317,322,3
TMEM241,4,1,317,322,3
ABCF2,5,2,315,322,3
UVSSA,8,5,309,322,3
REEP6,12,9,301,322,3
ZNF613,11,8,303,322,3
SERPINA10,4,1,317,322,3
WWP2,6,3,313,322,3
SERPINB7,6,3,313,322,3
PEAK1,6,3,313,322,3
SERPINB9,4,1,317,322,3
ZNF615,9,6,307,322,3
CLN5,7,4,311,322,3
PSG3,4,1,317,322,3
PHLDA1,9,6,307,322,3
ZNF543,6,3,313,322,3
CELF3,8,5,309,322,3
CIRBP,10,7,305,322,3
PKDREJ,3,0,319,322,3
ZNF429,5,2,315,322,3
PRR23A,4,1,317,322,3
SBSPON,5,2,315,322,3
PIWIL1,5,2,315,322,3
RHOH,6,3,313,322,3
BCO1,9,6,307,322,3
ALG12,7,4,311,322,3
AGAP3,10,7,305,322,3
ACAD11,6,3,313,322,3
ANKRD53,11,8,303,322,3
VPS37A,8,5,309,322,3
ZFP14,5,2,315,322,3
ARNT,8,5,309,322,3
PRR7,17,14,291,322,3
STYX,5,2,315,322,3
CAMK2A,4,1,317,322,3
PRR9,4,1,317,322,3
ZFP1,7,4,311,322,3
CKMT1A,21,18,283,322,3
SCD5,6,3,313,322,3
SCG3,6,3,313,322,3
UBR3,6,3,313,322,3
CEBPZ,8,5,309,322,3
ZNF470,6,3,313,322,3
SBK2,8,5,309,322,3
ZNF428,9,6,307,322,3
TMED4,5,2,315,322,3
TLE7,3,0,319,322,3
UBA5,8,5,309,322,3
AFG3L2,6,3,313,322,3
STX1B,7,4,311,322,3
TLCD4,5,2,315,322,3
STX2,5,2,315,322,3
ALG2,6,3,313,322,3
UBIAD1,6,3,313,322,3
ZFP92,3,0,319,322,3
VRK1,5,2,315,322,3
SARDH,6,3,313,322,3
TLE6,21,18,283,322,3
ALG1L2,19,16,287,322,3
PLA2G2D,5,2,315,322,3
ARPC5L,5,2,315,322,3
PLA2G1B,28,25,269,322,3
STX4,10,7,305,322,3
CILK1,5,2,315,322,3
AMBP,7,4,311,322,3
ZFP57,5,2,315,322,3
ATP1A3,15,12,295,322,3
ZNF426,4,1,317,322,3
ZFP37,6,3,313,322,3
ACTL8,5,2,315,322,3
SBDS,6,3,313,322,3
TLR8,4,1,317,322,3
CIPC,6,3,313,322,3
VPREB1,5,2,315,322,3
BEND2,3,0,319,322,3
TRPC5OS,5,2,315,322,3
AMER2,3,0,319,322,3
VEZT,8,5,309,322,3
TMEM117,5,2,315,322,3
SRARP,5,2,315,322,3
ARL5C,25,22,275,322,3
BEND7,3,0,319,322,3
WNT8A,6,3,313,322,3
AGRN,7,4,311,322,3
ALDH6A1,6,3,313,322,3
TMEM126A,10,7,305,322,3
ACTRT2,4,1,317,322,3
SDE2,4,1,317,322,3
PSD,9,6,307,322,3
PHLPP2,4,1,317,322,3
SRBD1,5,2,315,322,3
SDHA,8,5,309,322,3
CACNB3,12,9,301,322,3
BEX5,13,10,299,322,3
PHLDB3,7,4,311,322,3
PSG1,11,8,303,322,3
ARL16,7,4,311,322,3
SDS,18,15,289,322,3
CACNA2D1,7,4,311,322,3
AGRP,25,22,275,322,3
SEC22A,10,7,305,322,3
TMEM151A,10,7,305,322,3
ABHD15,6,3,313,322,3
SCYL2,6,3,313,322,3
AGPAT4,11,8,303,322,3
SUFU,11,8,303,322,3
SCPEP1,8,5,309,322,3
PRSS1,7,4,311,322,3
RHBDL2,10,7,305,322,3
SCN1A,6,3,313,322,3
SCN2B,5,2,315,322,3
VN1R2,9,6,307,322,3
SCN3B,3,0,319,322,3
TTC5,6,3,313,322,3
SRF,5,2,315,322,3
TMED8,3,0,319,322,3
PRSS38,3,0,319,322,3
TMEM106A,5,2,315,322,3
ZNF488,6,3,313,322,3
PIGM,5,2,315,322,3
CACNG6,6,3,313,322,3
VKORC1L1,4,1,317,322,3
PIGH,10,7,305,322,3
WNT7B,5,2,315,322,3
ZNF502,9,6,307,322,3
TMEM109,6,3,313,322,3
SCRN3,8,5,309,322,3
AGMO,6,3,313,322,3
CADM2,4,1,317,322,3
SCX,20,17,285,322,3
AGO3,5,2,315,322,3
BEND6,8,5,309,322,3
UBR5,5,2,315,322,3
CD59,10,7,305,322,3
POLR2H,9,6,307,322,3
A1BG,6,3,313,322,3
MZT2A,7,4,311,322,3
ESYT1,9,6,307,322,3
ESR2,5,2,315,322,3
HSPB2-C11orf52,26,23,273,322,3
NACAD,6,3,313,322,3
CXCL14,7,4,311,322,3
HTATIP2,10,7,305,322,3
CXCL16,5,2,315,322,3
NABP1,6,3,313,322,3
ERO1A,5,2,315,322,3
HTR3B,5,2,315,322,3
ERN1,4,1,317,322,3
NAA20,9,6,307,322,3
HUS1,6,3,313,322,3
IFNA10,3,0,319,322,3
IARS2,7,4,311,322,3
ERGIC2,11,8,303,322,3
ICAM5,9,6,307,322,3
ERCC8,7,4,311,322,3
ERCC6,9,6,307,322,3
ERCC4,8,5,309,322,3
IDO1,9,6,307,322,3
CXorf51A,9,6,307,322,3
MYOM1,4,1,317,322,3
ERC2,4,1,317,322,3
ERC1,7,4,311,322,3
ERBB2,7,4,311,322,3
HSH2D,17,14,291,322,3
HSFX3,10,7,305,322,3
ESYT2,4,1,317,322,3
NANOS1,10,7,305,322,3
HOMER1,6,3,313,322,3
EXOC1L,8,5,309,322,3
NDUFA6,9,6,307,322,3
EXO5,4,1,317,322,3
CTDSPL2,7,4,311,322,3
HOXA6,15,12,295,322,3
HOXB4,6,3,313,322,3
EXD1,7,4,311,322,3
NCR3LG1,4,1,317,322,3
NCOA7,7,4,311,322,3
NCKAP1L,3,0,319,322,3
HPCAL4,4,1,317,322,3
CTSK,4,1,317,322,3
CTSW,13,10,299,322,3
CTSZ,5,2,315,322,3
ETV5,12,9,301,322,3
ETV1,13,10,299,322,3
HS6ST2,6,3,313,322,3
HS6ST3,3,0,319,322,3
NBEAL1,5,2,315,322,3
NAV2,16,13,293,322,3
NAV1,11,8,303,322,3
ETHE1,11,8,303,322,3
ETFBKMT,5,2,315,322,3
ETDC,10,7,305,322,3
ERAP2,7,4,311,322,3
IFNA17,3,0,319,322,3
NDUFB4,10,7,305,322,3
IL25,4,1,317,322,3
CYP3A7-CYP3A51P,13,10,299,322,3
MTHFD2,7,4,311,322,3
MTG1,6,3,313,322,3
IGSF8,12,9,301,322,3
ENTPD7,5,2,315,322,3
IKZF3,5,2,315,322,3
IL10RA,7,4,311,322,3
ENSA,6,3,313,322,3
ENPP4,6,3,313,322,3
IL18RAP,3,0,319,322,3
IL2,4,1,317,322,3
CYP4F22,3,0,319,322,3
CYREN,9,6,307,322,3
IFNA8,3,0,319,322,3
MT1A,34,31,257,322,3
IL4R,16,13,293,322,3
MSRB2,7,4,311,322,3
EMG1,5,2,315,322,3
EME2,4,1,317,322,3
INAVA,5,2,315,322,3
INHA,11,8,303,322,3
MSLNL,3,0,319,322,3
ELP5,10,7,305,322,3
MSH2,6,3,313,322,3
INTS14,6,3,313,322,3
DACT2,5,2,315,322,3
MTMR12,8,5,309,322,3
IGLV4-69,4,1,317,322,3
MTMR7,12,9,301,322,3
EPAS1,5,2,315,322,3
IFNL2,6,3,313,322,3
EPRS1,6,3,313,322,3
MYMX,18,15,289,322,3
CYB561D2,11,8,303,322,3
IGFBP5,8,5,309,322,3
IGFBP7,12,9,301,322,3
IGHA1,6,3,313,322,3
EPHB4,7,4,311,322,3
MYH7,3,0,319,322,3
MAML2,5,2,315,322,3
IGHV1-69-2,14,11,297,322,3
MYEF2,11,8,303,322,3
MXRA7,5,2,315,322,3
IGHV3-7,13,10,299,322,3
IGHV4-31,7,4,311,322,3
MVB12A,14,11,297,322,3
IGHV4-59,8,5,309,322,3
IGHV4OR15-8,5,2,315,322,3
IGKV1-39,10,7,305,322,3
IGKV2D-28,9,6,307,322,3
MTX1,11,8,303,322,3
CYP27C1,3,0,319,322,3
IGLC2,12,9,301,322,3
IGLL5,6,3,313,322,3
EPB41,4,1,317,322,3
NDUFAF6,9,6,307,322,3
HNRNPA1L2,9,6,307,322,3
INTS9,7,4,311,322,3
NME7,7,4,311,322,3
NOD2,6,3,313,322,3
CRTAC1,9,6,307,322,3
GRP,17,14,291,322,3
GRPEL1,6,3,313,322,3
FAM240B,12,9,301,322,3
NOB1,11,8,303,322,3
NMS,6,3,313,322,3
CRX,5,2,315,322,3
NMNAT1,6,3,313,322,3
GSTM1,39,36,247,322,3
FAM234B,6,3,313,322,3
GTF2E1,3,0,319,322,3
FAM217A,9,6,307,322,3
CSAG3,17,14,291,322,3
CRYBG1,3,0,319,322,3
NMD3,6,3,313,322,3
CRYBG3,4,1,317,322,3
CRYGA,9,6,307,322,3
GTPBP6,10,7,305,322,3
GUCY2F,3,0,319,322,3
GVQW3,5,2,315,322,3
FAM204A,7,4,311,322,3
FAM186A,6,3,313,322,3
FAM185A,9,6,307,322,3
H2AJ,10,7,305,322,3
FAM174B,21,18,283,322,3
NOL6,7,4,311,322,3
NOL9,4,1,317,322,3
GRIK4,4,1,317,322,3
GRID2,6,3,313,322,3
FANCI,7,4,311,322,3
GPC6,6,3,313,322,3
FANCC,8,5,309,322,3
FANCB,6,3,313,322,3
GPLD1,4,1,317,322,3
GPR101,3,0,319,322,3
FAM98B,8,5,309,322,3
CRIM1,10,7,305,322,3
GPR157,16,13,293,322,3
NPFFR1,4,1,317,322,3
CRIPT,4,1,317,322,3
CRISP1,3,0,319,322,3
GPR37,4,1,317,322,3
CRISPLD2,10,7,305,322,3
NPAP1,4,1,317,322,3
NOXO1,22,19,281,322,3
NOTO,3,0,319,322,3
GPSM1,7,4,311,322,3
FAM76A,9,6,307,322,3
FAM72B,17,14,291,322,3
GRAMD1A,11,8,303,322,3
GREB1,8,5,309,322,3
CROCC,9,6,307,322,3
NOS1,3,0,319,322,3
NOP56,7,4,311,322,3
NKX2-2,3,0,319,322,3
NKAIN2,7,4,311,322,3
HNF1A,8,5,309,322,3
F8A3,16,13,293,322,3
FAM102A,8,5,309,322,3
CST4,5,2,315,322,3
HERPUD2,7,4,311,322,3
HES2,7,4,311,322,3
HES4,21,18,283,322,3
HEXB,10,7,305,322,3
FABP6,24,21,277,322,3
HHIP,4,1,317,322,3
FABP12,15,12,295,322,3
HIBADH,5,2,315,322,3
FAAP100,12,9,301,322,3
FAAH2,6,3,313,322,3
NETO2,7,4,311,322,3
NIT2,5,2,315,322,3
CST9L,5,2,315,322,3
F7,6,3,313,322,3
F2RL3,4,1,317,322,3
NEK7,5,2,315,322,3
F2R,5,2,315,322,3
NEIL2,10,7,305,322,3
F10,7,4,311,322,3
HLCS,5,2,315,322,3
CT47A12,10,7,305,322,3
NEDD4,6,3,313,322,3
NEDD1,5,2,315,322,3
HMOX2,6,3,313,322,3
CST11,7,4,311,322,3
HEPACAM2,4,1,317,322,3
NF2,6,3,313,322,3
FAM104A,6,3,313,322,3
FAM155B,6,3,313,322,3
HABP4,6,3,313,322,3
FAM13C,13,10,299,322,3
FAM136A,7,4,311,322,3
NIPAL2,3,0,319,322,3
NIPAL1,3,0,319,322,3
NINL,7,4,311,322,3
NIN,9,6,307,322,3
NICN1,8,5,309,322,3
NIBAN3,4,1,317,322,3
NIBAN2,8,5,309,322,3
HCAR3,7,4,311,322,3
NHSL1,10,7,305,322,3
HCCS,6,3,313,322,3
CSMD1,4,1,317,322,3
FAM111B,7,4,311,322,3
HDGFL1,3,0,319,322,3
HEATR5A,7,4,311,322,3
NFYA,6,3,313,322,3
HEATR9,9,6,307,322,3
HECTD2,9,6,307,322,3
NFKBID,8,5,309,322,3
HECW2,3,0,319,322,3
HELLS,7,4,311,322,3
HELQ,9,6,307,322,3
ELOVL7,4,1,317,322,3
ELOVL6,7,4,311,322,3
GORAB,5,2,315,322,3
MCAM,9,6,307,322,3
LCORL,7,4,311,322,3
LDB2,6,3,313,322,3
DPP8,5,2,315,322,3
DENND4A,6,3,313,322,3
MCMDC2,7,4,311,322,3
MCM5,11,8,303,322,3
LEKR1,13,10,299,322,3
DENR,5,2,315,322,3
LENG1,10,7,305,322,3
DEPDC1B,6,3,313,322,3
DEPDC5,10,7,305,322,3
DPF1,8,5,309,322,3
LHFPL4,8,5,309,322,3
MAS1L,4,1,317,322,3
LHFPL6,5,2,315,322,3
MBTPS2,7,4,311,322,3
LILRA2,4,1,317,322,3
LILRB4,4,1,317,322,3
LIN7A,10,7,305,322,3
DFFB,6,3,313,322,3
LIN9,6,3,313,322,3
LINGO4,4,1,317,322,3
MBD1,11,8,303,322,3
DGCR6,11,8,303,322,3
DOC2B,4,1,317,322,3
LMBR1,6,3,313,322,3
MCTS1,5,2,315,322,3
LCE4A,3,0,319,322,3
LCE1F,6,3,313,322,3
MDGA2,4,1,317,322,3
KRTAP4-16,8,5,309,322,3
MESP2,13,10,299,322,3
MESP1,5,2,315,322,3
KRTAP4-6,3,0,319,322,3
DEFB107A,3,0,319,322,3
DTWD2,5,2,315,322,3
KRTAP9-2,3,0,319,322,3
DTWD1,6,3,313,322,3
L2HGDH,5,2,315,322,3
DTD1,6,3,313,322,3
MEF2D,10,7,305,322,3
DEFB124,9,6,307,322,3
MED27,5,2,315,322,3
DEFB128,4,1,317,322,3
DRG1,9,6,307,322,3
LARS1,5,2,315,322,3
LARS2,8,5,309,322,3
LAS1L,6,3,313,322,3
DEFB135,7,4,311,322,3
MEAK7,12,9,301,322,3
DEFB4B,4,1,317,322,3
LBHD1,6,3,313,322,3
LBP,8,5,309,322,3
MDH1B,13,10,299,322,3
LCE1D,4,1,317,322,3
LMCD1,5,2,315,322,3
LMO1,11,8,303,322,3
DEFB104B,3,0,319,322,3
LYZL2,6,3,313,322,3
LSM14A,7,4,311,322,3
LSM5,10,7,305,322,3
MAP7,4,1,317,322,3
DMXL2,6,3,313,322,3
DMTF1,7,4,311,322,3
LTO1,7,4,311,322,3
LXN,17,14,291,322,3
MAP3K3,5,2,315,322,3
LYAR,7,4,311,322,3
DMAC2,11,8,303,322,3
MAP3K13,5,2,315,322,3
LYZL1,4,1,317,322,3
LZTS2,10,7,305,322,3
MAS1,5,2,315,322,3
LZTS3,4,1,317,322,3
M1AP,4,1,317,322,3
MACO1,4,1,317,322,3
DLEU7,6,3,313,322,3
MAD1L1,16,13,293,322,3
DLD,9,6,307,322,3
DKK3,9,6,307,322,3
MANBAL,7,4,311,322,3
MAGEA8,5,2,315,322,3
MAGEA9B,12,9,301,322,3
DIO3,5,2,315,322,3
MAN1A2,5,2,315,322,3
LSM10,10,7,305,322,3
MAPK15,7,4,311,322,3
LRRTM1,5,2,315,322,3
DNAI1,15,12,295,322,3
LPAR4,15,12,295,322,3
LPGAT1,4,1,317,322,3
DGKI,3,0,319,322,3
LRATD2,7,4,311,322,3
LRBA,6,3,313,322,3
LRCH2,6,3,313,322,3
MARK1,7,4,311,322,3
LRCH3,7,4,311,322,3
DNAJC6,5,2,315,322,3
LRG1,7,4,311,322,3
LRGUK,3,0,319,322,3
LRIG3,13,10,299,322,3
LRIT2,4,1,317,322,3
LRMDA,7,4,311,322,3
MARCHF8,8,5,309,322,3
MARCHF4,3,0,319,322,3
LRP6,8,5,309,322,3
LRRC10B,9,6,307,322,3
LRRC25,8,5,309,322,3
LRRC31,6,3,313,322,3
LRRC37A,9,6,307,322,3
DNAJC12,13,10,299,322,3
LRRC49,9,6,307,322,3
LRRC58,4,1,317,322,3
LRRFIP1,4,1,317,322,3
DEFB105B,5,2,315,322,3
KRTAP21-2,9,6,307,322,3
ELOVL2,6,3,313,322,3
KCP,6,3,313,322,3
JUP,13,10,299,322,3
KAAG1,3,0,319,322,3
KALRN,8,5,309,322,3
KATNAL2,11,8,303,322,3
EHD3,3,0,319,322,3
EGF,4,1,317,322,3
EFS,6,3,313,322,3
DCAF17,5,2,315,322,3
KCNJ3,4,1,317,322,3
MPP6,8,5,309,322,3
KCNK10,3,0,319,322,3
KCNK13,5,2,315,322,3
EFCAB11,4,1,317,322,3
KIF3B,6,3,313,322,3
EEF1B2,11,8,303,322,3
EEF1AKNMT,6,3,313,322,3
KDELR2,6,3,313,322,3
MOSPD3,13,10,299,322,3
EEA1,5,2,315,322,3
KDM4E,3,0,319,322,3
KDM6A,5,2,315,322,3
DCN,16,13,293,322,3
KIAA1614,8,5,309,322,3
KIAA1841,5,2,315,322,3
KIF18A,6,3,313,322,3
KIF25,6,3,313,322,3
JAM2,8,5,309,322,3
MRPL17,7,4,311,322,3
EIF2S3B,10,7,305,322,3
JADE2,8,5,309,322,3
MS4A2,6,3,313,322,3
IPO4,11,8,303,322,3
MRRF,4,1,317,322,3
IQGAP3,4,1,317,322,3
MRPS28,12,9,301,322,3
ELL2,7,4,311,322,3
ELFN2,4,1,317,322,3
IRF4,4,1,317,322,3
IRS4,7,4,311,322,3
ISG20L2,4,1,317,322,3
ISL2,12,9,301,322,3
ELAC2,9,6,307,322,3
ISY1,5,2,315,322,3
ITGA1,5,2,315,322,3
MRPS15,9,6,307,322,3
ITGA3,13,10,299,322,3
MRPS10,6,3,313,322,3
ITGAE,8,5,309,322,3
ITGAL,5,2,315,322,3
EIF4ENIF1,13,10,299,322,3
ITGB6,5,2,315,322,3
EIF4E,7,4,311,322,3
ITIH5,5,2,315,322,3
MRPL38,8,5,309,322,3
MRPL30,7,4,311,322,3
KIF3A,5,2,315,322,3
KIF6,4,1,317,322,3
METTL21A,6,3,313,322,3
DDX41,18,15,289,322,3
MIPEP,5,2,315,322,3
DDX21,5,2,315,322,3
KMT5B,11,8,303,322,3
MILR1,12,9,301,322,3
KNL1,7,4,311,322,3
KNOP1,6,3,313,322,3
DUSP21,5,2,315,322,3
KPNA7,6,3,313,322,3
KPTN,7,4,311,322,3
KRAS,7,4,311,322,3
DDX39A,11,8,303,322,3
MICA,9,6,307,322,3
MGST2,11,8,303,322,3
EBAG9,7,4,311,322,3
KRT20,3,0,319,322,3
DUS3L,12,9,301,322,3
MFSD14B,7,4,311,322,3
MFSD14A,7,4,311,322,3
KRT74,3,0,319,322,3
KRT75,7,4,311,322,3
DDX59,7,4,311,322,3
KRTAP10-1,4,1,317,322,3
MFAP3L,18,15,289,322,3
KRTAP11-1,4,1,317,322,3
KRTAP19-1,5,2,315,322,3
METTL24,12,9,301,322,3
MIS12,7,4,311,322,3
MISP,9,6,307,322,3
DDX19B,8,5,309,322,3
KLRF2,5,2,315,322,3
KIN,4,1,317,322,3
MOB1B,5,2,315,322,3
E2F4,8,5,309,322,3
KLF18,3,0,319,322,3
KLF5,8,5,309,322,3
MND1,12,9,301,322,3
DYSF,5,2,315,322,3
MMP8,5,2,315,322,3
DCTN3,11,8,303,322,3
DCTPP1,8,5,309,322,3
KLHL11,6,3,313,322,3
DYRK4,8,5,309,322,3
KLHL14,3,0,319,322,3
DYRK3,4,1,317,322,3
DDA1,9,6,307,322,3
KLHL5,7,4,311,322,3
KLHL8,3,0,319,322,3
KLK12,7,4,311,322,3
DUXA,8,5,309,322,3
MLH3,7,4,311,322,3
DDRGK1,7,4,311,322,3
DDX1,6,3,313,322,3
DDX11,6,3,313,322,3
MKNK1,8,5,309,322,3
DDX18,5,2,315,322,3
GP6,7,4,311,322,3
DIP2C,11,8,303,322,3
NUB1,8,5,309,322,3
GALNS,8,5,309,322,3
NPTX1,4,1,317,322,3
FOXRED2,5,2,315,322,3
FPGS,9,6,307,322,3
GFRA1,4,1,317,322,3
GAGE12H,10,7,305,322,3
FXR2,10,7,305,322,3
FRAS1,4,1,317,322,3
NR6A1,6,3,313,322,3
GCC2,7,4,311,322,3
GGCX,6,3,313,322,3
FREM2,5,2,315,322,3
FBXW4,3,0,319,322,3
GALK1,11,8,303,322,3
FKBP15,5,2,315,322,3
FRMD6,15,12,295,322,3
FFAR1,4,1,317,322,3
GOLGA2,8,5,309,322,3
FOXQ1,13,10,299,322,3
FNDC1,3,0,319,322,3
GEMIN8,5,2,315,322,3
FHOD3,6,3,313,322,3
FDX1,4,1,317,322,3
FZD3,8,5,309,322,3
CPA1,10,7,305,322,3
FNDC10,7,4,311,322,3
NSMCE1,9,6,307,322,3
FOXO6,10,7,305,322,3
GCM2,6,3,313,322,3
FYTTD1,9,6,307,322,3
CPS1,5,2,315,322,3
GLT6D1,3,0,319,322,3
FBL,8,5,309,322,3
NUDT7,12,9,301,322,3
GALM,5,2,315,322,3
FKBP3,9,6,307,322,3
CPQ,8,5,309,322,3
FBXW5,13,10,299,322,3
FGF2,5,2,315,322,3
FBXO17,6,3,313,322,3
FKBP9,5,2,315,322,3
GAS8,11,8,303,322,3
FLNA,8,5,309,322,3
FSIP2,8,5,309,322,3
NRP2,12,9,301,322,3
GAS2L3,5,2,315,322,3
FBXL2,7,4,311,322,3
FGFBP1,6,3,313,322,3
GAPVD1,5,2,315,322,3
NTPCR,5,2,315,322,3
GARRE1,6,3,313,322,3
FBXW9,9,6,307,322,3
GAREM1,14,11,297,322,3
FBXO21,9,6,307,322,3
FLOT1,8,5,309,322,3
GIGYF2,7,4,311,322,3
FRRS1L,6,3,313,322,3
NSD1,5,2,315,322,3
GNG2,16,13,293,322,3
GHDC,9,6,307,322,3
FCGR2A,24,21,277,322,3
NR5A2,11,8,303,322,3
NUDT10,5,2,315,322,3
GNG13,19,16,287,322,3
GINS3,6,3,313,322,3
GMEB1,4,1,317,322,3
CPNE9,12,9,301,322,3
NUCB2,7,4,311,322,3
GATAD2B,12,9,301,322,3
CPXM2,3,0,319,322,3
CPNE8,6,3,313,322,3
GOLGA6L7,6,3,313,322,3
FCAR,7,4,311,322,3
NUP133,7,4,311,322,3
CREG2,4,1,317,322,3
GAD2,5,2,315,322,3
FOCAD,5,2,315,322,3
FEN1,10,7,305,322,3
GABRR3,3,0,319,322,3
NUP35,7,4,311,322,3
NUPR1,8,5,309,322,3
GLMP,6,3,313,322,3
FBXO4,5,2,315,322,3
GJD3,5,2,315,322,3
GOLGA7B,3,0,319,322,3
GLIS2,10,7,305,322,3
GDPGP1,11,8,303,322,3
GABRR1,5,2,315,322,3
GDA,14,11,297,322,3
NUP50,7,4,311,322,3
G6PC3,9,6,307,322,3
GOLGA8F,3,0,319,322,3
GOLGA8M,17,14,291,322,3
G6PC,3,0,319,322,3
FEZ1,8,5,309,322,3
FOXB1,4,1,317,322,3
FBXO45,6,3,313,322,3
GLB1L2,4,1,317,322,3
NUTF2,6,3,313,322,3
GABRA6,5,2,315,322,3
CEP164,7,5,310,322,2
SMLR1,8,6,308,322,2
OR11H1,4,2,316,322,2
SMIM9,4,2,316,322,2
PRKAG3,4,2,316,322,2
KLHDC8A,14,12,296,322,2
PRH2,35,33,254,322,2
JAG2,3,1,318,322,2
ITPRIPL2,4,2,316,322,2
ITSN2,6,4,312,322,2
JADE3,4,2,316,322,2
ZNF554,5,3,314,322,2
MRPL35,8,6,308,322,2
OR1L3,2,0,320,322,2
SMIM35,2,0,320,322,2
ST3GAL2,3,1,318,322,2
PRB2,2,0,320,322,2
OR1L1,3,1,318,322,2
KLHL30,5,3,314,322,2
MLX,7,5,310,322,2
OR11H4,6,4,312,322,2
MNDA,4,2,316,322,2
KATNAL1,5,3,314,322,2
SRPRB,6,4,312,322,2
CPPED1,4,2,316,322,2
MRNIP,6,4,312,322,2
KAT6A,8,6,308,322,2
PRKG2,3,1,318,322,2
PRKG1,6,4,312,322,2
CEP120,7,5,310,322,2
BTBD17,4,2,316,322,2
BTBD11,7,5,310,322,2
ISCA1,8,6,308,322,2
JCHAIN,23,21,278,322,2
JCAD,4,2,316,322,2
DYTN,2,0,320,322,2
SSH3,6,4,312,322,2
MRPL11,9,7,306,322,2
ABRAXAS2,6,4,312,322,2
JAKMIP2,5,3,314,322,2
SMIM31,7,5,310,322,2
MRPS12,9,7,306,322,2
ZNF432,4,2,316,322,2
KLHL20,4,2,316,322,2
BTNL8,7,5,310,322,2
BBS2,10,8,304,322,2
ITGB3BP,9,7,306,322,2
KLHL34,2,0,320,322,2
ZNF45,4,2,316,322,2
STAT6,7,5,310,322,2
ZNF444,11,9,302,322,2
ZNF43,9,7,306,322,2
FGFRL1,8,6,308,322,2
ITGA8,3,1,318,322,2
ITGAD,3,1,318,322,2
GABRB1,9,7,306,322,2
MRPL57,5,3,314,322,2
ZNF431,6,4,312,322,2
PRDM5,6,4,312,322,2
DAPP1,6,4,312,322,2
SMIM14,6,4,312,322,2
ZNF561,5,3,314,322,2
BUB1B-PAK6,12,10,300,322,2
BCAT1,5,3,314,322,2
KLF17,3,1,318,322,2
GAR1,6,4,312,322,2
DDC,8,6,308,322,2
MRPS22,8,6,308,322,2
OR1L4,4,2,316,322,2
CEP20,5,3,314,322,2
ITPA,9,7,306,322,2
PSMD7,8,6,308,322,2
OR11G2,6,4,312,322,2
ZNF558,3,1,318,322,2
MMP12,2,0,320,322,2
FGF5,5,3,314,322,2
GAMT,13,11,298,322,2
PREX2,2,0,320,322,2
EIF4E1B,7,5,310,322,2
PREP,5,3,314,322,2
PRELP,4,2,316,322,2
BBX,9,7,306,322,2
OR10Z1,2,0,320,322,2
CPSF6,11,9,302,322,2
PRMT7,10,8,304,322,2
SRPK1,7,5,310,322,2
BOLA2B,18,16,288,322,2
EDDM3A,3,1,318,322,2
SOX12,7,5,310,322,2
PRSS35,6,4,312,322,2
MORN1,10,8,304,322,2
OR13H1,4,2,316,322,2
DCPS,5,3,314,322,2
SP140L,5,3,314,322,2
KDM5D,3,1,318,322,2
KIFBP,7,5,310,322,2
SPA17,2,0,320,322,2
MOCOS,3,1,318,322,2
EDNRA,5,3,314,322,2
BOK,7,5,310,322,2
ZNF536,4,2,316,322,2
EEF1AKMT3,4,2,316,322,2
KIRREL3,4,2,316,322,2
PRRG1,7,5,310,322,2
KIT,4,2,316,322,2
KCTD21,10,8,304,322,2
KCTD20,6,4,312,322,2
SOWAHA,5,3,314,322,2
KHNYN,8,6,308,322,2
KCTD18,3,1,318,322,2
SNX8,10,8,304,322,2
ECEL1,5,3,314,322,2
OR13C4,2,0,320,322,2
MOG,7,5,310,322,2
ABHD17C,11,9,302,322,2
KIF17,3,1,318,322,2
KIF16B,6,4,312,322,2
BRCC3,3,1,318,322,2
KIAA2026,3,1,318,322,2
BRCA2,5,3,314,322,2
KIAA1671,4,2,316,322,2
BRIP1,4,2,316,322,2
PRUNE2,6,4,312,322,2
BPY2,5,3,314,322,2
PRTG,11,9,302,322,2
KIAA1210,2,0,320,322,2
BPIFC,8,6,308,322,2
KIAA0586,5,3,314,322,2
SORBS2,19,17,286,322,2
KIAA0319,4,2,316,322,2
SORCS3,3,1,318,322,2
PRR5,6,4,312,322,2
SPATA16,3,1,318,322,2
BDH2,9,7,306,322,2
SPRR3,2,0,320,322,2
KLF16,8,6,308,322,2
MR1,4,2,316,322,2
SPPL2A,4,2,316,322,2
DCAF12L1,2,0,320,322,2
KCNH7,4,2,316,322,2
CDT1,8,6,308,322,2
SPRR2B,3,1,318,322,2
CENPI,8,6,308,322,2
KCNH1,2,0,320,322,2
KCNE4,4,2,316,322,2
BICRA,11,9,302,322,2
SPSB3,15,13,294,322,2
SPTLC2,4,2,316,322,2
PROC,12,10,300,322,2
KCNB2,3,1,318,322,2
OR13C8,2,0,320,322,2
CENPQ,7,5,310,322,2
BSPH1,6,4,312,322,2
KBTBD11,3,1,318,322,2
OR1E2,8,6,308,322,2
KCNIP4,11,9,302,322,2
EFL1,7,5,310,322,2
ZNF516,12,10,300,322,2
PSMA6,8,6,308,322,2
BMPR1B,6,4,312,322,2
SPATA31A3,3,1,318,322,2
KIZ,7,5,310,322,2
BMPR1A,5,3,314,322,2
DCAF8L2,6,4,312,322,2
KLC3,11,9,302,322,2
SPATA33,6,4,312,322,2
PRAMEF7,2,0,320,322,2
EFCAB2,7,5,310,322,2
SPC25,6,4,312,322,2
PSMB2,3,1,318,322,2
KCNQ1,11,9,302,322,2
SPDYE3,8,6,308,322,2
PRR16,11,9,302,322,2
PSMB10,8,6,308,322,2
OR1A2,2,0,320,322,2
MPP7,4,2,316,322,2
KCNJ8,8,6,308,322,2
BIRC5,7,5,310,322,2
FH,7,5,310,322,2
ZNF514,6,4,312,322,2
WDR97,4,2,316,322,2
BAK1,8,6,308,322,2
TDRD1,2,0,320,322,2
POLR3C,4,2,316,322,2
POLR2L,9,7,306,322,2
FEZ2,10,8,304,322,2
TCP10L2,9,7,306,322,2
CHDH,5,3,314,322,2
POLR2I,12,10,300,322,2
IGLON5,7,5,310,322,2
OR2T11,2,0,320,322,2
TCP11X1,2,0,320,322,2
CYP2C8,8,6,308,322,2
CHEK1,6,4,312,322,2
POLR1F,6,4,312,322,2
TCHH,2,0,320,322,2
NRG2,4,2,316,322,2
POLR1D,10,8,304,322,2
IGKV6D-21,3,1,318,322,2
MTSS1,14,12,296,322,2
TECPR1,4,2,316,322,2
TECTB,4,2,316,322,2
IGKV3OR2-268,9,7,306,322,2
GCNT2,4,2,316,322,2
OR2T27,2,0,320,322,2
MTX3,4,2,316,322,2
IGKV2D-24,6,4,312,322,2
MTRES1,5,3,314,322,2
POLR3GL,6,4,312,322,2
BAG5,6,4,312,322,2
CHCHD4,3,1,318,322,2
MTHFSD,7,5,310,322,2
IGSF21,2,0,320,322,2
TBCE,3,1,318,322,2
TBL1X,9,7,306,322,2
EOGT,5,3,314,322,2
TBL2,5,3,314,322,2
TBP,7,5,310,322,2
CHAT,3,1,318,322,2
TBRG1,4,2,316,322,2
POP4,9,7,306,322,2
TBX10,7,5,310,322,2
TBX19,5,3,314,322,2
TCF4,10,8,304,322,2
ATP10D,4,2,316,322,2
CHCHD7,12,10,300,322,2
CHD1,6,4,312,322,2
MTMR4,9,7,306,322,2
IGLV3-9,12,10,300,322,2
TBXA2R,5,3,314,322,2
NRG3,5,3,314,322,2
POMC,7,5,310,322,2
TCEA2,10,8,304,322,2
TCEAL5,5,3,314,322,2
TCERG1,4,2,316,322,2
EPC2,6,4,312,322,2
IGKV1D-39,9,7,306,322,2
ATAD3C,4,2,316,322,2
OR2V2,3,1,318,322,2
NREP,12,10,300,322,2
IGHV1-69,5,3,314,322,2
IGHV1-58,5,3,314,322,2
PMCH,14,12,296,322,2
TIAM1,5,3,314,322,2
ART5,17,15,290,322,2
TIMM17B,7,5,310,322,2
ARSK,4,2,316,322,2
TIMM29,7,5,310,322,2
EPHA7,3,1,318,322,2
CHRM3,4,2,316,322,2
ARSH,2,0,320,322,2
IGKV1D-37,4,2,316,322,2
PLSCR5,2,0,320,322,2
TIPIN,3,1,318,322,2
ARSB,3,1,318,322,2
PLSCR1,7,5,310,322,2
TKTL2,3,1,318,322,2
CHRNA9,8,6,308,322,2
ARRDC3,12,10,300,322,2
FERD3L,7,5,310,322,2
PLPPR1,13,11,298,322,2
TLNRD1,3,1,318,322,2
ARPC1B,10,8,304,322,2
CYBC1,5,3,314,322,2
PMP2,6,4,312,322,2
CYC1,7,5,310,322,2
PMPCA,9,7,306,322,2
POLA1,6,4,312,322,2
ATAD1,5,3,314,322,2
TES,4,2,316,322,2
TESPA1,2,0,320,322,2
POFUT1,5,3,314,322,2
TET1,7,5,310,322,2
TEX2,7,5,310,322,2
IGHV5-51,4,2,316,322,2
ZNF197,4,2,316,322,2
ZNF185,4,2,316,322,2
TFCP2L1,2,0,320,322,2
TFDP3,2,0,320,322,2
TGFB1,9,7,306,322,2
TGFB3,9,7,306,322,2
TGFBRAP1,3,1,318,322,2
TGM3,2,0,320,322,2
TGM5,2,0,320,322,2
IGHV3-21,3,1,318,322,2
IGHV3-20,4,2,316,322,2
EPHA10,8,6,308,322,2
THOC1,8,6,308,322,2
THRSP,11,9,302,322,2
CYCS,5,3,314,322,2
ATP1A4,5,3,314,322,2
TBC1D3E,4,2,316,322,2
IGSF3,9,7,306,322,2
CETN3,9,7,306,322,2
IPCEF1,3,1,318,322,2
CERS5,5,3,314,322,2
B3GAT3,5,3,314,322,2
CPTP,10,8,304,322,2
INTS4,9,7,306,322,2
PPP2R3A,6,4,312,322,2
CES4A,4,2,316,322,2
GBE1,5,3,314,322,2
ZNF326,6,4,312,322,2
B3GALNT1,5,3,314,322,2
MSL1,9,7,306,322,2
INPP5A,7,5,310,322,2
PPP1R16B,7,5,310,322,2
SVOP,4,2,316,322,2
SYN2,4,2,316,322,2
ACKR1,3,1,318,322,2
CFAP298,9,7,306,322,2
ING5,4,2,316,322,2
ING2,9,7,306,322,2
MSMO1,12,10,300,322,2
ZNF3,6,4,312,322,2
IMPG2,3,1,318,322,2
SYNPO2,5,3,314,322,2
ZNF292,9,7,306,322,2
B3GNT6,8,6,308,322,2
DALRD3,8,6,308,322,2
MS4A3,7,5,310,322,2
ZNF358,13,11,298,322,2
IRGQ,8,6,308,322,2
BACH2,8,6,308,322,2
GAS2L1,13,11,298,322,2
STX10,9,7,306,322,2
B9D2,14,12,296,322,2
STX18,4,2,316,322,2
IRAK2,5,3,314,322,2
PRAMEF1,2,0,320,322,2
ELMO2,10,8,304,322,2
B4GALT4,11,9,302,322,2
B4GALT3,7,5,310,322,2
IQCK,7,5,310,322,2
SUCNR1,3,1,318,322,2
MRPS7,6,4,312,322,2
B4GALNT2,3,1,318,322,2
IQCF6,7,5,310,322,2
MRS2,6,4,312,322,2
IQCF2,5,3,314,322,2
OR10S1,2,0,320,322,2
ELN,8,6,308,322,2
IQCD,8,6,308,322,2
IQCB1,9,7,306,322,2
IQANK1,3,1,318,322,2
CFAP410,10,8,304,322,2
MSRB1,10,8,304,322,2
TBC1D31,6,4,312,322,2
ACMSD,4,2,316,322,2
IL31RA,2,0,320,322,2
TAF4B,5,3,314,322,2
IL23R,3,1,318,322,2
TAF8,5,3,314,322,2
MTAP,5,3,314,322,2
TAFA3,8,6,308,322,2
IL21R,5,3,314,322,2
ZNF268,5,3,314,322,2
TAMALIN,6,4,312,322,2
ENPEP,7,5,310,322,2
TAPT1,7,5,310,322,2
TAS1R1,8,6,308,322,2
GC,2,0,320,322,2
IL18BP,7,5,310,322,2
PPBP,3,1,318,322,2
MTDH,6,4,312,322,2
GCG,8,6,308,322,2
PPARA,6,4,312,322,2
IL17A,4,2,316,322,2
ATP5ME,11,9,302,322,2
ZNF260,5,3,314,322,2
ZNF26,5,3,314,322,2
FFAR3,3,1,318,322,2
POU3F4,3,1,318,322,2
ATP8A2,5,3,314,322,2
TAF11L7,3,1,318,322,2
TAF11L5,3,1,318,322,2
CYP7B1,2,0,320,322,2
MSRB3,3,1,318,322,2
SYT3,11,9,302,322,2
SYT7,4,2,316,322,2
MST1,16,14,292,322,2
ATXN3,6,4,312,322,2
SYTL4,4,2,316,322,2
SYTL5,3,1,318,322,2
TAAR9,2,0,320,322,2
EML4,4,2,316,322,2
MT-ND1,7,5,310,322,2
ZNF276,5,3,314,322,2
CFAP97D1,3,1,318,322,2
CFAP99,9,7,306,322,2
MT-ND5,9,7,306,322,2
CFC1,2,0,320,322,2
NRIP3,8,6,308,322,2
PPL,6,4,312,322,2
PPIP5K2,6,4,312,322,2
OR2H2,6,4,312,322,2
PPIL6,5,3,314,322,2
WDR86,12,10,300,322,2
PPIL3,8,6,308,322,2
IL34,12,10,300,322,2
SMC5,4,2,316,322,2
ABCG1,7,5,310,322,2
CDK7,9,7,306,322,2
SCN9A,4,2,316,322,2
LLCFC1,3,1,318,322,2
REC114,9,7,306,322,2
RDM1,13,11,298,322,2
SCGB2A2,6,4,312,322,2
SCLT1,4,2,316,322,2
SCMH1,9,7,306,322,2
SCML2,4,2,316,322,2
RDH12,6,4,312,322,2
SCML4,4,2,316,322,2
RD3,4,2,316,322,2
LIPK,3,1,318,322,2
ZNF804B,2,0,320,322,2
CCNI2,6,4,312,322,2
CADPS2,2,0,320,322,2
FLT3,5,3,314,322,2
LIN7C,5,3,314,322,2
FRMD5,8,6,308,322,2
CACNG5,5,3,314,322,2
SCYL1,8,6,308,322,2
LIN28A,3,1,318,322,2
SDC1,5,3,314,322,2
CACNG3,2,0,320,322,2
CCPG1,5,3,314,322,2
RBPMS2,9,7,306,322,2
FRAT2,5,3,314,322,2
MAT2B,6,4,312,322,2
LILRA4,12,10,300,322,2
ZNF84,10,8,304,322,2
SALL1,9,7,306,322,2
SALL2,11,9,302,322,2
ZNHIT3,6,4,312,322,2
CCNC,6,4,312,322,2
RETNLB,2,0,320,322,2
OCLN,4,2,316,322,2
ZNF85,10,8,304,322,2
OCRL,5,3,314,322,2
CANT1,10,8,304,322,2
REPS2,3,1,318,322,2
DGKH,3,1,318,322,2
LNX1,7,5,310,322,2
DNTTIP1,11,9,302,322,2
LMOD1,6,4,312,322,2
FLVCR1,4,2,316,322,2
ZNF83,7,5,310,322,2
ODF2L,6,4,312,322,2
MASP1,6,4,312,322,2
DNMT3A,11,9,302,322,2
REG3A,2,0,320,322,2
SCARA5,6,4,312,322,2
CALN1,3,1,318,322,2
AASS,5,3,314,322,2
DNTT,2,0,320,322,2
SDHAF4,5,3,314,322,2
RBMY1J,2,0,320,322,2
SACM1L,5,3,314,322,2
RB1,6,4,312,322,2
SERAC1,6,4,312,322,2
CD109,2,0,320,322,2
RBFOX1,5,3,314,322,2
LEF1,8,6,308,322,2
MCM6,6,4,312,322,2
SERINC3,5,3,314,322,2
RBBP8NL,6,4,312,322,2
RBBP8,6,4,312,322,2
DPP6,7,5,310,322,2
MCM8,5,3,314,322,2
FLRT2,2,0,320,322,2
NUBPL,4,2,316,322,2
CPLX2,10,8,304,322,2
DPP9,5,3,314,322,2
C6,3,1,318,322,2
DENND2D,11,9,302,322,2
SETD9,7,5,310,322,2
CD2,2,0,320,322,2
SETDB2,3,1,318,322,2
ZNF75A,5,3,314,322,2
LCE6A,2,0,320,322,2
MCTS2P,7,5,310,322,2
LCE3C,2,0,320,322,2
CD226,4,2,316,322,2
C8orf82,6,4,312,322,2
COQ7,5,3,314,322,2
SEC14L3,4,2,316,322,2
SEMA3B,4,2,316,322,2
SEC16B,4,2,316,322,2
DESI1,5,3,314,322,2
LHX9,18,16,288,322,2
ZNF780A,7,5,310,322,2
DOK4,11,9,302,322,2
LHFPL5,6,4,312,322,2
CABP2,2,0,320,322,2
DEPTOR,6,4,312,322,2
CPD,5,3,314,322,2
CA8,2,0,320,322,2
CA4,16,14,292,322,2
DOT1L,10,8,304,322,2
SEPTIN14,3,1,318,322,2
RBM39,9,7,306,322,2
DEPDC7,5,3,314,322,2
RBM26,6,4,312,322,2
DPH2,8,6,308,322,2
MCHR2,5,3,314,322,2
LEPROT,7,5,310,322,2
LEP,2,0,320,322,2
RBM18,6,4,312,322,2
RBM15B,7,5,310,322,2
CD101,4,2,316,322,2
C9orf43,3,1,318,322,2
LRP2,3,1,318,322,2
CAPZA1,6,4,312,322,2
DVL1,7,5,310,322,2
RPH3AL,7,5,310,322,2
RIOX2,8,6,308,322,2
DLAT,5,3,314,322,2
ROR1,4,2,316,322,2
ROR2,5,3,314,322,2
DLEC1,5,3,314,322,2
ZSWIM5,4,2,316,322,2
NXF3,3,1,318,322,2
CCDC174,9,7,306,322,2
COX19,4,2,316,322,2
DHX57,11,9,302,322,2
FOXA2,3,1,318,322,2
CCDC171,4,2,316,322,2
CCDC185,3,1,318,322,2
RPL12,10,8,304,322,2
ZSWIM3,7,5,310,322,2
CCDC158,2,0,320,322,2
NUP37,7,5,310,322,2
LYST,6,4,312,322,2
RPL27,10,8,304,322,2
RIC1,7,5,310,322,2
RHPN1,8,6,308,322,2
LYPD8,3,1,318,322,2
DMAC2L,5,3,314,322,2
RHOT1,9,7,306,322,2
MAOA,3,1,318,322,2
DKC1,5,3,314,322,2
LY6K,5,3,314,322,2
RMND1,6,4,312,322,2
MAMDC4,11,9,302,322,2
RNASEH2B,8,6,308,322,2
RNF168,4,2,316,322,2
RNF182,7,5,310,322,2
MAGEB6,2,0,320,322,2
RNASE2,4,2,316,322,2
RNASE12,4,2,316,322,2
RNASE11,7,5,310,322,2
DISP1,6,4,312,322,2
MAGEB2,5,3,314,322,2
MAN2A1,4,2,316,322,2
MAGEB18,3,1,318,322,2
DISP3,4,2,316,322,2
CCDC3,4,2,316,322,2
MAN2B2,4,2,316,322,2
CCDC27,3,1,318,322,2
MAGEA9,7,5,310,322,2
RLN2,15,13,294,322,2
NUP85,10,8,304,322,2
RNF24,7,5,310,322,2
DISP2,3,1,318,322,2
MAGEA2B,27,25,270,322,2
RNF5,9,7,306,322,2
RNLS,6,4,312,322,2
ZSCAN5C,3,1,318,322,2
ZSCAN4,3,1,318,322,2
DHCR24,9,7,306,322,2
RWDD1,7,5,310,322,2
RGS1,3,1,318,322,2
LRRC8B,3,1,318,322,2
LRRC74A,3,1,318,322,2
RSU1,6,4,312,322,2
RTCA,5,3,314,322,2
DNAJB7,10,8,304,322,2
ZSCAN1,7,5,310,322,2
ZRSR2,6,4,312,322,2
RGL3,12,10,300,322,2
LRRC40,6,4,312,322,2
DHFR,3,1,318,322,2
RFX4,11,9,302,322,2
RGS13,3,1,318,322,2
RWDD2A,3,1,318,322,2
LRRC28,5,3,314,322,2
ZPLD1,2,0,320,322,2
RXFP3,6,4,312,322,2
CARMIL3,4,2,316,322,2
RFT1,4,2,316,322,2
LRRC2,4,2,316,322,2
DNAJC18,9,7,306,322,2
DNAJC19,12,10,300,322,2
NUF2,6,4,312,322,2
DNAJC2,4,2,316,322,2
LRRC8D,5,3,314,322,2
RSF1,9,7,306,322,2
MAP3K4,16,14,292,322,2
MAPK13,5,3,314,322,2
LY6H,10,8,304,322,2
CCDC103,26,24,272,322,2
COX7B2,18,16,288,322,2
DMXL1,6,4,312,322,2
RPS4Y2,2,0,320,322,2
DNAH1,9,7,306,322,2
DHRS7C,6,4,312,322,2
ZSCAN22,6,4,312,322,2
RHBDF2,6,4,312,322,2
CBLN3,5,3,314,322,2
RPTOR,7,5,310,322,2
LRTM2,4,2,316,322,2
LRRIQ1,17,15,290,322,2
CBLL2,5,3,314,322,2
LRRTM3,2,0,320,322,2
LRRTM2,11,9,302,322,2
FNDC4,11,9,302,322,2
CCL23,6,4,312,322,2
OARD1,6,4,312,322,2
LRRN3,3,1,318,322,2
DNAH9,4,2,316,322,2
RRM2,9,7,306,322,2
LRRK1,4,2,316,322,2
RRS1,8,6,308,322,2
C4orf51,4,2,316,322,2
MCUB,6,4,312,322,2
C4orf45,7,5,310,322,2
PVALB,21,19,282,322,2
KRT38,2,0,320,322,2
MGAM,6,4,312,322,2
C15orf40,11,9,302,322,2
DDX55,4,2,316,322,2
SLC44A5,7,5,310,322,2
SLC45A4,4,2,316,322,2
SLC4A1,5,3,314,322,2
PWP1,7,5,310,322,2
CDH10,5,3,314,322,2
PVR,7,5,310,322,2
DDX52,4,2,316,322,2
C14orf132,9,7,306,322,2
KRT4,6,4,312,322,2
SLC50A1,5,3,314,322,2
SLC52A3,17,15,290,322,2
SLC5A10,3,1,318,322,2
CDH12,3,1,318,322,2
SLC5A7,2,0,320,322,2
CDH19,5,3,314,322,2
MGMT,5,3,314,322,2
C12orf71,12,10,300,322,2
KRT14,3,1,318,322,2
C12orf56,5,3,314,322,2
SLC6A19,3,1,318,322,2
KRT39,2,0,320,322,2
KRT40,2,0,320,322,2
DUSP12,9,7,306,322,2
KRT8,4,2,316,322,2
SLC2A2,11,9,302,322,2
R3HDML,8,6,308,322,2
R3HDM2,12,10,300,322,2
SLC30A2,5,3,314,322,2
FXYD1,29,27,266,322,2
SLC31A2,10,8,304,322,2
SLC32A1,3,1,318,322,2
SLC35A4,7,5,310,322,2
DUOX2,2,0,320,322,2
SLC35F3,4,2,316,322,2
SLC35G1,7,5,310,322,2
SLC35G4,3,1,318,322,2
SLC39A13,9,7,306,322,2
DUOXA2,4,2,316,322,2
FKBP11,9,7,306,322,2
SLC37A2,5,3,314,322,2
SLC37A4,9,7,306,322,2
OPTN,8,6,308,322,2
SLC38A11,4,2,316,322,2
SLC38A6,6,4,312,322,2
SLC38A7,4,2,316,322,2
OR10A3,5,3,314,322,2
PYGL,6,4,312,322,2
KRT72,3,1,318,322,2
OR10A6,3,1,318,322,2
PTRH2,9,7,306,322,2
LCE2D,3,1,318,322,2
C11orf21,3,1,318,322,2
DDX20,5,3,314,322,2
ABCG2,7,5,310,322,2
MIS18A,5,3,314,322,2
OR10H4,2,0,320,322,2
DDX19A,5,3,314,322,2
OR10H5,4,2,316,322,2
ZNF583,6,4,312,322,2
GABBR1,8,6,308,322,2
DDX10,3,1,318,322,2
ZNF580,8,6,308,322,2
A1CF,3,1,318,322,2
PTGES3L,8,6,308,322,2
CDK11A,9,7,306,322,2
CDK20,10,8,304,322,2
MKX,10,8,304,322,2
C11orf16,10,8,304,322,2
MLANA,6,4,312,322,2
SMAD3,9,7,306,322,2
C10orf88,5,3,314,322,2
ABCG8,2,0,320,322,2
C10orf82,8,6,308,322,2
PTF1A,11,9,302,322,2
C10orf67,6,4,312,322,2
MLLT10,6,4,312,322,2
IGFBP3,9,7,306,322,2
SLFN12L,5,3,314,322,2
DDX5,10,8,304,322,2
SLC9A2,6,4,312,322,2
PTPRU,3,1,318,322,2
DDX49,9,7,306,322,2
FZD7,13,11,298,322,2
SLC7A14,3,1,318,322,2
DDX3Y,2,0,320,322,2
KRI1,8,6,308,322,2
KRBOX1,9,7,306,322,2
C12orf40,3,1,318,322,2
ZNF611,6,4,312,322,2
SLC8A1,7,5,310,322,2
OR10C1,2,0,320,322,2
DUSP18,5,3,314,322,2
PTPN1,6,4,312,322,2
CDH7,4,2,316,322,2
ZNF606,8,6,308,322,2
ZNF605,4,2,316,322,2
SLC9B2,5,3,314,322,2
SLCO1A2,22,20,280,322,2
SLCO5A1,3,1,318,322,2
FITM2,6,4,312,322,2
SLF2,11,9,302,322,2
CDIN1,5,3,314,322,2
MINAR1,2,0,320,322,2
KNDC1,3,1,318,322,2
MEX3A,11,9,302,322,2
SLC2A11,10,8,304,322,2
RAB11FIP2,5,3,314,322,2
LAMC2,2,0,320,322,2
C2orf16,6,4,312,322,2
RAMP3,2,0,320,322,2
SHD,17,15,290,322,2
RAMP1,19,17,286,322,2
SHFL,11,9,302,322,2
C2orf15,11,9,302,322,2
LANCL2,5,3,314,322,2
DSC3,3,1,318,322,2
RALGAPA2,7,5,310,322,2
SHISAL2A,8,6,308,322,2
C2CD4C,4,2,316,322,2
DSG3,5,3,314,322,2
SHANK1,5,3,314,322,2
SHROOM2,8,6,308,322,2
CD40LG,5,3,314,322,2
SHROOM3,9,7,306,322,2
LACTB2,7,5,310,322,2
FUCA1,5,3,314,322,2
SIGLEC6,4,2,316,322,2
SIGMAR1,7,5,310,322,2
L3MBTL4,4,2,316,322,2
FKBP6,4,2,316,322,2
L3MBTL1,5,3,314,322,2
DTD2,4,2,316,322,2
LARP1B,6,4,312,322,2
ZNF713,6,4,312,322,2
RAB11FIP3,8,6,308,322,2
OLR1,16,14,292,322,2
LCE2B,2,0,320,322,2
SFRP5,6,4,312,322,2
RASA4,14,12,296,322,2
SFT2D2,6,4,312,322,2
RASA2,6,4,312,322,2
DENND10,6,4,312,322,2
SFTPA2,8,6,308,322,2
SFTPC,19,17,286,322,2
LCE1A,3,1,318,322,2
LBX1,2,0,320,322,2
LBR,7,5,310,322,2
LAYN,5,3,314,322,2
CD320,7,5,310,322,2
C3orf52,5,3,314,322,2
SH2B3,5,3,314,322,2
SH2D1B,2,0,320,322,2
SH2D5,10,8,304,322,2
CD300E,4,2,316,322,2
ZNF721,6,4,312,322,2
DRD3,4,2,316,322,2
C2orf92,10,8,304,322,2
ABCA9,5,3,314,322,2
ZNF716,4,2,316,322,2
SH3GLB2,7,5,310,322,2
SIVA1,8,6,308,322,2
MEI1,26,24,272,322,2
RAD17,6,4,312,322,2
RAB32,8,6,308,322,2
SLC22A12,2,0,320,322,2
KRTAP4-11,4,2,316,322,2
KRTAP3-2,6,4,312,322,2
RAB3B,2,0,320,322,2
METTL11B,4,2,316,322,2
C1orf167,8,6,308,322,2
CDC16,7,5,310,322,2
SLC22A24,2,0,320,322,2
KRTAP23-1,2,0,320,322,2
SLC25A15,4,2,316,322,2
RAB33B,6,4,312,322,2
CDC20B,7,5,310,322,2
MEI4,2,0,320,322,2
KRTAP20-3,3,1,318,322,2
RAB28,12,10,300,322,2
SLC25A27,14,12,296,322,2
DTX3L,5,3,314,322,2
COPS7A,8,6,308,322,2
SLC25A37,7,5,310,322,2
SLC25A38,8,6,308,322,2
SLC25A42,5,3,314,322,2
KRTAP13-4,2,0,320,322,2
SLC26A4,6,4,312,322,2
SLC29A3,5,3,314,322,2
METAP1,12,10,300,322,2
ZNF675,7,5,310,322,2
C1orf35,7,5,310,322,2
ZNF676,3,1,318,322,2
SIX6,2,0,320,322,2
SKAP2,3,1,318,322,2
KRTAP9-8,2,0,320,322,2
C1QTNF2,3,1,318,322,2
OPA3,7,5,310,322,2
SLA2,5,3,314,322,2
KRTAP9-4,3,1,318,322,2
SLAIN2,6,4,312,322,2
OPALIN,2,0,320,322,2
CD84,3,1,318,322,2
ZNF69,5,3,314,322,2
RAB9B,4,2,316,322,2
SLC12A2,2,0,320,322,2
DTX1,5,3,314,322,2
SLC12A5,22,20,280,322,2
SLC13A1,3,1,318,322,2
C1orf56,8,6,308,322,2
SLC15A5,4,2,316,322,2
KRTAP5-3,2,0,320,322,2
SLC17A3,3,1,318,322,2
KRTAP4-8,7,5,310,322,2
FKBP2,13,11,298,322,2
FKBP1C,10,8,304,322,2
PLPP1,7,5,310,322,2
IL36B,4,2,316,322,2
TRPV5,3,1,318,322,2
EXOC1,5,3,314,322,2
GSKIP,6,4,312,322,2
UPRT,6,4,312,322,2
EXOC8,9,7,306,322,2
OR51E1,3,1,318,322,2
XAGE3,21,19,282,322,2
HNRNPCL4,3,1,318,322,2
UPK3A,8,6,308,322,2
CTAGE9,15,13,294,322,2
PGAP4,5,3,314,322,2
CRY1,6,4,312,322,2
CNTNAP2,5,3,314,322,2
UNKL,4,2,316,322,2
HNRNPA1P48,26,24,272,322,2
CLEC3B,25,23,274,322,2
CLEC4D,2,0,320,322,2
CLEC4E,3,1,318,322,2
CLEC4F,3,1,318,322,2
TRBV19,3,1,318,322,2
ADGRA2,6,4,312,322,2
TRAV34,3,1,318,322,2
GSG1,7,5,310,322,2
FAM237B,3,1,318,322,2
URB1,6,4,312,322,2
PAGE3,3,1,318,322,2
XAF1,7,5,310,322,2
TRAPPC2,4,2,316,322,2
XAGE1A,9,7,306,322,2
HORMAD2,7,5,310,322,2
HOOK1,6,4,312,322,2
URI1,7,5,310,322,2
TRAT1,2,0,320,322,2
URAD,6,4,312,322,2
NDUFB11,10,8,304,322,2
TRAV10,3,1,318,322,2
TRAV24,2,0,320,322,2
NDUFAF4,6,4,312,322,2
GSDMA,8,6,308,322,2
GJB2,3,1,318,322,2
FAM240A,2,0,320,322,2
CNTNAP4,2,0,320,322,2
TRAV26-2,2,0,320,322,2
ADGRA1,3,1,318,322,2
FAM220A,8,6,308,322,2
GTF2A2,8,6,308,322,2
TRIL,4,2,316,322,2
CRYAA,6,4,312,322,2
TRHDE,5,3,314,322,2
TRHR,4,2,316,322,2
GTF3A,7,5,310,322,2
GJB6,6,4,312,322,2
HMCN2,4,2,316,322,2
GNG10,9,7,306,322,2
XKR5,3,1,318,322,2
PERP,3,1,318,322,2
PEX13,6,4,312,322,2
UGT2B4,20,18,284,322,2
GJB7,7,5,310,322,2
CT47A11,7,5,310,322,2
UGT2B28,2,0,320,322,2
PARM1,4,2,316,322,2
TRIM27,9,7,306,322,2
UGT2A2,3,1,318,322,2
EYA2,5,3,314,322,2
TRGJP2,2,0,320,322,2
XK,2,0,320,322,2
CLEC5A,5,3,314,322,2
TREM1,5,3,314,322,2
ULK4,9,7,306,322,2
PAPOLG,5,3,314,322,2
PAPPA,2,0,320,322,2
TRBV6-8,6,4,312,322,2
NDUFV3,4,2,316,322,2
TRDN,8,6,308,322,2
TRDV1,3,1,318,322,2
PFAS,9,7,306,322,2
PF4,4,2,316,322,2
UHRF1BP1,5,3,314,322,2
PAPSS2,4,2,316,322,2
PEX7,4,2,316,322,2
NME8,5,3,314,322,2
PEX5L,5,3,314,322,2
HMGCL,8,6,308,322,2
GTF2H3,6,4,312,322,2
TRERF1,5,3,314,322,2
OR5K1,3,1,318,322,2
FAM243B,10,8,304,322,2
CLEC17A,3,1,318,322,2
NLRP8,2,0,320,322,2
PGS1,7,5,310,322,2
HR,5,3,314,322,2
HPSE2,7,5,310,322,2
P4HA3,10,8,304,322,2
CLCNKB,6,4,312,322,2
COG8,6,4,312,322,2
USP46,5,3,314,322,2
PI4K2A,6,4,312,322,2
CROT,6,4,312,322,2
HPS1,11,9,302,322,2
HPRT1,6,4,312,322,2
NCAPG2,7,5,310,322,2
TOPBP1,6,4,312,322,2
EVA1B,16,14,292,322,2
CTSO,4,2,316,322,2
NCBP2AS2,11,9,302,322,2
TOR3A,7,5,310,322,2
TOR4A,4,2,316,322,2
OR4Q3,2,0,320,322,2
PABPC3,3,1,318,322,2
FBP2,6,4,312,322,2
PIAS3,7,5,310,322,2
PIAS4,8,6,308,322,2
USP54,7,5,310,322,2
USP6,4,2,316,322,2
TNKS1BP1,8,6,308,322,2
HS6ST1,7,5,310,322,2
APOOL,3,1,318,322,2
HS3ST6,10,8,304,322,2
APOL5,5,3,314,322,2
PIGF,9,7,306,322,2
FCER1A,2,0,320,322,2
TNS3,6,4,312,322,2
NCAM2,3,1,318,322,2
FAM50B,3,1,318,322,2
HRH1,5,3,314,322,2
TOM1,12,10,300,322,2
TOM1L1,9,7,306,322,2
ZDHHC22,7,5,310,322,2
HRC,23,21,278,322,2
HRAS,10,8,304,322,2
USP48,6,4,312,322,2
APOB,3,1,318,322,2
APOA5,2,0,320,322,2
ACVRL1,11,9,302,322,2
USP17L11,9,7,306,322,2
TRAJ12,4,2,316,322,2
PADI3,2,0,320,322,2
PHF13,8,6,308,322,2
TRAJ20,2,0,320,322,2
GRIP2,14,12,296,322,2
PADI6,4,2,316,322,2
NDST3,2,0,320,322,2
GRK1,2,0,320,322,2
TRAJ23,4,2,316,322,2
NDRG3,5,3,314,322,2
TRAJ31,3,1,318,322,2
TRAJ37,2,0,320,322,2
PHC1,11,9,302,322,2
FAM24B,11,9,302,322,2
EXO1,7,5,310,322,2
ADA,8,6,308,322,2
GNG4,8,6,308,322,2
NDUFA5,9,7,306,322,2
TRAJ1,3,1,318,322,2
NDRG2,14,12,296,322,2
TP53I13,14,12,296,322,2
NCR2,2,0,320,322,2
GNGT1,6,4,312,322,2
CTSC,4,2,316,322,2
PHLDB2,3,1,318,322,2
HOXD11,5,3,314,322,2
WWP1,4,2,316,322,2
HOXC8,7,5,310,322,2
OR4X1,5,3,314,322,2
USP28,6,4,312,322,2
APEH,10,8,304,322,2
HOXB13,3,1,318,322,2
FBXL12,8,6,308,322,2
EVX1,4,2,316,322,2
TPST1,12,10,300,322,2
USP25,5,3,314,322,2
APBB1IP,2,0,320,322,2
AK7,14,12,296,322,2
TPX2,5,3,314,322,2
ZDHHC12,10,8,304,322,2
GTPBP4,4,2,316,322,2
PELO,7,5,310,322,2
GIMAP6,3,1,318,322,2
TSPAN11,13,11,298,322,2
PCDH20,2,0,320,322,2
HEATR1,6,4,312,322,2
GMDS,4,2,316,322,2
TSTD3,8,6,308,322,2
UBALD2,16,14,292,322,2
HDDC2,9,7,306,322,2
PCYT1B,4,2,316,322,2
UBA2,7,5,310,322,2
ANKRD13B,11,9,302,322,2
FBXO39,5,3,314,322,2
TTC23,10,8,304,322,2
NKD1,4,2,316,322,2
HDAC11,9,7,306,322,2
PCDHA12,3,1,318,322,2
CSE1L,7,5,310,322,2
AMD1,10,8,304,322,2
HCRT,17,15,290,322,2
NHLRC2,5,3,314,322,2
PCDHA3,2,0,320,322,2
CSN1S1,2,0,320,322,2
GLRA1,12,10,300,322,2
HEATR5B,5,3,314,322,2
NKX2-5,6,4,312,322,2
H2BC21,10,8,304,322,2
TSPAN6,6,4,312,322,2
CNNM2,4,2,316,322,2
CMC2,10,8,304,322,2
OR52R1,2,0,320,322,2
PDE11A,3,1,318,322,2
ALOX12B,5,3,314,322,2
ALOX15B,3,1,318,322,2
FAM170A,5,3,314,322,2
TSR3,8,6,308,322,2
NKX2-1,3,1,318,322,2
H2BW1,14,12,296,322,2
ALPI,5,3,314,322,2
PDCD6-AHRR,37,35,250,322,2
ANKRD20A2P,24,22,276,322,2
UBASH3A,5,3,314,322,2
OR56A1,2,0,320,322,2
UBAP2,9,7,306,322,2
AMDHD2,10,8,304,322,2
NHLRC3,6,4,312,322,2
CMTM6,5,3,314,322,2
HAAO,5,3,314,322,2
ANGPT1,9,7,306,322,2
TXNDC9,9,7,306,322,2
TXNDC2,9,7,306,322,2
ANGEL1,7,5,310,322,2
ANAPC4,7,5,310,322,2
PCDHGC5,5,3,314,322,2
PCDHB3,2,0,320,322,2
HARS2,6,4,312,322,2
HARBI1,6,4,312,322,2
AMER3,4,2,316,322,2
CNGA3,4,2,316,322,2
PCDHGB4,4,2,316,322,2
OR5B17,2,0,320,322,2
TWIST2,4,2,316,322,2
TUSC1,3,1,318,322,2
HACL1,7,5,310,322,2
HADH,7,5,310,322,2
FBXO3,9,7,306,322,2
FAM160B1,7,5,310,322,2
TYMS,9,7,306,322,2
NKAP,7,5,310,322,2
OR5B3,2,0,320,322,2
PCDHA6,3,1,318,322,2
TTC38,14,12,296,322,2
H3Y2,2,0,320,322,2
TTC7A,7,5,310,322,2
GLS2,8,6,308,322,2
HCFC1R1,11,9,302,322,2
GLT1D1,2,0,320,322,2
CSF2RA,6,4,312,322,2
CSF2RB,3,1,318,322,2
PCGF6,5,3,314,322,2
ANKEF1,2,0,320,322,2
PCMTD2,7,5,310,322,2
FAM122B,5,3,314,322,2
TYRP1,10,8,304,322,2
PCDHB10,4,2,316,322,2
PCLAF,7,5,310,322,2
HAUS3,6,4,312,322,2
TUBA3C,6,4,312,322,2
ADAMTS17,5,3,314,322,2
TSLP,3,1,318,322,2
HLA-DRB1,5,3,314,322,2
FAM104B,8,6,308,322,2
UEVLD,5,3,314,322,2
PASD1,4,2,316,322,2
CLNK,11,9,302,322,2
OR51V1,3,1,318,322,2
TRIM7,6,4,312,322,2
TRIM72,4,2,316,322,2
F8,6,4,312,322,2
CSTA,18,16,288,322,2
PDXP,11,9,302,322,2
ALDH16A1,4,2,316,322,2
GUCY1A2,3,1,318,322,2
TRIM75P,3,1,318,322,2
HINT3,8,6,308,322,2
F8A2,2,0,320,322,2
UCN2,9,7,306,322,2
PATE4,3,1,318,322,2
PATJ,4,2,316,322,2
OR52A1,2,0,320,322,2
NET1,6,4,312,322,2
TRIM67,3,1,318,322,2
GUCY1A1,4,2,316,322,2
CSTF2,6,4,312,322,2
ZC3H18,7,5,310,322,2
UGT1A7,5,3,314,322,2
CLIP4,8,6,308,322,2
UGT1A4,9,7,306,322,2
PARP15,6,4,312,322,2
CLK2,7,5,310,322,2
PARP2,9,7,306,322,2
XPC,8,6,308,322,2
PARP4,6,4,312,322,2
PECR,7,5,310,322,2
FAM20B,4,2,316,322,2
TRIM49C,4,2,316,322,2
F2RL1,6,4,312,322,2
FBXL3,11,9,302,322,2
TRIM51,5,3,314,322,2
TRIM58,3,1,318,322,2
TRIM6-TRIM34,5,3,314,322,2
NLRP4,2,0,320,322,2
HIRA,8,6,308,322,2
OR5H1,2,0,320,322,2
NETO1,3,1,318,322,2
ALDH1A1,9,7,306,322,2
PBX1,7,5,310,322,2
ZBTB3,9,7,306,322,2
UBQLN2,5,3,314,322,2
UBL4B,11,9,302,322,2
PBK,8,6,308,322,2
ANKRD40,5,3,314,322,2
H2AC4,36,34,252,322,2
FAM174C,10,8,304,322,2
CRYGN,11,9,302,322,2
H2AX,10,8,304,322,2
TRUB1,8,6,308,322,2
OR52K1,2,0,320,322,2
ADAMTS15,11,9,302,322,2
XYLT1,4,2,316,322,2
TSGA13,7,5,310,322,2
TSHB,4,2,316,322,2
NFATC2IP,5,3,314,322,2
PDE6C,5,3,314,322,2
H2BC10,32,30,260,322,2
TRUB2,3,1,318,322,2
ADAM29,2,0,320,322,2
UCK2,5,3,314,322,2
PAX2,4,2,316,322,2
GKN1,6,4,312,322,2
ALDH1A3,8,6,308,322,2
TRIP13,5,3,314,322,2
NEU3,5,3,314,322,2
FBXL4,5,3,314,322,2
NEURL1B,8,6,308,322,2
TRIT1,8,6,308,322,2
TRMO,9,7,306,322,2
ALDH1L2,3,1,318,322,2
TRPV2,23,21,278,322,2
PAX4,2,0,320,322,2
NEURL3,8,6,308,322,2
GNAI3,4,2,316,322,2
ZBTB49,10,8,304,322,2
FBXO42,7,5,310,322,2
OR52E6,2,0,320,322,2
TRPM8,3,1,318,322,2
ANKRD66,6,4,312,322,2
GREB1L,7,5,310,322,2
CRCP,6,4,312,322,2
ZDHHC4,8,6,308,322,2
VHL,4,2,316,322,2
ARL17A,7,5,310,322,2
OR8K3,2,0,320,322,2
ADRA1A,8,6,308,322,2
TMEM68,7,5,310,322,2
TMEM64,5,3,314,322,2
TMEM132B,4,2,316,322,2
VILL,13,11,298,322,2
GPR37L1,5,3,314,322,2
OTOS,6,4,312,322,2
ZMYND11,7,5,310,322,2
TMEM52B,4,2,316,322,2
HTR1B,4,2,316,322,2
CIR1,6,4,312,322,2
TMEM40,8,6,308,322,2
OTOP2,5,3,314,322,2
CPXM1,6,4,312,322,2
GPN2,6,4,312,322,2
PKNOX2,14,12,296,322,2
OTOL1,3,1,318,322,2
CXXC4,4,2,316,322,2
FAM90A10P,4,2,316,322,2
WNT10B,8,6,308,322,2
VWA8,5,3,314,322,2
VTI1A,5,3,314,322,2
IFNA1,3,1,318,322,2
CXCR1,3,1,318,322,2
PLEKHA2,6,4,312,322,2
ARL13B,6,4,312,322,2
OTOA,2,0,320,322,2
WASHC1,10,8,304,322,2
ZFPM2,4,2,316,322,2
GPR63,2,0,320,322,2
ACP5,18,16,288,322,2
ARMC1,7,5,310,322,2
FANCD2OS,16,14,292,322,2
PLEKHG4B,5,3,314,322,2
FANCD2,3,1,318,322,2
ADO,7,5,310,322,2
OR6C6,7,5,310,322,2
ESCO1,5,3,314,322,2
NPAS1,15,13,294,322,2
GPC3,3,1,318,322,2
HSPB3,14,12,296,322,2
ERVV-2,4,2,316,322,2
WFDC8,11,9,302,322,2
WFDC9,4,2,316,322,2
WBP11,7,5,310,322,2
ERVK3-1,8,6,308,322,2
ERVH48-1,9,7,306,322,2
ARHGAP15,5,3,314,322,2
PIWIL2,4,2,316,322,2
ACTL7A,6,4,312,322,2
PIWIL4,10,8,304,322,2
ADPGK,8,6,308,322,2
WASHC3,10,8,304,322,2
OTUD6B,5,3,314,322,2
NRBP1,5,3,314,322,2
OR8J3,2,0,320,322,2
GOLGA6B,3,1,318,322,2
ARL4A,6,4,312,322,2
VGLL1,10,8,304,322,2
PLEKHD1,4,2,316,322,2
VTCN1,8,6,308,322,2
TMEM275,3,1,318,322,2
N4BP3,2,0,320,322,2
FAM90A16P,7,5,310,322,2
ACP7,4,2,316,322,2
TMEM225,2,0,320,322,2
OR4D1,2,0,320,322,2
IDE,5,3,314,322,2
VPS8,8,6,308,322,2
VPS9D1,11,9,302,322,2
MYT1L,6,4,312,322,2
ORM1,9,7,306,322,2
COLCA2,7,5,310,322,2
MYSM1,5,3,314,322,2
ZMYM3,10,8,304,322,2
MYOF,7,5,310,322,2
ARHGEF37,15,13,294,322,2
TMEM209,6,4,312,322,2
TMEM207,2,0,320,322,2
NPIPA2,20,18,284,322,2
OSBP2,13,11,298,322,2
ORM2,4,2,316,322,2
PLAUR,7,5,310,322,2
CHTF18,5,3,314,322,2
TMEM204,10,8,304,322,2
ACSL5,7,5,310,322,2
ORMDL1,5,3,314,322,2
TMEM192,5,3,314,322,2
ARHGEF5,5,3,314,322,2
ZIM3,4,2,316,322,2
NPIPA8,30,28,264,322,2
NPIPA5,27,25,270,322,2
AFG1L,11,9,302,322,2
PLAAT1,8,6,308,322,2
PLAA,5,3,314,322,2
OSBPL6,5,3,314,322,2
ORAI2,6,4,312,322,2
AGBL3,24,22,276,322,2
GPR12,3,1,318,322,2
TMEM154,6,4,312,322,2
CILP,2,0,320,322,2
HTRA3,6,4,312,322,2
ARL1,11,9,302,322,2
ADGRF2,3,1,318,322,2
TMEM161A,7,5,310,322,2
TMEM272,6,4,312,322,2
CHST8,5,3,314,322,2
IFIT1B,3,1,318,322,2
ARID5A,8,6,308,322,2
IFI30,22,20,280,322,2
GPR176,5,3,314,322,2
GPR15,4,2,316,322,2
CRHR2,7,5,310,322,2
GPR171,6,4,312,322,2
PLA2G2F,2,0,320,322,2
HSD11B1L,7,5,310,322,2
HYKK,6,4,312,322,2
PLA2G4A,4,2,316,322,2
PLA2G4B,14,12,296,322,2
IFI27L1,11,9,302,322,2
OR6J1,4,2,316,322,2
GPR152,3,1,318,322,2
COL9A2,8,6,308,322,2
IBA57,5,3,314,322,2
ACSM3,19,17,286,322,2
HSPB11,7,5,310,322,2
GPR55,4,2,316,322,2
GOLGA5,6,4,312,322,2
EPPIN-WFDC6,3,1,318,322,2
UTP6,10,8,304,322,2
TNFRSF13B,4,2,316,322,2
TMC1,2,0,320,322,2
PIK3R5,5,3,314,322,2
ADGRE2,3,1,318,322,2
P2RX1,6,4,312,322,2
TMC5,7,5,310,322,2
GPS2,5,3,314,322,2
GPRIN3,2,0,320,322,2
TNFRSF10A,6,4,312,322,2
OXSR1,7,5,310,322,2
GPRIN1,7,5,310,322,2
PLIN4,6,4,312,322,2
ADGRG7,2,0,320,322,2
WDR12,5,3,314,322,2
TMC7,3,1,318,322,2
AHNAK2,4,2,316,322,2
CHRNG,15,13,294,322,2
TNFAIP6,7,5,310,322,2
VASH2,5,3,314,322,2
CHST1,3,1,318,322,2
CHST10,11,9,302,322,2
PIP4K2A,5,3,314,322,2
FCHO2,7,5,310,322,2
WDR64,2,0,320,322,2
ARMCX1,6,4,312,322,2
TNFRSF13C,4,2,316,322,2
OR6X1,4,2,316,322,2
PIK3R1,8,6,308,322,2
P2RX7,5,3,314,322,2
HSD11B2,13,11,298,322,2
FBLN7,9,7,306,322,2
ETNPPL,17,15,290,322,2
USP9Y,2,0,320,322,2
TM4SF4,9,7,306,322,2
GIMAP4,3,1,318,322,2
PIGV,7,5,310,322,2
TNFSF4,7,5,310,322,2
CLCA1,2,0,320,322,2
TM4SF5,8,6,308,322,2
WDR83OS,16,14,292,322,2
TNFSF18,7,5,310,322,2
ETNK2,11,9,302,322,2
NAT9,7,5,310,322,2
UST,5,3,314,322,2
AQP12A,3,1,318,322,2
UTF1,6,4,312,322,2
CYB5B,5,3,314,322,2
HSD17B2,5,3,314,322,2
TNFRSF9,5,3,314,322,2
UTP18,7,5,310,322,2
ARNTL,7,5,310,322,2
UTP20,3,1,318,322,2
ETFA,8,6,308,322,2
AQP6,5,3,314,322,2
VASN,8,6,308,322,2
MYPOP,7,5,310,322,2
CHST2,5,3,314,322,2
WDR17,7,5,310,322,2
PLEKHN1,3,1,318,322,2
TMPRSS11E,2,0,320,322,2
ARMC8,5,3,314,322,2
FAM83B,2,0,320,322,2
OR8B4,4,2,316,322,2
WDR27,8,6,308,322,2
TMCC3,7,5,310,322,2
GPRASP1,3,1,318,322,2
TMSB15B,9,7,306,322,2
CWF19L1,4,2,316,322,2
TMPRSS3,5,3,314,322,2
PIR,7,5,310,322,2
GOT1L1,5,3,314,322,2
MYNN,8,6,308,322,2
OR8B3,3,1,318,322,2
IFT46,8,6,308,322,2
OR4F6,2,0,320,322,2
TMPRSS11A,2,0,320,322,2
HSPA14,8,6,308,322,2
EPS15L1,6,4,312,322,2
GORASP2,7,5,310,322,2
OR7C1,4,2,316,322,2
ARMC10,6,4,312,322,2
RNF125,3,2,317,322,1
KRTAP25-1,3,2,317,322,1
SLC25A16,12,11,299,322,1
KRTAP5-11,1,0,321,322,1
WDR19,10,9,303,322,1
MAJIN,11,10,301,322,1
ZSWIM1,5,4,313,322,1
RNF38,9,8,305,322,1
GPATCH1,6,5,311,322,1
MAL2,9,8,305,322,1
MAGEA10,4,3,315,322,1
FKTN,6,5,311,322,1
UBXN2B,6,5,311,322,1
SHE,2,1,319,322,1
WDR45,6,5,311,322,1
LYZ,10,9,303,322,1
DSC2,3,2,317,322,1
HABP2,2,1,319,322,1
GML,4,3,315,322,1
UBQLNL,2,1,319,322,1
VSTM2B,3,2,317,322,1
FAM170B,1,0,321,322,1
GPR135,4,3,315,322,1
TVP23A,3,2,317,322,1
MALRD1,3,2,317,322,1
SH3RF2,2,1,319,322,1
MAGEB10,6,5,311,322,1
KRTAP2-4,3,2,317,322,1
H3C3,25,24,273,322,1
ZYG11B,4,3,315,322,1
RPL30,9,8,305,322,1
FKBP14,3,2,317,322,1
LYRM2,5,4,313,322,1
KRTAP2-1,6,5,311,322,1
C1QB,4,3,315,322,1
SLC12A1,4,3,315,322,1
GMCL1,3,2,317,322,1
UAP1,5,4,313,322,1
LYRM9,13,12,297,322,1
ABCD1,10,9,303,322,1
LYSMD1,7,6,309,322,1
SLC13A2,1,0,321,322,1
RPL27A,10,9,303,322,1
KRTAP5-9,9,8,305,322,1
ZNF705G,1,0,321,322,1
SLC25A21,5,4,313,322,1
TWIST1,4,3,315,322,1
KRTAP9-1,3,2,317,322,1
MAGEA6,5,4,313,322,1
C2orf50,4,3,315,322,1
VSIG8,4,3,315,322,1
KRTAP21-1,4,3,315,322,1
SHC3,10,9,303,322,1
ALG10B,4,3,315,322,1
RNF121,7,6,309,322,1
VSIR,2,1,319,322,1
UBQLN3,3,2,317,322,1
DSCC1,6,5,311,322,1
LACRT,2,1,319,322,1
SLC22A10,2,1,319,322,1
SIGLEC14,4,3,315,322,1
DLG3,5,4,313,322,1
SIGLEC15,8,7,307,322,1
ADSL,5,4,313,322,1
ADH1C,11,10,301,322,1
UBE2QL1,1,0,321,322,1
RP1,1,0,321,322,1
FAM9C,4,3,315,322,1
H4C12,41,40,241,322,1
H2BC15,5,4,313,322,1
SIX3,2,1,319,322,1
ADGRF5,1,0,321,322,1
GPIHBP1,2,1,319,322,1
SLC22A1,15,14,293,322,1
FBXO25,5,4,313,322,1
MAGEB6B,2,1,319,322,1
A4GALT,3,2,317,322,1
ALMS1,9,8,305,322,1
C1orf216,6,5,311,322,1
A2M,10,9,303,322,1
ROPN1,12,11,299,322,1
FARSB,4,3,315,322,1
KRTAP4-4,1,0,321,322,1
ROMO1,7,6,309,322,1
MAGEB4,4,3,315,322,1
UBE2J2,6,5,311,322,1
FOLR2,10,9,303,322,1
SIRT2,5,4,313,322,1
KY,1,0,321,322,1
MACC1,3,2,317,322,1
SIGLEC12,2,1,319,322,1
RPL10L,10,9,303,322,1
DIS3,7,6,309,322,1
FAM155A,1,0,321,322,1
SLC17A1,1,0,321,322,1
ADCY3,9,8,305,322,1
WDR73,6,5,311,322,1
RNPC3,10,9,303,322,1
DIPK1C,3,2,317,322,1
AMN1,8,7,307,322,1
WFS1,12,11,299,322,1
MAGEE2,2,1,319,322,1
SHISAL1,3,2,317,322,1
CCDC186,5,4,313,322,1
RPL10,11,10,301,322,1
VSX1,5,4,313,322,1
SHLD1,8,7,307,322,1
C1orf185,9,8,305,322,1
FAM174A,7,6,309,322,1
SKOR2,2,1,319,322,1
LAMB3,5,4,313,322,1
SHPRH,8,7,307,322,1
SLC17A4,1,0,321,322,1
ZNF668,11,10,301,322,1
ALPK1,6,5,311,322,1
CCDC43,9,8,305,322,1
SI,2,1,319,322,1
KRTAP9-7,1,0,321,322,1
GOT1,6,5,311,322,1
LAIR1,4,3,315,322,1
DSPP,1,0,321,322,1
DTNBP1,7,6,309,322,1
VWC2L,3,2,317,322,1
C22orf39,5,4,313,322,1
LSM12,5,4,313,322,1
LYPD3,14,13,295,322,1
UCN3,1,0,321,322,1
AGTRAP,10,9,303,322,1
SDR42E2,2,1,319,322,1
SDR42E1,1,0,321,322,1
VCL,8,7,307,322,1
SDR39U1,12,11,299,322,1
SDR16C5,1,0,321,322,1
USP17L10,2,1,319,322,1
DOCK8,8,7,307,322,1
CARMIL1,7,6,309,322,1
RYR3,10,9,303,322,1
GPR85,6,5,311,322,1
FAM83F,2,1,319,322,1
FAM83D,10,9,303,322,1
LIMK1,8,7,307,322,1
USP17L18,3,2,317,322,1
USP17L19,2,1,319,322,1
LRR1,4,3,315,322,1
USP17L21,1,0,321,322,1
USP17L23,8,7,307,322,1
SLC25A33,3,2,317,322,1
USP17L8,2,1,319,322,1
ZPBP2,2,1,319,322,1
ABCA2,11,10,301,322,1
DNAJC16,4,3,315,322,1
FRMD8,8,7,307,322,1
LILRA1,2,1,319,322,1
ABCA4,3,2,317,322,1
AKIP1,6,5,311,322,1
LRRC30,1,0,321,322,1
DOP1B,6,5,311,322,1
XAGE1B,9,8,305,322,1
LGR5,5,4,313,322,1
LGR6,4,3,315,322,1
LHCGR,4,3,315,322,1
CABP1,9,8,305,322,1
FRMPD3,3,2,317,322,1
FAM243A,6,5,311,322,1
GPR61,6,5,311,322,1
AGTR2,1,0,321,322,1
GRK5,2,1,319,322,1
FAM24A,7,6,309,322,1
CACNA1B,4,3,315,322,1
LIAS,4,3,315,322,1
FBXL13,7,6,309,322,1
VEGFC,3,2,317,322,1
SEC14L6,3,2,317,322,1
USP16,4,3,315,322,1
DOHH,8,7,307,322,1
CACNA1S,2,1,319,322,1
LINC02203,1,0,321,322,1
CADM3,2,1,319,322,1
GRIN1,2,1,319,322,1
SCCPDH,7,6,309,322,1
AJUBA,10,9,303,322,1
UTP3,4,3,315,322,1
USP45,8,7,307,322,1
GRAMD1B,7,6,309,322,1
CAND2,13,12,297,322,1
GRHL2,2,1,319,322,1
SCEL,1,0,321,322,1
WT1,5,4,313,322,1
LRATD1,6,5,311,322,1
SART3,8,7,307,322,1
DNASE1L3,8,7,307,322,1
USP35,7,6,309,322,1
SCART1,4,3,315,322,1
CAMKK2,7,6,309,322,1
ZNF839,9,8,305,322,1
LMLN2,5,4,313,322,1
AIMP2,7,6,309,322,1
AIMP1,5,4,313,322,1
ADGRD1,4,3,315,322,1
LNX2,2,1,319,322,1
DNMBP,5,4,313,322,1
LMO2,8,7,307,322,1
LKAAEAR1,13,12,297,322,1
GNL2,5,4,313,322,1
LINGO3,13,12,297,322,1
AICDA,7,6,309,322,1
CAPS2,7,6,309,322,1
SAA2,15,14,293,322,1
LINS1,6,5,311,322,1
SCNN1B,5,4,313,322,1
ZPBP,5,4,313,322,1
SAC3D1,8,7,307,322,1
LIPI,4,3,315,322,1
FMO5,7,6,309,322,1
SCN1B,4,3,315,322,1
DNAJC25,5,4,313,322,1
SCN11A,3,2,317,322,1
GRID2IP,3,2,317,322,1
AIF1L,10,9,303,322,1
ABCA10,6,5,311,322,1
FOXL1,6,5,311,322,1
SAMD15,5,4,313,322,1
GRIK3,3,2,317,322,1
GRIK1,5,4,313,322,1
ZNF860,3,2,317,322,1
ADGRE1,1,0,321,322,1
SCLY,5,4,313,322,1
AARD,4,3,315,322,1
DPEP1,10,9,303,322,1
GPR6,1,0,321,322,1
LRRC38,3,2,317,322,1
VPS33A,7,6,309,322,1
SFRP4,6,5,311,322,1
UGT2B10,1,0,321,322,1
GPR153,9,8,305,322,1
GPR160,15,14,293,322,1
AADAT,3,2,317,322,1
DNAH3,1,0,321,322,1
UGT2B7,9,8,305,322,1
GPR174,3,2,317,322,1
C5orf22,8,7,307,322,1
RPUSD1,9,8,305,322,1
GPR18,7,6,309,322,1
FSD1L,8,7,307,322,1
VPS26C,5,4,313,322,1
AGBL1,1,0,321,322,1
LCE5A,3,2,317,322,1
UHRF1BP1L,7,6,309,322,1
GTF2H4,9,8,305,322,1
GPR180,5,4,313,322,1
DPYD,6,5,311,322,1
FATE1,4,3,315,322,1
DPY19L4,6,5,311,322,1
GTF2H2C,5,4,313,322,1
RPS6KA3,5,4,313,322,1
AADACL4,2,1,319,322,1
C6orf118,3,2,317,322,1
VRK2,3,2,317,322,1
C3orf33,8,7,307,322,1
LYNX1-SLURP2,7,6,309,322,1
GPR143,12,11,299,322,1
LY86,4,3,315,322,1
CCDC125,3,2,317,322,1
LATS2,6,5,311,322,1
CCDC12,11,10,301,322,1
ABCA8,5,4,313,322,1
FAM20C,5,4,313,322,1
ZNF732,5,4,313,322,1
SGO2,5,4,313,322,1
FSIP1,22,21,279,322,1
ALAS2,8,7,307,322,1
FAM210B,5,4,313,322,1
CCDC114,8,7,307,322,1
FNDC5,15,14,293,322,1
CBX6,7,6,309,322,1
SFTPD,3,2,317,322,1
C4orf19,6,5,311,322,1
VPS54,3,2,317,322,1
ZSCAN26,7,6,309,322,1
AFP,2,1,319,322,1
CBLC,4,3,315,322,1
GPR34,8,7,307,322,1
LGALS16,3,2,317,322,1
GPR42,1,0,321,322,1
GOLGA6C,7,6,309,322,1
UPB1,4,3,315,322,1
C9orf16,13,12,297,322,1
UPK2,8,7,307,322,1
CASP8,8,7,307,322,1
C9orf50,10,9,303,322,1
SEPTIN10,5,4,313,322,1
DNAJC1,3,2,317,322,1
LELP1,2,1,319,322,1
AKNAD1,5,4,313,322,1
ZNF77,4,3,315,322,1
RSPH3,2,1,319,322,1
DNAJC10,5,4,313,322,1
RTN4R,8,7,307,322,1
UQCR10,10,9,303,322,1
RTP2,2,1,319,322,1
GSDME,7,6,309,322,1
AGPAT5,7,6,309,322,1
ABCA6,3,2,317,322,1
DPH1,7,6,309,322,1
CA10,2,1,319,322,1
RUBCNL,5,4,313,322,1
DPM3,11,10,301,322,1
VIT,9,8,305,322,1
LCP1,6,5,311,322,1
SERPINB13,3,2,317,322,1
ZSCAN16,11,10,301,322,1
LRRIQ3,11,10,301,322,1
LCP2,3,2,317,322,1
C6orf163,7,6,309,322,1
ZNF763,8,7,307,322,1
GTF2H2,6,5,311,322,1
ZNF764,6,5,311,322,1
FAM219A,7,6,309,322,1
C7orf26,14,13,295,322,1
VLDLR,7,6,309,322,1
SERPINB11,3,2,317,322,1
GSTA5,2,1,319,322,1
SERPINA1,11,10,301,322,1
C8A,2,1,319,322,1
XIRP2,1,0,321,322,1
ZSCAN12,6,5,311,322,1
LRRCC1,3,2,317,322,1
AKR1C4,2,1,319,322,1
FBXL15,9,8,305,322,1
UNC79,2,1,319,322,1
UNC80,2,1,319,322,1
AGL,6,5,311,322,1
GRIN3A,6,5,311,322,1
IGFALS,13,12,297,322,1
AMY1C,1,0,321,322,1
IL9,2,1,319,322,1
ILVBL,10,9,303,322,1
SYT13,2,1,319,322,1
GGT6,6,5,311,322,1
SYT14,4,3,315,322,1
ARFGAP3,6,5,311,322,1
ESS2,8,7,307,322,1
TAAR1,1,0,321,322,1
HSFX4,8,7,307,322,1
TAAR2,1,0,321,322,1
TAAR6,2,1,319,322,1
TAAR8,1,0,321,322,1
ATPAF2,11,10,301,322,1
TMPRSS11D,2,1,319,322,1
EMP1,12,11,299,322,1
AUH,8,7,307,322,1
HSF5,1,0,321,322,1
AQR,5,4,313,322,1
GBP4,4,3,315,322,1
SWAP70,4,3,315,322,1
SYCP2,14,13,295,322,1
AVPR1A,3,2,317,322,1
INHBC,2,1,319,322,1
HSD17B8,13,12,297,322,1
ACTR6,7,6,309,322,1
TNFAIP8L3,5,4,313,322,1
ESYT3,4,3,315,322,1
AVEN,4,3,315,322,1
ETDB,10,9,303,322,1
GBP6,1,0,321,322,1
SYNJ2,5,4,313,322,1
TNFAIP8L1,8,7,307,322,1
HSDL1,9,8,305,322,1
ESF1,5,4,313,322,1
TACR1,3,2,317,322,1
ESCO2,5,4,313,322,1
FCRL5,2,1,319,322,1
TMEM63A,11,10,301,322,1
ATP6V1C2,10,9,303,322,1
TMEM54,7,6,309,322,1
ATP6V1B2,6,5,311,322,1
ENPP1,5,4,313,322,1
HTR2A,7,6,309,322,1
ZNF266,4,3,315,322,1
ENAM,13,12,297,322,1
TAS2R14,6,5,311,322,1
ENPP6,2,1,319,322,1
HTR5A,1,0,321,322,1
ARHGAP28,5,4,313,322,1
ATP5IF1,6,5,311,322,1
ENTPD1,2,1,319,322,1
TMEM69,5,4,313,322,1
TAFA2,18,17,287,322,1
TMEM72,3,2,317,322,1
IL23A,18,17,287,322,1
GFY,7,6,309,322,1
TMEM74B,10,9,303,322,1
ZNF275,5,4,313,322,1
ARHGAP19-SLIT1,23,22,277,322,1
ENKD1,8,7,307,322,1
IL3,4,3,315,322,1
ENG,4,3,315,322,1
ZFP90,18,17,287,322,1
TMEM87A,7,6,309,322,1
ERVFRD-1,7,6,309,322,1
FCN1,3,2,317,322,1
ENDOD1,9,8,305,322,1
ARG1,10,9,303,322,1
SVIP,4,3,315,322,1
INSC,4,3,315,322,1
ADCY2,9,8,305,322,1
BBC3,12,11,299,322,1
STAP1,5,4,313,322,1
ITGBL1,1,0,321,322,1
HOXD4,7,6,309,322,1
BBIP1,10,9,303,322,1
TP53,28,27,267,322,1
STIL,4,3,315,322,1
HPN,10,9,303,322,1
ZNF454,6,5,311,322,1
BAZ1A,4,3,315,322,1
EIF5A2,5,4,313,322,1
STK31,3,2,317,322,1
FGF7,14,13,295,322,1
TOP2A,10,9,303,322,1
ELAPOR1,4,3,315,322,1
TPM4,7,6,309,322,1
HOXC6,12,11,299,322,1
ELSPBP1,9,8,305,322,1
EIF3D,9,8,305,322,1
JAKMIP1,7,6,309,322,1
EIF2S3,7,6,309,322,1
AP5S1,3,2,317,322,1
ABTB1,10,9,303,322,1
TRABD,7,6,309,322,1
ZDHHC13,6,5,311,322,1
EIF3G,5,4,313,322,1
ZDHHC14,8,7,307,322,1
BCDIN3D,7,6,309,322,1
ST6GALNAC2,14,13,295,322,1
ST6GALNAC5,7,6,309,322,1
EVX2,1,0,321,322,1
TPRN,6,5,311,322,1
APCS,1,0,321,322,1
TONSL,4,3,315,322,1
ELAPOR2,11,10,301,322,1
IRX6,1,0,321,322,1
GATA6,6,5,311,322,1
SULT1B1,5,4,313,322,1
IPPK,7,6,309,322,1
SULT1E1,5,4,313,322,1
FGF16,1,0,321,322,1
ELOVL4,5,4,313,322,1
ZNF350,7,6,309,322,1
SUN2,10,9,303,322,1
STOML1,7,6,309,322,1
GHRHR,3,2,317,322,1
TNFRSF25,9,8,305,322,1
GATD1,4,3,315,322,1
B3GALT2,10,9,303,322,1
ELP4,4,3,315,322,1
ETF1,4,3,315,322,1
B3GNT9,7,6,309,322,1
B3GNTL1,6,5,311,322,1
SUGP1,9,8,305,322,1
GIMAP7,1,0,321,322,1
TNNI1,5,4,313,322,1
STXBP6,4,3,315,322,1
APOL4,6,5,311,322,1
APOBR,3,2,317,322,1
APOBEC4,7,6,309,322,1
STX3,4,3,315,322,1
GAS2L2,4,3,315,322,1
APOBEC3G,6,5,311,322,1
ELF4,4,3,315,322,1
BAG2,3,2,317,322,1
STPG2,4,3,315,322,1
BAIAP2L1,7,6,309,322,1
STON1,3,2,317,322,1
IL12A,10,9,303,322,1
TBATA,3,2,317,322,1
IL10RB,4,3,315,322,1
ZNF160,6,5,311,322,1
ARL2BP,6,5,311,322,1
TGFBR3,4,3,315,322,1
ARL4D,11,10,301,322,1
IGHV3-72,5,4,313,322,1
ACOT9,6,5,311,322,1
ASDURF,53,52,217,322,1
EPS8L2,4,3,315,322,1
TFB1M,5,4,313,322,1
ASCL4,2,1,319,322,1
ZNF101,6,5,311,322,1
IGHV3-66,2,1,319,322,1
ASB9,14,13,295,322,1
IGHV3-33,10,9,303,322,1
ZNF107,5,4,313,322,1
IGHV4-34,24,23,275,322,1
GCSH,11,10,301,322,1
ARHGAP32,9,8,305,322,1
IGKJ1,1,0,321,322,1
IGKV1-6,4,3,315,322,1
GCSAM,11,10,301,322,1
IGKV1-37,2,1,319,322,1
EPCAM,8,7,307,322,1
TEX22,29,28,265,322,1
IGKV1-12,3,2,317,322,1
ASPSCR1,4,3,315,322,1
IGHV4-61,7,6,309,322,1
TEX44,4,3,315,322,1
TEX50,6,5,311,322,1
IGHV7-4-1,3,2,317,322,1
IGHV6-1,2,1,319,322,1
TFAP2B,1,0,321,322,1
IFNA16,1,0,321,322,1
TMEM104,7,6,309,322,1
ASB15,2,1,319,322,1
THEMIS,3,2,317,322,1
IGBP1P2,4,3,315,322,1
FECH,5,4,313,322,1
ARMCX2,8,7,307,322,1
TINAG,1,0,321,322,1
TMC2,2,1,319,322,1
TK2,23,22,277,322,1
ZNF154,4,3,315,322,1
EPOR,5,4,313,322,1
THNSL2,2,1,319,322,1
TM9SF1,7,6,309,322,1
ACOXL,7,6,309,322,1
IGFL4,16,15,291,322,1
ZNF141,3,2,317,322,1
ZNF132,6,5,311,322,1
EPM2A,5,4,313,322,1
TIMM22,5,4,313,322,1
TIMM10B,7,6,309,322,1
TIGD6,3,2,317,322,1
TIGAR,2,1,319,322,1
IGHV1-2,18,17,287,322,1
IGHV1-3,6,5,311,322,1
IGHV1-45,4,3,315,322,1
TMCO4,3,2,317,322,1
ASAP3,10,9,303,322,1
THSD7B,1,0,321,322,1
ZNF155,10,9,303,322,1
THSD7A,2,1,319,322,1
TMCO5A,5,4,313,322,1
THSD1,5,4,313,322,1
TMDD1,12,11,299,322,1
IFT74,8,7,307,322,1
THPO,17,16,289,322,1
TESC,14,13,295,322,1
TMEM150C,16,15,291,322,1
IGKV1D-12,4,3,315,322,1
ACOT2,11,10,301,322,1
TMEM256,12,11,299,322,1
TBL1Y,2,1,319,322,1
IGLV5-37,8,7,307,322,1
ATP13A1,9,8,305,322,1
TMEM254,8,7,307,322,1
ATP11B,5,4,313,322,1
ERI1,7,6,309,322,1
TMEM215,5,4,313,322,1
ACSM4,4,3,315,322,1
TMEM242,7,6,309,322,1
ERG,5,4,313,322,1
GFM1,6,5,311,322,1
ARHGEF10,6,5,311,322,1
ARHGEF28,3,2,317,322,1
TBCK,7,6,309,322,1
ARHGAP39,6,5,311,322,1
ERICH6B,1,0,321,322,1
ZG16,3,2,317,322,1
IGSF22,1,0,321,322,1
TMEM271,2,1,319,322,1
TBC1D3H,1,0,321,322,1
TBC1D3G,5,4,313,322,1
ZFYVE28,9,8,305,322,1
ACOT1,11,10,301,322,1
TBC1D32,7,6,309,322,1
ATP2B1,5,4,313,322,1
IGSF5,2,1,319,322,1
ZNF253,11,10,301,322,1
TBC1D20,4,3,315,322,1
ATP4B,5,4,313,322,1
ZNF257,14,13,295,322,1
TCEAL4,8,7,307,322,1
TMEM211,2,1,319,322,1
TERF1,4,3,315,322,1
TEDDM1,2,1,319,322,1
TEAD3,9,8,305,322,1
TMEM185A,14,13,295,322,1
IGKV6-21,6,5,311,322,1
TECTA,2,1,319,322,1
TMEM181,4,3,315,322,1
TMEM179B,9,8,305,322,1
IGKV3D-15,2,1,319,322,1
IGLV2-8,4,3,315,322,1
TEKT4,9,8,305,322,1
ZMYM6,4,3,315,322,1
IGKV2D-30,2,1,319,322,1
TENM1,2,1,319,322,1
TMEM175,14,13,295,322,1
IGKV2D-26,4,3,315,322,1
IGKV6D-41,1,0,321,322,1
ZKSCAN7,7,6,309,322,1
TMEM186,6,5,311,322,1
TDRD7,2,1,319,322,1
TDRD12,5,4,313,322,1
TMEM19,10,9,303,322,1
IGLL1,17,16,289,322,1
TCP11X2,2,1,319,322,1
TMEM201,7,6,309,322,1
IGLV1-36,5,4,313,322,1
ERCC5,5,4,313,322,1
TCN1,6,5,311,322,1
ZNF215,5,4,313,322,1
IGLV10-54,5,4,313,322,1
TCHP,8,7,307,322,1
TCFL5,3,2,317,322,1
IGLV2-11,5,4,313,322,1
TRAIP,9,8,305,322,1
SSR4,8,7,307,322,1
EIF2D,9,8,305,322,1
FBXO40,1,0,321,322,1
KMT5C,13,12,297,322,1
G6PC2,4,3,315,322,1
ZBED6CL,4,3,315,322,1
SLITRK2,3,2,317,322,1
DUSP26,6,5,311,322,1
SLK,7,6,309,322,1
ADAMTS1,12,11,299,322,1
TSHR,4,3,315,322,1
DUSP28,6,5,311,322,1
TSEN54,7,6,309,322,1
C11orf53,3,2,317,322,1
FILIP1,4,3,315,322,1
TSEN2,4,3,315,322,1
C11orf45,8,7,307,322,1
SLFN14,2,1,319,322,1
TSHZ2,5,4,313,322,1
TRIM65,6,5,311,322,1
HEBP1,4,3,315,322,1
SLC7A13,1,0,321,322,1
TSPY9P,1,0,321,322,1
TSPY8,1,0,321,322,1
TSPY4,1,0,321,322,1
TSPY3,1,0,321,322,1
TSPY2,1,0,321,322,1
C12orf29,7,6,309,322,1
ZNF598,5,4,313,322,1
G0S2,13,12,297,322,1
ANKRD29,6,5,311,322,1
HELB,6,5,311,322,1
ANKRD30BL,4,3,315,322,1
SLCO3A1,8,7,307,322,1
ZBED4,6,5,311,322,1
DUSP6,16,15,291,322,1
ZBTB2,5,4,313,322,1
FIGLA,3,2,317,322,1
KLHL23,6,5,311,322,1
DYNC1LI1,7,6,309,322,1
BTNL3,1,0,321,322,1
SMIM1,33,32,257,322,1
KLHL35,11,10,301,322,1
DYNC2H1,7,6,309,322,1
SMIM17,5,4,313,322,1
SMIM2,12,11,299,322,1
TSBP1,2,1,319,322,1
TRIM77,1,0,321,322,1
BTN3A1,6,5,311,322,1
SMIM26,9,8,305,322,1
GABRD,8,7,307,322,1
KLHDC7B,3,2,317,322,1
SMIM42,5,4,313,322,1
FA2H,19,18,285,322,1
GLA,7,6,309,322,1
KLHL6,1,0,321,322,1
KLHL9,7,6,309,322,1
KLK1,15,14,293,322,1
SMARCD1,9,8,305,322,1
GABRA4,1,0,321,322,1
TRMT44,6,5,311,322,1
FABP1,5,4,313,322,1
GABRA3,2,1,319,322,1
ADAM21,7,6,309,322,1
C10orf71,1,0,321,322,1
ADAM23,11,10,301,322,1
ZNF574,13,12,297,322,1
HEYL,3,2,317,322,1
FADS6,9,8,305,322,1
ARNTL2,3,2,317,322,1
KRIT1,6,5,311,322,1
KRR1,7,6,309,322,1
GLOD4,9,8,305,322,1
SLC35F4,2,1,319,322,1
ABCD2,4,3,315,322,1
TUBB6,12,11,299,322,1
SLC35A5,8,7,307,322,1
ANGEL2,4,3,315,322,1
SLC35B4,3,2,317,322,1
KRT80,2,1,319,322,1
FBXO36,6,5,311,322,1
TTLL4,8,7,307,322,1
ADARB1,28,27,267,322,1
ANGPT4,2,1,319,322,1
SLC36A3,2,1,319,322,1
FXYD5,7,6,309,322,1
TUB,9,8,305,322,1
TTPA,6,5,311,322,1
KRTAP10-12,2,1,319,322,1
ADAT2,2,1,319,322,1
SLC30A10,3,2,317,322,1
FAM133B,7,6,309,322,1
SLC2A4RG,8,7,307,322,1
TUBGCP2,7,6,309,322,1
HAPLN2,8,7,307,322,1
ANAPC10,9,8,305,322,1
ADAT3,15,14,293,322,1
SLC27A6,3,2,317,322,1
C19orf25,6,5,311,322,1
KRTAP13-3,1,0,321,322,1
TUNAR,2,1,319,322,1
SLC26A2,4,3,315,322,1
KRTAP16-1,1,0,321,322,1
ZNF662,3,2,317,322,1
SLC25A45,5,4,313,322,1
KRT73,2,1,319,322,1
ADAMTSL3,1,0,321,322,1
SLC7A1,5,4,313,322,1
TSTD2,5,4,313,322,1
TTC22,4,3,315,322,1
C13orf42,1,0,321,322,1
FZD4,1,0,321,322,1
SLC66A1,7,6,309,322,1
SLC66A2,5,4,313,322,1
ADAMTS8,2,1,319,322,1
C12orf57,11,10,301,322,1
YOD1,6,5,311,322,1
KRT10,3,2,317,322,1
SLC6A4,4,3,315,322,1
TSR1,4,3,315,322,1
ZNF614,8,7,307,322,1
C12orf45,5,4,313,322,1
KRT1,1,0,321,322,1
SLC4A9,2,1,319,322,1
FAM114A1,5,4,313,322,1
ANKRA2,5,4,313,322,1
HDAC10,9,8,305,322,1
HCRTR1,9,8,305,322,1
KRT25,1,0,321,322,1
KRT3,4,3,315,322,1
SLC46A3,5,4,313,322,1
SLC46A1,9,8,305,322,1
KRT33B,4,3,315,322,1
ANKMY1,12,11,299,322,1
HCN1,1,0,321,322,1
C15orf65,17,16,289,322,1
KRT37,2,1,319,322,1
TTC6,8,7,307,322,1
SLC39A12,1,0,321,322,1
KRT7,8,7,307,322,1
SMKR1,11,10,301,322,1
ZC3H12D,3,2,317,322,1
SSNA1,11,10,301,322,1
KCNJ1,5,4,313,322,1
KCNJ5,4,3,315,322,1
TRAV27,1,0,321,322,1
ZNF497,16,15,291,322,1
SPIRE2,5,4,313,322,1
SPN,3,2,317,322,1
TRAV26-1,2,1,319,322,1
SPP2,1,0,321,322,1
BIRC7,8,7,307,322,1
ZCCHC7,4,3,315,322,1
SPRED1,5,4,313,322,1
SPRR1B,3,2,317,322,1
KCNH4,1,0,321,322,1
TRAV1-1,6,5,311,322,1
KCNH2,3,2,317,322,1
KCNJ6,6,5,311,322,1
BLCAP,8,7,307,322,1
SMN1,6,5,311,322,1
BMP3,3,2,317,322,1
TRBJ1-5,1,0,321,322,1
TRBJ1-4,2,1,319,322,1
TRBJ1-3,2,1,319,322,1
HNRNPCL3,2,1,319,322,1
KCNT1,2,1,319,322,1
TRAV8-6,1,0,321,322,1
SPDL1,9,8,305,322,1
BLK,2,1,319,322,1
BMP10,1,0,321,322,1
BLOC1S6,6,5,311,322,1
EXOSC2,4,3,315,322,1
KCNK12,4,3,315,322,1
FHAD1,9,8,305,322,1
TRAV40,2,1,319,322,1
KCNG4,4,3,315,322,1
KCNG3,5,4,313,322,1
SPRR5,2,1,319,322,1
TRAJ35,1,0,321,322,1
SRP72,6,5,311,322,1
TRAJ41,1,0,321,322,1
TRAJ40,2,1,319,322,1
TRAJ39,1,0,321,322,1
SRPX,8,7,307,322,1
KAT7,10,9,303,322,1
KASH5,7,6,309,322,1
SPRY3,3,2,317,322,1
KANTR,4,3,315,322,1
TRAJ30,1,0,321,322,1
SRSF7,9,8,305,322,1
ABRAXAS1,5,4,313,322,1
JMJD7,9,8,305,322,1
TRAJ22,2,1,319,322,1
SRFBP1,2,1,319,322,1
EGFL6,1,0,321,322,1
AP4M1,10,9,303,322,1
KCNA1,2,1,319,322,1
KCNA10,3,2,317,322,1
SRD5A3,5,4,313,322,1
KCNAB3,3,2,317,322,1
GJA3,3,2,317,322,1
BEST4,8,7,307,322,1
KCNC2,1,0,321,322,1
KCNC3,4,3,315,322,1
TRAPPC11,6,5,311,322,1
ZNF486,6,5,311,322,1
BFSP1,9,8,305,322,1
SPSB4,5,4,313,322,1
ZCCHC8,4,3,315,322,1
GALE,12,11,299,322,1
TRBV18,2,1,319,322,1
EEF1E1-BLOC1S5,28,27,267,322,1
ZCCHC17,7,6,309,322,1
EBPL,5,4,313,322,1
ANXA2,6,5,311,322,1
GJC3,12,11,299,322,1
EBF3,4,3,315,322,1
HLF,4,3,315,322,1
ANXA8L1,6,5,311,322,1
KIF4A,5,4,313,322,1
ANXA9,6,5,311,322,1
ABHD6,9,8,305,322,1
SNX13,6,5,311,322,1
BRDT,24,23,275,322,1
HMGA2,9,8,305,322,1
GJB5,3,2,317,322,1
KIF13B,5,4,313,322,1
TRGV1,23,22,277,322,1
BRS3,3,2,317,322,1
KIR3DL1,1,0,321,322,1
ZC3H8,4,3,315,322,1
SNAP25,18,17,287,322,1
ZNF541,2,1,319,322,1
TRIM41,6,5,311,322,1
BSN,7,6,309,322,1
SMYD2,7,6,309,322,1
HLA-DOA,2,1,319,322,1
KLF11,9,8,305,322,1
TRIM5,6,5,311,322,1
SMR3B,1,0,321,322,1
ZNF547,12,11,299,322,1
SMOX,12,11,299,322,1
TRIM60,4,3,315,322,1
GJE1,2,1,319,322,1
ZNF548,6,5,311,322,1
TRGJP1,1,0,321,322,1
TRGJP,1,0,321,322,1
TRBV24-1,10,9,303,322,1
SPAG4,19,18,285,322,1
ZCCHC13,1,0,321,322,1
HMSD,15,14,293,322,1
BOLA2-SMG1P6,10,9,303,322,1
HMX1,7,6,309,322,1
SPACA5B,2,1,319,322,1
ZNF524,13,12,297,322,1
TRBV6-2,2,1,319,322,1
FHL3,9,8,305,322,1
GJB4,6,5,311,322,1
GAGE12E,11,10,301,322,1
EXOSC7,7,6,309,322,1
SPANXC,16,15,291,322,1
KCTD8,5,4,313,322,1
ZNF518A,6,5,311,322,1
GAGE12B,12,11,299,322,1
AP1S3,4,3,315,322,1
HMHB1,6,5,311,322,1
BOP1,8,7,307,322,1
EDEM2,8,7,307,322,1
SOX7,4,3,315,322,1
KEAP1,11,10,301,322,1
KERA,1,0,321,322,1
SOSTDC1,3,2,317,322,1
BPIFA3,1,0,321,322,1
TREM2,6,5,311,322,1
BPIFB2,1,0,321,322,1
KIAA0319L,5,4,313,322,1
TREML2,2,1,319,322,1
KIAA1191,5,4,313,322,1
TRGC1,2,1,319,322,1
TRGC2,7,6,309,322,1
EPHA8,5,4,313,322,1
SLC7A4,6,5,311,322,1
CTC1,10,9,303,322,1
NOC3L,5,4,313,322,1
MS4A6A,11,10,301,322,1
RBM47,9,8,305,322,1
NANS,6,5,311,322,1
MRTFA,12,11,299,322,1
OR2AG2,3,2,317,322,1
PDE7B,2,1,319,322,1
PDZRN4,3,2,317,322,1
NAP1L2,3,2,317,322,1
CKMT1B,15,14,293,322,1
PAIP2B,3,2,317,322,1
COA6,6,5,311,322,1
MCCC2,6,5,311,322,1
RBM3,7,6,309,322,1
PADI2,2,1,319,322,1
PADI1,1,0,321,322,1
DEPDC1,6,5,311,322,1
OR52E8,2,1,319,322,1
PRAMEF2,1,0,321,322,1
RBM5,7,6,309,322,1
MS4A8,2,1,319,322,1
CR2,6,5,311,322,1
PEAK3,9,8,305,322,1
OC90,1,0,321,322,1
OPN1MW,4,3,315,322,1
PAPLN,5,4,313,322,1
OR51G1,1,0,321,322,1
DEUP1,11,10,301,322,1
CCP110,5,4,313,322,1
PPP1R1C,11,10,301,322,1
OR1I1,3,2,317,322,1
CCR4,2,1,319,322,1
PPP2R5B,10,9,303,322,1
NRTN,21,20,281,322,1
PALMD,2,1,319,322,1
PPP1R3G,5,4,313,322,1
CWC25,3,2,317,322,1
CSPG4,2,1,319,322,1
PALD1,5,4,313,322,1
PIP,8,7,307,322,1
PPP2R5A,5,4,313,322,1
MCM10,6,5,311,322,1
CCZ1,10,9,303,322,1
PRAMEF4,1,0,321,322,1
DBNDD2,10,9,303,322,1
RASGRP4,4,3,315,322,1
DAZ4,1,0,321,322,1
CRNN,4,3,315,322,1
PGM2L1,3,2,317,322,1
P2RY12,3,2,317,322,1
MRPL2,10,9,303,322,1
NEXMIF,3,2,317,322,1
RASD2,3,2,317,322,1
CEP135,3,2,317,322,1
OR52H1,6,5,311,322,1
NOTCH2NLB,32,31,259,322,1
CLCN2,5,4,313,322,1
P2RX5-TAX1BP3,4,3,315,322,1
CEP126,3,2,317,322,1
CRB1,7,6,309,322,1
OR56A5,6,5,311,322,1
ME1,2,1,319,322,1
OR56B1,1,0,321,322,1
MCTP1,4,3,315,322,1
OR52N2,1,0,321,322,1
CEP170B,4,3,315,322,1
NRK,2,1,319,322,1
NAPEPLD,7,6,309,322,1
PRAMEF6,1,0,321,322,1
RBKS,7,6,309,322,1
PGLYRP2,2,1,319,322,1
PRB1,7,6,309,322,1
CUL2,5,4,313,322,1
RBBP9,4,3,315,322,1
DENND4C,7,6,309,322,1
CPA6,1,0,321,322,1
CRP,3,2,317,322,1
PDZD3,3,2,317,322,1
PRDX2,20,19,283,322,1
PIK3C2G,1,0,321,322,1
CEP41,4,3,315,322,1
COQ10B,8,7,307,322,1
OR52J3,1,0,321,322,1
NATD1,4,3,315,322,1
CNTN4,4,3,315,322,1
MBD3L4,3,2,317,322,1
CTXND1,5,4,313,322,1
POTEJ,5,4,313,322,1
OR4K15,3,2,317,322,1
PDE4B,11,10,301,322,1
NLN,9,8,305,322,1
PAX9,3,2,317,322,1
POTEB2,1,0,321,322,1
DGKK,1,0,321,322,1
POTEG,9,8,305,322,1
MTHFS,8,7,307,322,1
RET,8,7,307,322,1
PON2,10,9,303,322,1
CHAC2,9,8,305,322,1
POU2F3,9,8,305,322,1
MTG2,4,3,315,322,1
OR4M2B,2,1,319,322,1
POU4F1,7,6,309,322,1
RER1,8,7,307,322,1
OR2G6,5,4,313,322,1
POU4F2,3,2,317,322,1
POP7,9,8,305,322,1
PON1,4,3,315,322,1
OR51D1,1,0,321,322,1
NUP107,5,4,313,322,1
PECAM1,2,1,319,322,1
PCBD2,4,3,315,322,1
CSAG1,10,9,303,322,1
CSAD,5,4,313,322,1
POLR2K,12,11,299,322,1
CPVL,9,8,305,322,1
POLR3B,3,2,317,322,1
PKHD1L1,1,0,321,322,1
CHD6,5,4,313,322,1
CHCHD5,5,4,313,322,1
OR4K1,2,1,319,322,1
RFNG,12,11,299,322,1
NFKBIA,9,8,305,322,1
CNOT2,12,11,299,322,1
OR4K13,1,0,321,322,1
NLGN4Y,4,3,315,322,1
RFFL,10,9,303,322,1
POMGNT2,9,8,305,322,1
OR4N5,3,2,317,322,1
PKD1L1,6,5,311,322,1
MARVELD1,3,2,317,322,1
DGAT2L6,3,2,317,322,1
NAGA,9,8,305,322,1
CPA4,2,1,319,322,1
OR51B4,6,5,311,322,1
CFHR1,5,4,313,322,1
CYP4Z1,1,0,321,322,1
MAVS,5,4,313,322,1
OR51C1P,1,0,321,322,1
CYRIB,7,6,309,322,1
RCOR1,6,5,311,322,1
CCNG2,10,9,303,322,1
PAQR7,6,5,311,322,1
CFAP58,10,9,303,322,1
CX3CR1,4,3,315,322,1
MB21D2,5,4,313,322,1
MBD2,4,3,315,322,1
MSTO1,8,7,307,322,1
COX11,7,6,309,322,1
RCCD1,6,5,311,322,1
CFHR4,7,6,309,322,1
PITPNM2,9,8,305,322,1
PARP12,8,7,307,322,1
OR4X2,3,2,317,322,1
MTERF4,8,7,307,322,1
OPRPN,3,2,317,322,1
CITED2,12,11,299,322,1
OR10T2,1,0,321,322,1
NLRP2B,2,1,319,322,1
PPARD,4,3,315,322,1
PITX3,9,8,305,322,1
OPRL1,3,2,317,322,1
RELA,12,11,299,322,1
NLRP3,1,0,321,322,1
CYP4B1,3,2,317,322,1
PPEF2,6,5,311,322,1
PITRM1,9,8,305,322,1
DGCR8,7,6,309,322,1
NT5DC3,2,1,319,322,1
PPHLN1,14,13,295,322,1
PARP14,4,3,315,322,1
NDUFAF3,7,6,309,322,1
PRM1,10,9,303,322,1
CNNM1,2,1,319,322,1
MMP24,9,8,305,322,1
OIP5,6,5,311,322,1
CPSF2,6,5,311,322,1
ODF3,6,5,311,322,1
PSMB9,11,10,301,322,1
NUDCD2,5,4,313,322,1
MMS19,10,9,303,322,1
OR9A2,4,3,315,322,1
CDR1,19,18,285,322,1
METTL4,8,7,307,322,1
OR6B1,1,0,321,322,1
NCKAP5,8,7,307,322,1
MMP11,13,12,297,322,1
OR6C2,1,0,321,322,1
MMD,7,6,309,322,1
CDC34,11,10,301,322,1
CTPS1,5,4,313,322,1
OR8G5,2,1,319,322,1
PHKA2,3,2,317,322,1
NSMCE4A,8,7,307,322,1
RAB2B,4,3,315,322,1
OR5K4,2,1,319,322,1
MET,5,4,313,322,1
PRXL2C,2,1,319,322,1
NPHS2,1,0,321,322,1
PRY2,1,0,321,322,1
MOGAT1,10,9,303,322,1
OR5M11,1,0,321,322,1
ORC6,4,3,315,322,1
OR5M3,1,0,321,322,1
ORC3,5,4,313,322,1
DEFB105A,1,0,321,322,1
DEFB104A,1,0,321,322,1
CTH,4,3,315,322,1
CPB1,10,9,303,322,1
CLRN2,2,1,319,322,1
PSG5,4,3,315,322,1
PSG7,6,5,311,322,1
PSG8,11,10,301,322,1
RAB37,4,3,315,322,1
CDY2A,1,0,321,322,1
CREBL2,3,2,317,322,1
OR6C76,1,0,321,322,1
MFAP2,9,8,305,322,1
CST7,10,9,303,322,1
OR7D4,2,1,319,322,1
OR7D2,3,2,317,322,1
PTPRA,9,8,305,322,1
MICU2,5,4,313,322,1
MICOS10,6,5,311,322,1
NEUROD4,2,1,319,322,1
PTPRQ,9,8,305,322,1
MFSD8,7,6,309,322,1
PTS,8,7,307,322,1
DDI2,5,4,313,322,1
CRELD2,9,8,305,322,1
CDCP1,3,2,317,322,1
MGLL,7,6,309,322,1
CDH13,2,1,319,322,1
NUDT14,15,14,293,322,1
CLSPN,3,2,317,322,1
PUS1,5,4,313,322,1
OR6T1,1,0,321,322,1
PYURF,8,7,307,322,1
CDC6,7,6,309,322,1
MIER3,9,8,305,322,1
CDK1,11,10,301,322,1
CLSTN2,1,0,321,322,1
CDC40,4,3,315,322,1
QSOX2,6,5,311,322,1
PHF20,6,5,311,322,1
PTGDR,1,0,321,322,1
PTGDR2,12,11,299,322,1
OR6F1,2,1,319,322,1
OR8B8,1,0,321,322,1
DDT,9,8,305,322,1
OR8B12,2,1,319,322,1
QRSL1,4,3,315,322,1
CDK2,7,6,309,322,1
CDK14,8,7,307,322,1
MFF,8,7,307,322,1
OGFOD2,5,4,313,322,1
MFN1,4,3,315,322,1
OR6N1,1,0,321,322,1
PRSS58,1,0,321,322,1
DCHS2,2,1,319,322,1
ONECUT3,3,2,317,322,1
OCM,13,12,297,322,1
NDUFA9,6,5,311,322,1
CTXN3,1,0,321,322,1
OR12D2,1,0,321,322,1
RAMP2,25,24,273,322,1
NOX5,2,1,319,322,1
MED21,9,8,305,322,1
DEFB127,2,1,319,322,1
OR12D3,1,0,321,322,1
DCAF15,10,9,303,322,1
OR2F2,1,0,321,322,1
OTX2,4,3,315,322,1
MED6,5,4,313,322,1
CRLF3,7,6,309,322,1
PRPS2,5,4,313,322,1
PRPSAP2,12,11,299,322,1
RAG2,15,14,293,322,1
CD3G,7,6,309,322,1
COL4A4,3,2,317,322,1
MREG,4,3,315,322,1
CENPH,6,5,311,322,1
CLDN16,6,5,311,322,1
MRGPRX4,1,0,321,322,1
CENPT,9,8,305,322,1
CD2AP,4,3,315,322,1
OMP,48,47,227,322,1
MECR,7,6,309,322,1
CD300C,5,4,313,322,1
PDHA1,7,6,309,322,1
DBT,3,2,317,322,1
PROCR,6,5,311,322,1
OR5A2,1,0,321,322,1
CD36,10,9,303,322,1
CD300LF,2,1,319,322,1
DBX1,2,1,319,322,1
NOX1,6,5,311,322,1
OXCT1,7,6,309,322,1
NOX3,1,0,321,322,1
PROP1,2,1,319,322,1
MRGPRE,1,0,321,322,1
MRGPRD,2,1,319,322,1
MPPE1,7,6,309,322,1
NPY5R,2,1,319,322,1
DCAF8L1,1,0,321,322,1
PHRF1,9,8,305,322,1
MPC2,6,5,311,322,1
PHYHIP,7,6,309,322,1
PHYHD1,13,12,297,322,1
MEIOB,8,7,307,322,1
OR5H14,4,3,315,322,1
MOSPD1,5,4,313,322,1
MOS,2,1,319,322,1
NCBP2L,4,3,315,322,1
PRSS21,7,6,309,322,1
MED8,5,4,313,322,1
OSGEPL1,6,5,311,322,1
CEBPA,2,1,319,322,1
PRSS3,16,15,291,322,1
CD8A,4,3,315,322,1
MEOX1,6,5,311,322,1
PRSS41,8,7,307,322,1
PRSS50,5,4,313,322,1
PRSS51,4,3,315,322,1
CD6,6,5,311,322,1
DEFB113,2,1,319,322,1
CELF1,4,3,315,322,1
CD5L,1,0,321,322,1
OR1L8,2,1,319,322,1
CD47,9,8,305,322,1
OR2B11,4,3,315,322,1
MED9,7,6,309,322,1
OR2F1,1,0,321,322,1
COL5A2,5,4,313,322,1
CLTRN,7,6,309,322,1
COL5A3,1,0,321,322,1
OMD,4,3,315,322,1
PRR19,6,5,311,322,1
CRISP2,1,0,321,322,1
OR1K1,4,3,315,322,1
PRR23B,1,0,321,322,1
PRR23C,3,2,317,322,1
MPP1,6,5,311,322,1
PRR30,2,1,319,322,1
MPHOSPH10,7,6,309,322,1
PCBP3,9,8,305,322,1
CLDN25,3,2,317,322,1
OR10G8,1,0,321,322,1
PMFBP1,11,10,301,322,1
OR2T6,1,0,321,322,1
DIAPH3,4,3,315,322,1
MYF5,1,0,321,322,1
OR10K2,1,0,321,322,1
CCL3,16,15,291,322,1
RIMS4,5,4,313,322,1
CCDC80,6,5,311,322,1
RNASE1,13,12,297,322,1
PEX16,12,11,299,322,1
CINP,5,4,313,322,1
COPG2,9,8,305,322,1
OR2L5,4,3,315,322,1
NT5C3A,5,4,313,322,1
PLA2G4D,2,1,319,322,1
PCDHA2,3,2,317,322,1
NEGR1,3,2,317,322,1
CMTM8,8,7,307,322,1
OR4D11,1,0,321,322,1
RING1,5,4,313,322,1
CXorf49,5,4,313,322,1
PLD4,7,6,309,322,1
CIDEA,7,6,309,322,1
MUC19,8,7,307,322,1
RIMBP3,23,22,277,322,1
CCL4,17,16,289,322,1
MYF6,2,1,319,322,1
NUP58,5,4,313,322,1
NRDE2,16,15,291,322,1
CXorf38,4,3,315,322,1
MYO3A,2,1,319,322,1
NKTR,8,7,307,322,1
DHX37,5,4,313,322,1
CTAG2,9,8,305,322,1
CLHC1,12,11,299,322,1
MUC3A,4,3,315,322,1
CYP1A2,4,3,315,322,1
PDCD1LG2,4,3,315,322,1
PCDHB8,5,4,313,322,1
MUC1,13,12,297,322,1
NFS1,5,4,313,322,1
OR2T29,2,1,319,322,1
PCLO,6,5,311,322,1
PLAAT5,3,2,317,322,1
CCDC86,6,5,311,322,1
CCDC85C,8,7,307,322,1
MYO15B,14,13,295,322,1
PLEKHG6,9,8,305,322,1
OR2T3,1,0,321,322,1
PDCD10,7,6,309,322,1
MZT1,8,7,307,322,1
CYB5A,11,10,301,322,1
MYADM,4,3,315,322,1
CCL18,2,1,319,322,1
CIITA,3,2,317,322,1
MAP9,7,6,309,322,1
PLET1,5,4,313,322,1
RGS9BP,3,2,317,322,1
RIPK1,2,1,319,322,1
MYBL2,11,10,301,322,1
PLAC8,6,5,311,322,1
RMDN2,4,3,315,322,1
MYBBP1A,8,7,307,322,1
NUP54,6,5,311,322,1
RMDN1,4,3,315,322,1
OR4C5,1,0,321,322,1
PNPT1,4,3,315,322,1
PLPP4,2,1,319,322,1
PCID2,5,4,313,322,1
CHMP4C,3,2,317,322,1
DIO2,11,10,301,322,1
PCDHA7,4,3,315,322,1
CHRNB3,4,3,315,322,1
DHTKD1,5,4,313,322,1
MANEA,7,6,309,322,1
PLA2G2E,3,2,317,322,1
OR4C13,1,0,321,322,1
MYH8,2,1,319,322,1
DIMT1,8,7,307,322,1
MTRR,8,7,307,322,1
POLL,10,9,303,322,1
CXorf66,1,0,321,322,1
PLCXD3,2,1,319,322,1
PCCA,7,6,309,322,1
CLEC7A,9,8,305,322,1
NRBF2,6,5,311,322,1
PCCB,8,7,307,322,1
RGN,9,8,305,322,1
NEFL,5,4,313,322,1
POLR1C,7,6,309,322,1
CYP2A13,2,1,319,322,1
CIBAR1,10,9,303,322,1
OR10AG1,1,0,321,322,1
OR1D5,3,2,317,322,1
PDE1A,5,4,313,322,1
OR4A15,1,0,321,322,1
RIF1,6,5,311,322,1
CCKAR,4,3,315,322,1
OR2M4,1,0,321,322,1
OR10AD1,3,2,317,322,1
NGFR,7,6,309,322,1
CYB5RL,6,5,311,322,1
OR3A1,3,2,317,322,1
CHURC1,9,8,305,322,1
RHPN2,6,5,311,322,1
MAMLD1,6,5,311,322,1
CCKBR,7,6,309,322,1
MYOG,3,2,317,322,1
MAPKBP1,13,12,297,322,1
NECAP1,8,7,307,322,1
POLR1G,8,7,307,322,1
OR2M3,3,2,317,322,1
RHOQ,9,8,305,322,1
POLR1E,5,4,313,322,1
NUP43,3,2,317,322,1
RNASET2,5,4,313,322,1
CSMD3,1,0,321,322,1
OR10J1,2,1,319,322,1
CHST12,8,7,307,322,1
PCDHGB2,4,3,315,322,1
NUP160,5,4,313,322,1
PCDH17,1,0,321,322,1
RNASEH2A,7,6,309,322,1
HRNR,0,0,322,322,0
TMEM243,5,5,312,322,0
SP110,2,2,318,322,0
PRSS22,8,8,306,322,0
SPTBN4,3,3,316,322,0
PRSS23,8,8,306,322,0
MYLK,1,1,320,322,0
PCDHGB6,2,2,318,322,0
KDM4F,0,0,322,322,0
NPHP1,8,8,306,322,0
KDR,0,0,322,322,0
TRPM1,2,2,318,322,0
IGHD3-10,0,0,322,322,0
SPTBN5,4,4,314,322,0
OR13A1,2,2,318,322,0
BPHL,6,6,310,322,0
CENPN,4,4,314,322,0
MORN3,3,3,316,322,0
TOX,3,3,316,322,0
PLPPR4,4,4,314,322,0
SOX17,0,0,322,322,0
IGHD6-6,0,0,322,322,0
SPINK5,4,4,314,322,0
AGBL4,3,3,316,322,0
ZNF341,7,7,308,322,0
CRLS1,7,7,308,322,0
NPFF,30,30,262,322,0
IGFBP1,4,4,314,322,0
ARHGEF1,8,8,306,322,0
SPAG17,8,8,306,322,0
TMEM233,2,2,318,322,0
GPRC5C,10,10,302,322,0
EPN3,9,9,304,322,0
BIN3,10,10,302,322,0
ANKRD6,16,16,290,322,0
FGF14,0,0,322,322,0
KCNE1B,14,14,294,322,0
MORN4,5,5,312,322,0
SPNS3,2,2,318,322,0
GPR155,4,4,314,322,0
CLUAP1,11,11,300,322,0
IGHD3-3,0,0,322,322,0
IGHD7-27,0,0,322,322,0
PRSS54,1,1,320,322,0
FSTL3,6,6,310,322,0
BPIFB3,0,0,322,322,0
PLIN2,8,8,306,322,0
BPIFB4,1,1,320,322,0
TMEM229A,2,2,318,322,0
PLXDC2,2,2,318,322,0
BPIFB6,0,0,322,322,0
OR10G7,0,0,322,322,0
TP53I3,6,6,310,322,0
PROB1,5,5,312,322,0
KIAA1143,3,3,316,322,0
GPR149,0,0,322,322,0
DCLRE1A,5,5,312,322,0
CEACAM7,1,1,320,322,0
CEACAM4,2,2,318,322,0
OSBPL7,6,6,310,322,0
KIAA0232,7,7,308,322,0
VCX2,4,4,314,322,0
KHDRBS2,0,0,322,322,0
COQ2,7,7,308,322,0
IGHD3-9,0,0,322,322,0
PRSS37,8,8,306,322,0
EDDM3B,5,5,312,322,0
IGHD5-12,0,0,322,322,0
DCDC2C,3,3,316,322,0
ZNF750,6,6,310,322,0
BICC1,4,4,314,322,0
SORCS2,4,4,314,322,0
PLK2,5,5,312,322,0
OR2B3,2,2,318,322,0
BPIFA1,0,0,322,322,0
COL8A2,7,7,308,322,0
NPHP3,4,4,314,322,0
OR10G6,0,0,322,322,0
GPR78,1,1,320,322,0
ARHGDIB,5,5,312,322,0
CELA3A,6,6,310,322,0
SPANXB1,20,20,282,322,0
OR13F1,0,0,322,322,0
CRISP3,5,5,312,322,0
BHLHE23,6,6,310,322,0
BMP15,0,0,322,322,0
TINF2,10,10,302,322,0
EFCC1,4,4,314,322,0
IGHD6-19,0,0,322,322,0
VMAC,5,5,312,322,0
NOX4,5,5,312,322,0
GALNTL5,3,3,316,322,0
IGHD1OR15-1A,0,0,322,322,0
OTC,1,1,320,322,0
GPR33,0,0,322,322,0
FSHR,2,2,318,322,0
OR10G2,2,2,318,322,0
KCNS2,5,5,312,322,0
PRR23D1,3,3,316,322,0
CTU1,13,13,296,322,0
KCNMB1,4,4,314,322,0
NPBWR2,2,2,318,322,0
IGHD1-20,0,0,322,322,0
IGHD6-13,0,0,322,322,0
IGHD1-14,0,0,322,322,0
KCNH8,0,0,322,322,0
HAS1,9,9,304,322,0
ANKRD62,1,1,320,322,0
BLOC1S2,8,8,306,322,0
APOL1,2,2,318,322,0
SPESP1,1,1,320,322,0
IGHD1-26,0,0,322,322,0
IGHD1-1,0,0,322,322,0
IGHD,0,0,322,322,0
PLPPR2,9,9,304,322,0
KCNK17,1,1,320,322,0
GALNTL6,2,2,318,322,0
KCNK18,2,2,318,322,0
IGHD5OR15-5A,0,0,322,322,0
IGHD1-7,0,0,322,322,0
GPR45,8,8,306,322,0
CHRNA1,6,6,310,322,0
KCNV1,1,1,320,322,0
MYH3,2,2,318,322,0
VAV1,4,4,314,322,0
ZNF438,4,4,314,322,0
TOPAZ1,0,0,322,322,0
SPATA1,7,7,308,322,0
ICMT,3,3,316,322,0
CNGA2,0,0,322,322,0
MPEG1,4,4,314,322,0
IGHD5-18,0,0,322,322,0
PRPF39,9,9,304,322,0
TLCD3A,10,10,302,322,0
OR1Q1,4,4,314,322,0
IGHD6-25,0,0,322,322,0
NPAT,7,7,308,322,0
HAUS2,5,5,312,322,0
PDHA2,0,0,322,322,0
DBX2,1,1,320,322,0
MRGPRX2,0,0,322,322,0
KCNE3,5,5,312,322,0
SPATA17,7,7,308,322,0
OR13C3,2,2,318,322,0
BHMT,1,1,320,322,0
SPATA31A5,0,0,322,322,0
VN1R4,0,0,322,322,0
HAS3,7,7,308,322,0
SPATA31E1,0,0,322,322,0
SPATA31D4,0,0,322,322,0
SPPL2C,1,1,320,322,0
SPATA31D1,0,0,322,322,0
SPATA31A7,1,1,320,322,0
IGHD5-24,0,0,322,322,0
NTSR2,2,2,318,322,0
DCANP1,0,0,322,322,0
SPATA31A1,0,0,322,322,0
HEXD,11,11,300,322,0
CENPL,6,6,310,322,0
FSHB,0,0,322,322,0
PRR33,0,0,322,322,0
VNN3,2,2,318,322,0
DCAF12L2,0,0,322,322,0
HTR1A,0,0,322,322,0
SOAT2,5,5,312,322,0
WDR36,4,4,314,322,0
IDI1,7,7,308,322,0
PLD5,2,2,318,322,0
OR8B2,3,3,316,322,0
OR14C36,0,0,322,322,0
KLRF1,9,9,304,322,0
TMEM164,4,4,314,322,0
IFIT1,7,7,308,322,0
OR8A1,3,3,316,322,0
GPAT4,7,7,308,322,0
C11orf42,9,9,304,322,0
OR7G3,2,2,318,322,0
GPAM,6,6,310,322,0
OR10H3,0,0,322,322,0
APCDD1L,9,9,304,322,0
TMEM200B,2,2,318,322,0
SLITRK4,0,0,322,322,0
SLIT3,2,2,318,322,0
PHGR1,8,8,306,322,0
OGFOD3,4,4,314,322,0
PCP4,13,13,296,322,0
MINDY4B,0,0,322,322,0
GAB4,0,0,322,322,0
NHLRC1,10,10,302,322,0
WDR4,6,6,310,322,0
CDK5R2,4,4,314,322,0
ZNF587B,6,6,310,322,0
HOXD10,6,6,310,322,0
OR8G3P,0,0,322,322,0
BTNL9,4,4,314,322,0
PTAFR,4,4,314,322,0
TMEM128,4,4,314,322,0
SMCP,1,1,320,322,0
KLHL41,12,12,298,322,0
NHP2,10,10,302,322,0
WBP2NL,1,1,320,322,0
SMC6,9,9,304,322,0
PTCD1,6,6,310,322,0
PTCD2,5,5,312,322,0
DDHD2,9,9,304,322,0
OR10H2,0,0,322,322,0
TMEM203,8,8,306,322,0
HCK,1,1,320,322,0
IFNA13,2,2,318,322,0
OR8G1,0,0,322,322,0
C10orf120,0,0,322,322,0
NPIPB7,12,12,298,322,0
KLK3,4,4,314,322,0
KLK7,4,4,314,322,0
EPS8L3,1,1,320,322,0
OR8D2,2,2,318,322,0
ARL14EP,8,8,306,322,0
OR8D1,1,1,320,322,0
PTPDC1,2,2,318,322,0
OR10K1,2,2,318,322,0
HHLA1,1,1,320,322,0
WDR72,0,0,322,322,0
PTPRO,5,5,312,322,0
PTPRR,4,4,314,322,0
OR10J3,0,0,322,322,0
SLC6A5,0,0,322,322,0
PTRH1,4,4,314,322,0
DDX50,5,5,312,322,0
TMEM182,6,6,310,322,0
CDH22,2,2,318,322,0
SLC6A17,0,0,322,322,0
DUSP11,6,6,310,322,0
SLC6A14,1,1,320,322,0
TRMT61B,4,4,314,322,0
ERAL1,8,8,306,322,0
GBP2,1,1,320,322,0
SLC5A9,4,4,314,322,0
SLC5A8,1,1,320,322,0
ZNF582,8,8,306,322,0
CMTM3,13,13,296,322,0
TRMT6,5,5,312,322,0
SLC5A1,0,0,322,322,0
WDR87,0,0,322,322,0
ADH1A,0,0,322,322,0
KRT24,0,0,322,322,0
SLC4A7,7,7,308,322,0
FASTK,8,8,306,322,0
PTPRJ,2,2,318,322,0
DUSP14,9,9,304,322,0
KRBOX4,7,7,308,322,0
DDX25,4,4,314,322,0
SLCO4A1,3,3,316,322,0
KNTC1,4,4,314,322,0
SLCO1C1,4,4,314,322,0
NPM2,16,16,290,322,0
APBB3,7,7,308,322,0
CSMD2,3,3,316,322,0
TMEM176B,5,5,312,322,0
HOXB8,15,15,292,322,0
SLC9C2,4,4,314,322,0
FARSA,8,8,306,322,0
SLC9A9,19,19,284,322,0
FRMD7,0,0,322,322,0
DDX31,4,4,314,322,0
ADH5,9,9,304,322,0
SLC9A4,2,2,318,322,0
COQ8A,16,16,290,322,0
TMEM196,0,0,322,322,0
MYO5C,4,4,314,322,0
OR7C2,0,0,322,322,0
ZNF783,5,5,312,322,0
ZNF785,3,3,316,322,0
OR7A5,0,0,322,322,0
OR8H3,0,0,322,322,0
OR8J1,0,0,322,322,0
CIAPIN1,8,8,306,322,0
OR9K2,0,0,322,322,0
ANK3,8,8,306,322,0
CEACAM18,1,1,320,322,0
VSX2,2,2,318,322,0
MOCS1,5,5,312,322,0
BRIX1,5,5,312,322,0
TPCN1,4,4,314,322,0
OR9Q2,0,0,322,322,0
EBF1,0,0,322,322,0
OR9Q1,0,0,322,322,0
TMEM102,17,17,288,322,0
CDY2B,0,0,322,322,0
FSBP,4,4,314,322,0
AHR,3,3,316,322,0
ZNF334,4,4,314,322,0
KIR2DL3,1,1,320,322,0
BRSK1,13,13,296,322,0
FGF10,0,0,322,322,0
PSKH1,9,9,304,322,0
OR13G1,0,0,322,322,0
KIR3DL2,0,0,322,322,0
SNCG,19,19,284,322,0
KIR3DL3,1,1,320,322,0
SNCA,6,6,310,322,0
PSKH2,1,1,320,322,0
TPBGL,1,1,320,322,0
ZNF335,6,6,310,322,0
OR2C3,1,1,320,322,0
TRPC1,8,8,306,322,0
OLFML2A,4,4,314,322,0
ERF,11,11,300,322,0
VSIG1,4,4,314,322,0
PSAPL1,0,0,322,322,0
IFT88,5,5,312,322,0
EVC,7,7,308,322,0
FSCN2,5,5,312,322,0
GPR139,0,0,322,322,0
KIF19,1,1,320,322,0
CHST15,5,5,312,322,0
BRD9,8,8,306,322,0
ANHX,0,0,322,322,0
KIF2B,0,0,322,322,0
SNX15,7,7,308,322,0
FSCB,0,0,322,322,0
TTLL8,0,0,322,322,0
PSD4,4,4,314,322,0
NPIPA9,21,21,280,322,0
FAM90A9P,1,1,320,322,0
TTLL2,2,2,318,322,0
CEACAM19,7,7,308,322,0
ECE1,3,3,316,322,0
EVC2,0,0,322,322,0
PLEKHG7,4,4,314,322,0
CPM,6,6,310,322,0
TMEM218,7,7,308,322,0
OR9I1,0,0,322,322,0
HCAR1,3,3,316,322,0
MMP27,0,0,322,322,0
SMIM8,6,6,310,322,0
FRRS1,1,1,320,322,0
SMIM43,4,4,314,322,0
ADRB3,3,3,316,322,0
MMP26,0,0,322,322,0
TTF1,2,2,318,322,0
SMIM38,2,2,318,322,0
BTBD8,6,6,310,322,0
PSMD5,9,9,304,322,0
BTC,4,4,314,322,0
KLHL1,0,0,322,322,0
SNAPC2,10,10,302,322,0
MYRIP,0,0,322,322,0
PSMD6,10,10,302,322,0
MMP20,0,0,322,322,0
OR8U1,0,0,322,322,0
NPIPB13,26,26,270,322,0
KLHL17,6,6,310,322,0
PSMG3,6,6,310,322,0
OR8K5,0,0,322,322,0
BTNL2,3,3,316,322,0
OR8K1,0,0,322,322,0
FRMPD4,1,1,320,322,0
CYB561A3,3,3,316,322,0
PCYT2,8,8,306,322,0
MMP9,1,1,320,322,0
TROAP,12,12,298,322,0
VWA3B,2,2,318,322,0
CDY1B,0,0,322,322,0
CDY1,0,0,322,322,0
CDX4,0,0,322,322,0
FAM110D,7,7,308,322,0
ADTRP,16,16,290,322,0
FGD5,6,6,310,322,0
SMYD4,6,6,310,322,0
ARHGEF3,5,5,312,322,0
CLDN17,0,0,322,322,0
OR9G4,0,0,322,322,0
OR10G9,0,0,322,322,0
VWC2,0,0,322,322,0
OR9G1,0,0,322,322,0
PSMB8,7,7,308,322,0
SMR3A,0,0,322,322,0
E2F1,5,5,312,322,0
BTBD10,5,5,312,322,0
VWF,1,1,320,322,0
APH1B,4,4,314,322,0
VXN,16,16,290,322,0
ERCC6L2,7,7,308,322,0
IFNAR2,8,8,306,322,0
IGHJ1,0,0,322,322,0
UTS2B,11,11,300,322,0
TNR,0,0,322,322,0
TAS2R31,11,11,300,322,0
IL26,2,2,318,322,0
PCDHA10,3,3,316,322,0
CYP4F8,3,3,316,322,0
TAF1L,0,0,322,322,0
CKAP2,8,8,306,322,0
CYP4X1,2,2,318,322,0
ZNF621,3,3,316,322,0
UGT2B11,1,1,320,322,0
PNRC2,21,21,280,322,0
GTPBP3,6,6,310,322,0
OR1S2,0,0,322,322,0
UGT2B17,1,1,320,322,0
TAF11L8,3,3,316,322,0
GALNT17,5,5,312,322,0
CFH,1,1,320,322,0
TAF11L14,1,1,320,322,0
CYP8B1,1,1,320,322,0
CFC1B,1,1,320,322,0
ESM1,5,5,312,322,0
TMEM35B,7,7,308,322,0
ATP8B3,3,3,316,322,0
GTF3C6,7,7,308,322,0
TEX47,0,0,322,322,0
OPN1MW3,6,6,310,322,0
TACSTD2,3,3,316,322,0
NKD2,3,3,316,322,0
FUZ,11,11,300,322,0
UGT1A9,2,2,318,322,0
TANGO6,6,6,310,322,0
NAA40,6,6,310,322,0
TAS2R16,0,0,322,322,0
CSNKA2IP,0,0,322,322,0
PPCDC,9,9,304,322,0
ATP6V0A4,4,4,314,322,0
FAM166B,13,13,296,322,0
TEX13A,1,1,320,322,0
IL18R1,2,2,318,322,0
NLRP5,13,13,296,322,0
TAP2,6,6,310,322,0
MUC7,1,1,320,322,0
TEX13C,0,0,322,322,0
IGKJ2,0,0,322,322,0
ARHGAP1,5,5,312,322,0
PARP6,6,6,310,322,0
TEX13D,0,0,322,322,0
IGKV1-16,4,4,314,322,0
IL22RA2,1,1,320,322,0
PPFIBP2,15,15,292,322,0
ACADSB,3,3,316,322,0
CXCL9,0,0,322,322,0
IGKJ3,0,0,322,322,0
UGT1A5,4,4,314,322,0
TAF9,6,6,310,322,0
TACR3,0,0,322,322,0
GTF3C2,9,9,304,322,0
TEX48,5,5,312,322,0
FAM228A,17,17,288,322,0
TYROBP,18,18,286,322,0
TSPY1,0,0,322,322,0
ANKRD34C,0,0,322,322,0
N6AMT1,4,4,314,322,0
PPP1R17,7,7,308,322,0
HELZ2,2,2,318,322,0
CYP11B1,0,0,322,322,0
TFF3,6,6,310,322,0
SYNPR,9,9,304,322,0
OPLAH,9,9,304,322,0
TMPRSS2,3,3,316,322,0
IGHV3OR16-9,3,3,316,322,0
GALR1,0,0,322,322,0
DAAM2,3,3,316,322,0
UNC50,8,8,306,322,0
SYNGR4,18,18,286,322,0
UNC5A,3,3,316,322,0
TMPRSS5,11,11,300,322,0
PPP1R2B,2,2,318,322,0
PPP1R2C,0,0,322,322,0
OR10R2,1,1,320,322,0
PANX2,8,8,306,322,0
CFAP298-TCP10L,10,10,302,322,0
ZNF682,7,7,308,322,0
SYT10,0,0,322,322,0
AMELY,0,0,322,322,0
CYSLTR2,2,2,318,322,0
MUS81,11,11,300,322,0
TEX49,13,13,296,322,0
CNTLN,1,1,320,322,0
TAB3,3,3,316,322,0
ZNF672,11,11,300,322,0
TAAR5,0,0,322,322,0
TMEM35A,5,5,312,322,0
OR10W1,0,0,322,322,0
IL6R,3,3,316,322,0
IGHV8-51-1,0,0,322,322,0
PNPO,2,2,318,322,0
PKP3,9,9,304,322,0
TMPRSS11F,2,2,318,322,0
CYP11B2,0,0,322,322,0
SYT9,2,2,318,322,0
MSS51,8,8,306,322,0
SYT6,3,3,316,322,0
ILDR1,0,0,322,322,0
PPP1R14A,20,20,282,322,0
SYT2,1,1,320,322,0
AKR1E2,10,10,302,322,0
EMILIN2,2,2,318,322,0
CYP19A1,9,9,304,322,0
TFAP2D,1,1,320,322,0
PAPPA2,1,1,320,322,0
GUCA1C,2,2,318,322,0
ZNF655,6,6,310,322,0
FUT2,6,6,310,322,0
TAS2R40,1,1,320,322,0
MTMR9,3,3,316,322,0
ALG6,7,7,308,322,0
IGLV3-19,8,8,306,322,0
ATL1,8,8,306,322,0
NRG4,12,12,298,322,0
POM121L12,1,1,320,322,0
MTRNR2L7,4,4,314,322,0
ATL3,2,2,318,322,0
IGLV3-22,2,2,318,322,0
MTMR8,2,2,318,322,0
H2AP,27,27,268,322,0
TCAIM,4,4,314,322,0
ATP10A,12,12,298,322,0
TC2N,3,3,316,322,0
IGKV4-1,2,2,318,322,0
PBLD,5,5,312,322,0
TMEM63C,9,9,304,322,0
TMEM65,2,2,318,322,0
CSNK1A1L,0,0,322,322,0
HECW1,15,15,292,322,0
UBLCP1,6,6,310,322,0
H2BU1,5,5,312,322,0
FAM181A,5,5,312,322,0
PAXX,10,10,302,322,0
PCDH15,6,6,310,322,0
TCERG1L,0,0,322,322,0
EPB41L4A,9,9,304,322,0
PBX4,11,11,300,322,0
H2BC14,41,41,240,322,0
IGLJ1,1,1,320,322,0
TDP1,5,5,312,322,0
H2BC7,15,15,292,322,0
TDG,7,7,308,322,0
TDRD15,0,0,322,322,0
IGLJ4,0,0,322,322,0
IGLJ5,3,3,316,322,0
IGLJ6,3,3,316,322,0
ATG12,2,2,318,322,0
CYP2D7,15,15,292,322,0
TDRD5,0,0,322,322,0
PDE3A,2,2,318,322,0
IGLV3-1,7,7,308,322,0
CYP2S1,5,5,312,322,0
FYCO1,4,4,314,322,0
TDRD9,1,1,320,322,0
ARHGAP24,7,7,308,322,0
TCHHL1,0,0,322,322,0
POLR3G,8,8,306,322,0
EOLA2,8,8,306,322,0
POLR3H,9,9,304,322,0
IGLV2-14,7,7,308,322,0
POLR3K,5,5,312,322,0
TCF23,1,1,320,322,0
GABRA5,4,4,314,322,0
TELO2,10,10,302,322,0
ARHGAP26,3,3,316,322,0
MTFMT,5,5,312,322,0
IGSF9,7,7,308,322,0
ALX1,5,5,312,322,0
TBC1D21,0,0,322,322,0
UBXN6,10,10,302,322,0
GYPC,6,6,310,322,0
TMEM43,9,9,304,322,0
MTFR2,10,10,302,322,0
OR2A42,6,6,310,322,0
CYP1B1,7,7,308,322,0
MTFP1,12,12,298,322,0
FGF3,1,1,320,322,0
POU6F2,3,3,316,322,0
TENT5D,0,0,322,322,0
MUC22,0,0,322,322,0
CYP4A11,9,9,304,322,0
TMEM41B,7,7,308,322,0
TATDN1,8,8,306,322,0
TASL,4,4,314,322,0
NLRP13,0,0,322,322,0
HTR3A,1,1,320,322,0
TMEM87B,8,8,306,322,0
CNPY2,6,6,310,322,0
PKMYT1,11,11,300,322,0
ARHGAP18,2,2,318,322,0
GAP43,9,9,304,322,0
GYPE,6,6,310,322,0
CYP3A5,9,9,304,322,0
TMEM74,4,4,314,322,0
NLRC3,2,2,318,322,0
POTEC,8,8,306,322,0
POTED,4,4,314,322,0
OPTC,6,6,310,322,0
IGLV7-46,19,19,284,322,0
OR2A2,2,2,318,322,0
IGSF1,3,3,316,322,0
ANKRD30A,0,0,322,322,0
UBTD1,8,8,306,322,0
ALDH4A1,8,8,306,322,0
ANKRD30B,3,3,316,322,0
ATP1B4,2,2,318,322,0
IGKV1D-42,2,2,318,322,0
ATP23,5,5,312,322,0
TENM2,1,1,320,322,0
H2BW2,12,12,298,322,0
FGF4,1,1,320,322,0
CHAF1A,9,9,304,322,0
NLRC4,9,9,304,322,0
MTHFD1,6,6,310,322,0
ARHGAP27,4,4,314,322,0
ALPP,4,4,314,322,0
FAM167A,6,6,310,322,0
TBC1D25,6,6,310,322,0
PPP1R3B,3,3,316,322,0
AVPR2,4,4,314,322,0
FAM78B,7,7,308,322,0
STIMATE-MUSTN1,27,27,268,322,0
ST8SIA3,1,1,320,322,0
ASAH2B,2,2,318,322,0
ITPRID1,5,5,312,322,0
ITPRIP,10,10,302,322,0
CNGB1,9,9,304,322,0
NOS2,2,2,318,322,0
DAZ2,0,0,322,322,0
PRIM1,5,5,312,322,0
IVD,7,7,308,322,0
ST6GAL2,2,2,318,322,0
PRIM2,6,6,310,322,0
CLCA2,0,0,322,322,0
DAZ3,0,0,322,322,0
PRIMPOL,5,5,312,322,0
FLG,0,0,322,322,0
CLCA4,0,0,322,322,0
PIGR,1,1,320,322,0
BCKDHA,13,13,296,322,0
IGHV1-46,2,2,318,322,0
P2RY6,3,3,316,322,0
ETS1,6,6,310,322,0
P2RY4,7,7,308,322,0
MRPL22,5,5,312,322,0
FAM71B,0,0,322,322,0
BCKDHB,7,7,308,322,0
NOP2,8,8,306,322,0
STAB1,18,18,286,322,0
STAC2,8,8,306,322,0
THSD4,7,7,308,322,0
PABPC1L,7,7,308,322,0
FAM47B,0,0,322,322,0
TNFRSF8,2,2,318,322,0
STBD1,9,9,304,322,0
CYHR1,5,5,312,322,0
OR11H12,4,4,314,322,0
BBS1,15,15,292,322,0
TNFSF10,11,11,300,322,0
AMY1B,4,4,314,322,0
MYCBP,9,9,304,322,0
EIF4EBP1,7,7,308,322,0
BBS12,6,6,310,322,0
MRPL40,8,8,306,322,0
PREB,9,9,304,322,0
FAM47E,4,4,314,322,0
ETFRF1,14,14,294,322,0
DAZ1,0,0,322,322,0
CUL1,6,6,310,322,0
PRELID2,3,3,316,322,0
COG3,15,15,292,322,0
CEP290,5,5,312,322,0
ITIH6,2,2,318,322,0
ITLN1,2,2,318,322,0
PIH1D1,11,11,300,322,0
CYBB,0,0,322,322,0
PRKACG,0,0,322,322,0
SSU72P2,17,17,288,322,0
TUFT1,4,4,314,322,0
ZNF711,5,5,312,322,0
IGHM,0,0,322,322,0
APOLD1,5,5,312,322,0
APOL6,2,2,318,322,0
KAT14,5,5,312,322,0
MROH1,9,9,304,322,0
IGHJ6,0,0,322,322,0
SRR,12,12,298,322,0
FAM76B,7,7,308,322,0
HS3ST4,1,1,320,322,0
CUBN,1,1,320,322,0
UXS1,7,7,308,322,0
MROH2B,0,0,322,322,0
MRM3,4,4,314,322,0
PRLHR,2,2,318,322,0
IGHJ5,0,0,322,322,0
IGHJ4,0,0,322,322,0
KATNBL1,6,6,310,322,0
HAO2,4,4,314,322,0
IGHJ3,0,0,322,322,0
IGHJ2,0,0,322,322,0
KCNA2,2,2,318,322,0
KCNA4,0,0,322,322,0
KCNA6,2,2,318,322,0
SRSF2,10,10,302,322,0
NEUROG3,1,1,320,322,0
FAM71C,0,0,322,322,0
FLG2,0,0,322,322,0
SSTR4,0,0,322,322,0
NIP7,4,4,314,322,0
CHRDL1,5,5,312,322,0
OR10A7,0,0,322,322,0
TIFAB,0,0,322,322,0
DBF4B,7,7,308,322,0
DBH,3,3,316,322,0
PIGO,5,5,312,322,0
PLXNB3,9,9,304,322,0
TIGD1,2,2,318,322,0
MRPL10,5,5,312,322,0
JAZF1,6,6,310,322,0
HAO1,2,2,318,322,0
AMY2A,10,10,302,322,0
UTP15,8,8,306,322,0
P2RY10,2,2,318,322,0
EPHA3,3,3,316,322,0
TNMD,3,3,316,322,0
JMJD8,8,8,306,322,0
JPH1,6,6,310,322,0
PRKCQ,4,4,314,322,0
BCL2L2-PABPN1,13,13,296,322,0
GABRG3,4,4,314,322,0
HERC6,7,7,308,322,0
FAM47A,0,0,322,322,0
HACD4,1,1,320,322,0
TSN,5,5,312,322,0
ITGA5,6,6,310,322,0
MS4A6E,6,6,310,322,0
IP6K3,11,11,300,322,0
CNTRL,4,4,314,322,0
GABRG1,0,0,322,322,0
CERKL,2,2,318,322,0
ARHGAP36,2,2,318,322,0
PPP3CC,5,5,312,322,0
CSN3,2,2,318,322,0
SULT1C3,1,1,320,322,0
PPP4R3C,0,0,322,322,0
MS4A15,5,5,312,322,0
UROC1,0,0,322,322,0
AMN,13,13,296,322,0
MS4A1,2,2,318,322,0
CYLC1,1,1,320,322,0
CSRP1,9,9,304,322,0
ZNF789,9,9,304,322,0
IGHV3-64D,1,1,320,322,0
PAGE5,7,7,308,322,0
PDCL3,6,6,310,322,0
DAO,3,3,316,322,0
TH,6,6,310,322,0
IGHV3-64,3,3,316,322,0
DAOA,0,0,322,322,0
IQCM,2,2,318,322,0
PNMA8B,3,3,316,322,0
OR1S1,0,0,322,322,0
AMMECR1,6,6,310,322,0
TMSB4Y,4,4,314,322,0
ZNF684,4,4,314,322,0
SYCP1,0,0,322,322,0
ZNF385D,7,7,308,322,0
HTRA4,4,4,314,322,0
AXIN1,11,11,300,322,0
FAM236B,2,2,318,322,0
FAM161B,7,7,308,322,0
UPF3B,3,3,316,322,0
ARFGAP2,9,9,304,322,0
AMIGO1,11,11,300,322,0
MSL3,9,9,304,322,0
NFATC4,10,10,302,322,0
TSPY10,0,0,322,322,0
PLA2G2C,3,3,316,322,0
UPP2,4,4,314,322,0
OR10A4,6,6,310,322,0
HENMT1,4,4,314,322,0
ABHD13,4,4,314,322,0
NTF4,15,15,292,322,0
PDE6H,4,4,314,322,0
GSDMD,9,9,304,322,0
INSRR,1,1,320,322,0
INTS6L,3,3,316,322,0
OR11A1,2,2,318,322,0
GRM8,7,7,308,322,0
PRADC1,8,8,306,322,0
STXBP4,3,3,316,322,0
MRPS26,9,9,304,322,0
IRX2,2,2,318,322,0
THBS3,7,7,308,322,0
PACSIN3,8,8,306,322,0
NFU1,8,8,306,322,0
BAIAP2L2,9,9,304,322,0
PCDHB4,1,1,320,322,0
CIDEB,13,13,296,322,0
MRPS27,4,4,314,322,0
PACSIN1,3,3,316,322,0
BANK1,1,1,320,322,0
USP17L4,2,2,318,322,0
AQP9,1,1,320,322,0
ASB18,12,12,298,322,0
ELAC1,9,9,304,322,0
AK9,5,5,312,322,0
MYBPC1,2,2,318,322,0
ZNF366,1,1,320,322,0
MYBPC3,0,0,322,322,0
ISY1-RAB43,20,20,282,322,0
STK26,5,5,312,322,0
PDF,9,9,304,322,0
STK17B,6,6,310,322,0
PRDM13,1,1,320,322,0
FTHL17,1,1,320,322,0
USP17L20,0,0,322,322,0
TNFRSF12A,16,16,290,322,0
CSN2,1,1,320,322,0
PRAMEF15,0,0,322,322,0
ELL3,14,14,294,322,0
CUX2,1,1,320,322,0
EPHA1,6,6,310,322,0
PRAMEF12,0,0,322,322,0
CRPPA,3,3,316,322,0
USP17L12,0,0,322,322,0
STX17,7,7,308,322,0
FTMT,0,0,322,322,0
PRAMEF14,1,1,320,322,0
IRAK4,3,3,316,322,0
PDCD7,6,6,310,322,0
IGHV3-23,7,7,308,322,0
PRAMEF27,0,0,322,322,0
ABCB6,22,22,278,322,0
COCH,12,12,298,322,0
PNLIP,0,0,322,322,0
ELF5,4,4,314,322,0
NAPB,5,5,312,322,0
IRF6,4,4,314,322,0
GRIN3B,5,5,312,322,0
ASB4,2,2,318,322,0
TNFRSF11B,5,5,312,322,0
PRAMEF20,0,0,322,322,0
PRAMEF26,0,0,322,322,0
OR14A16,0,0,322,322,0
ACACB,8,8,306,322,0
OR1C1,1,1,320,322,0
AAR2,6,6,310,322,0
C3orf14,9,9,304,322,0
OR5A1,2,2,318,322,0
DEFB136,6,6,310,322,0
SH2D4B,1,1,320,322,0
DHRS11,7,7,308,322,0
FDCSP,3,3,316,322,0
OR56B4,2,2,318,322,0
OR4D5,0,0,322,322,0
YPEL1,10,10,302,322,0
ACSM6,5,5,312,322,0
SH2D3A,13,13,296,322,0
OR4D6,0,0,322,322,0
CD300A,5,5,312,322,0
LRRC63,4,4,314,322,0
RTL3,2,2,318,322,0
RTL4,0,0,322,322,0
OR56B2P,0,0,322,322,0
FCRLB,7,7,308,322,0
RTL8B,5,5,312,322,0
SGTB,3,3,316,322,0
PGM5,4,4,314,322,0
OR5AC2,0,0,322,322,0
ANO5,2,2,318,322,0
RTN2,15,15,292,322,0
PGP,6,6,310,322,0
RSBN1L,4,4,314,322,0
AADACL2,0,0,322,322,0
OR4D10,0,0,322,322,0
F11R,3,3,316,322,0
RANBP17,8,8,306,322,0
RGS10,4,4,314,322,0
SHARPIN,10,10,302,322,0
SHANK2,9,9,304,322,0
CD34,2,2,318,322,0
DRD5,3,3,316,322,0
OCIAD2,2,2,318,322,0
OR5AP2,0,0,322,322,0
SH3RF1,7,7,308,322,0
C2orf74,13,13,296,322,0
AP3S2,3,3,316,322,0
OR5AK2,0,0,322,322,0
CD300LG,5,5,312,322,0
OR4D2,0,0,322,322,0
CLEC9A,0,0,322,322,0
SH3GL2,5,5,312,322,0
C2orf80,16,16,290,322,0
RTL9,7,7,308,322,0
C3orf70,3,3,316,322,0
MED22,1,1,320,322,0
ADAMTS4,2,2,318,322,0
LCE1E,6,6,310,322,0
PFKL,15,15,292,322,0
CD244,0,0,322,322,0
HMX3,3,3,316,322,0
OR2J3,1,1,320,322,0
MDFIC2,0,0,322,322,0
LCE2C,1,1,320,322,0
C4orf33,11,11,300,322,0
RFX5,9,9,304,322,0
CCN3,8,8,306,322,0
C4orf50,1,1,320,322,0
TRBV5-5,8,8,306,322,0
RASGRF1,0,0,322,322,0
ACTL6B,8,8,306,322,0
RXFP2,0,0,322,322,0
C5AR2,3,3,316,322,0
RFWD3,3,3,316,322,0
OR52N5,0,0,322,322,0
LCE3D,2,2,318,322,0
GLMN,6,6,310,322,0
ZACN,9,9,304,322,0
RASAL1,5,5,312,322,0
LRRC3C,5,5,312,322,0
LAX1,2,2,318,322,0
LCE1B,2,2,318,322,0
LRRC55,2,2,318,322,0
SGO1,3,3,316,322,0
FCRLA,12,12,298,322,0
C3orf80,8,8,306,322,0
OR4E2,1,1,320,322,0
C3orf85,1,1,320,322,0
LRRC52,1,1,320,322,0
CCL8,0,0,322,322,0
GFRAL,2,2,318,322,0
RGL4,7,7,308,322,0
OR56A3,0,0,322,322,0
YTHDF2,6,6,310,322,0
PDX1,1,1,320,322,0
FCRL4,1,1,320,322,0
HKDC1,1,1,320,322,0
DELE1,8,8,306,322,0
RARRES1,17,17,288,322,0
RUFY4,0,0,322,322,0
ADAMTS6,2,2,318,322,0
RUNDC1,6,6,310,322,0
CASD1,7,7,308,322,0
RALYL,2,2,318,322,0
LANCL3,1,1,320,322,0
DEFB112,0,0,322,322,0
CCL15-CCL14,4,4,314,322,0
ACSL1,11,11,300,322,0
CBR4,9,9,304,322,0
GMPR,5,5,312,322,0
SIRPG,2,2,318,322,0
TRAJ56,0,0,322,322,0
KYNU,4,4,314,322,0
TRAJ57,0,0,322,322,0
TRAJ59,0,0,322,322,0
TRDJ4,0,0,322,322,0
GMPPB,4,4,314,322,0
NEU2,2,2,318,322,0
ZNF304,7,7,308,322,0
TRAJ61,0,0,322,322,0
OCSTAMP,1,1,320,322,0
SIMC1,4,4,314,322,0
RPS6KA1,3,3,316,322,0
DNAH14,4,4,314,322,0
DNAH17,6,6,310,322,0
RPS6KA6,3,3,316,322,0
OR4C15,0,0,322,322,0
GEN1,10,10,302,322,0
ANTXRL,7,7,308,322,0
LTB4R,7,7,308,322,0
DEFB118,0,0,322,322,0
OR5D3P,0,0,322,322,0
ZNF479,2,2,318,322,0
NUP214,8,8,306,322,0
TRAJ52,0,0,322,322,0
NRCAM,7,7,308,322,0
SKOR1,3,3,316,322,0
OR4C11,0,0,322,322,0
C1QTNF1,6,6,310,322,0
XPNPEP2,0,0,322,322,0
OR5F1,0,0,322,322,0
GEMIN2,9,9,304,322,0
OR4C12,0,0,322,322,0
KRTAP9-9,0,0,322,322,0
ZNF264,7,7,308,322,0
C1QTNF6,6,6,310,322,0
DTL,5,5,312,322,0
C1QTNF7,4,4,314,322,0
TRIM42,0,0,322,322,0
C1QTNF8,1,1,320,322,0
DTHD1,0,0,322,322,0
CBWD3,9,9,304,322,0
DEFB114,1,1,320,322,0
SIKE1,2,2,318,322,0
OR4C16,0,0,322,322,0
MAPK6,5,5,312,322,0
CLEC12B,2,2,318,322,0
OR4C46,0,0,322,322,0
LAMA3,5,5,312,322,0
RGS21,0,0,322,322,0
RGS20,10,10,302,322,0
LAMB4,4,4,314,322,0
C2CD4B,2,2,318,322,0
ZIK1,8,8,306,322,0
TRDD1,0,0,322,322,0
ACSL6,4,4,314,322,0
RRP15,1,1,320,322,0
SHLD3,11,11,300,322,0
RRP1B,4,4,314,322,0
CD3E,0,0,322,322,0
CAVIN2,1,1,320,322,0
OR4C6,0,0,322,322,0
FOXR2,0,0,322,322,0
DEFB125,0,0,322,322,0
RS1,0,0,322,322,0
SHISA9,3,3,316,322,0
NDUFA7,12,12,298,322,0
LANCL1,9,9,304,322,0
C2CD2,2,2,318,322,0
CRCT1,3,3,316,322,0
C21orf91,4,4,314,322,0
TRDD2,0,0,322,322,0
RAD51B,14,14,294,322,0
CBLN1,5,5,312,322,0
OR5D18,0,0,322,322,0
RPTN,0,0,322,322,0
RHAG,1,1,320,322,0
OR5D14,1,1,320,322,0
SIGLEC5,0,0,322,322,0
TRDJ1,0,0,322,322,0
RAD54B,8,8,306,322,0
MEF2C,9,9,304,322,0
TRDD3,0,0,322,322,0
OR5D13,0,0,322,322,0
SIGLEC1,0,0,322,322,0
GFAP,38,38,246,322,0
DNAH6,2,2,318,322,0
OR5C1,4,4,314,322,0
RGS7BP,1,1,320,322,0
RGS7,3,3,316,322,0
CBLIF,5,5,312,322,0
COX17,10,10,302,322,0
TRAK2,6,6,310,322,0
LRRC19,3,3,316,322,0
LCMT1,6,6,310,322,0
FLYWCH2,8,8,306,322,0
LMX1A,0,0,322,322,0
RELL1,4,4,314,322,0
RELB,10,10,302,322,0
CAMK1G,4,4,314,322,0
NEK4,3,3,316,322,0
ACY1,10,10,302,322,0
ZC3H14,9,9,304,322,0
TRAV8-3,3,3,316,322,0
OR51S1,0,0,322,322,0
FMO2,1,1,320,322,0
OR4S2,0,0,322,322,0
REG1B,0,0,322,322,0
RBMY1A1,2,2,318,322,0
CACNA1D,8,8,306,322,0
RBMY1B,0,0,322,322,0
SEC14L4,4,4,314,322,0
OAZ3,4,4,314,322,0
CACNA1I,0,0,322,322,0
TRBJ2-7,1,1,320,322,0
LILRA5,8,8,306,322,0
MBL2,0,0,322,322,0
REEP3,4,4,314,322,0
SEC24D,5,5,312,322,0
LHX3,6,6,310,322,0
OR51L1,0,0,322,322,0
LHPP,12,12,298,322,0
SELP,0,0,322,322,0
OR52B4,1,1,320,322,0
REM1,1,1,320,322,0
ZBTB8A,6,6,310,322,0
LPAR3,2,2,318,322,0
FGGY,6,6,310,322,0
GAL3ST3,7,7,308,322,0
SAYSD1,7,7,308,322,0
ADAM2,0,0,322,322,0
LPA,2,2,318,322,0
OR52A5,0,0,322,322,0
ABLIM1,5,5,312,322,0
GK2,1,1,320,322,0
LOXL4,7,7,308,322,0
LOXL1,4,4,314,322,0
LONRF1,7,7,308,322,0
RELT,8,8,306,322,0
CABP5,3,3,316,322,0
RELN,1,1,320,322,0
PGBD4,1,1,320,322,0
OR51T1,1,1,320,322,0
ZDHHC15,1,1,320,322,0
OR51I2,0,0,322,322,0
OR1J1,3,3,316,322,0
LIN54,3,3,316,322,0
MBD3L5,0,0,322,322,0
LINC02210-CRHR1,3,3,316,322,0
GJB1,4,4,314,322,0
LINC02218,0,0,322,322,0
CADPS,7,7,308,322,0
GCAT,7,7,308,322,0
SCN10A,0,0,322,322,0
RD3L,1,1,320,322,0
FMOD,2,2,318,322,0
SCP2D1,6,6,310,322,0
LIPN,0,0,322,322,0
LIPC,3,3,316,322,0
FOXI2,0,0,322,322,0
LIPF,0,0,322,322,0
SCNN1G,1,1,320,322,0
SCNN1D,11,11,300,322,0
LIPM,1,1,320,322,0
DOCK2,9,9,304,322,0
CALHM1,5,5,312,322,0
TRBJ1-6,0,0,322,322,0
PGAM5,3,3,316,322,0
RDH16,6,6,310,322,0
RCAN3,7,7,308,322,0
TRBJ2-6,3,3,316,322,0
OR51F1,0,0,322,322,0
TRBJ2-5,0,0,322,322,0
OR51A2,0,0,322,322,0
CACNB1,9,9,304,322,0
OR51A4,0,0,322,322,0
FOXL2NB,3,3,316,322,0
OR51G2,0,0,322,322,0
LILRB2,3,3,316,322,0
RECK,4,4,314,322,0
OR51A7,0,0,322,322,0
LILRB5,3,3,316,322,0
HNRNPCL2,7,7,308,322,0
LIM2,4,4,314,322,0
TRBD1,0,0,322,322,0
CR1,0,0,322,322,0
DOCK11,8,8,306,322,0
TRBJ2-2P,1,1,320,322,0
PGAP3,11,11,300,322,0
SCIMP,9,9,304,322,0
SCIN,5,5,312,322,0
MATN2,9,9,304,322,0
OR51F2,0,0,322,322,0
OR4Q2,0,0,322,322,0
ZNF492,2,2,318,322,0
ADAM22,8,8,306,322,0
SERPIND1,5,5,312,322,0
TRBV29-1,18,18,286,322,0
RAVER1,8,8,306,322,0
MCOLN3,4,4,314,322,0
CD1B,0,0,322,322,0
CARD10,5,5,312,322,0
CAPZA3,1,1,320,322,0
SERPINB4,3,3,316,322,0
TRAV16,2,2,318,322,0
DENND4B,6,6,310,322,0
SERPINB12,0,0,322,322,0
CAPSL,17,17,288,322,0
OR4K14,0,0,322,322,0
CLEC4M,0,0,322,322,0
SAA2-SAA4,5,5,312,322,0
OAS2,1,1,320,322,0
TRAV2,1,1,320,322,0
OR4K2,1,1,320,322,0
CTAGE15,14,14,294,322,0
SERPINA12,0,0,322,322,0
ACTRT1,0,0,322,322,0
SERPINA11,0,0,322,322,0
RFK,5,5,312,322,0
DPPA4,3,3,316,322,0
OR52E2,2,2,318,322,0
TRAV13-1,2,2,318,322,0
ZAN,1,1,320,322,0
OR4F4,5,5,312,322,0
PGLYRP4,0,0,322,322,0
TRAV12-1,0,0,322,322,0
LCN9,7,7,308,322,0
NR1I2,3,3,316,322,0
GLIS1,5,5,312,322,0
TRBV4-2,1,1,320,322,0
ZSCAN21,10,10,302,322,0
ZNF891,3,3,316,322,0
ZBED3,6,6,310,322,0
NUMBL,9,9,304,322,0
CARF,7,7,308,322,0
FMC1-LUC7L2,17,17,288,322,0
GBP7,0,0,322,322,0
TRAV12-3,4,4,314,322,0
RFLNA,7,7,308,322,0
SERPING1,4,4,314,322,0
TRBV3-1,2,2,318,322,0
MCPH1,5,5,312,322,0
LRP8,7,7,308,322,0
DPP7,15,15,292,322,0
MCM9,3,3,316,322,0
SAGE1,1,1,320,322,0
TRAV20,1,1,320,322,0
TRBV2,3,3,316,322,0
SAMSN1,2,2,318,322,0
TRBV17,3,3,316,322,0
LRCH1,6,6,310,322,0
ZNF99,1,1,320,322,0
LEPR,5,5,312,322,0
OR52E5,0,0,322,322,0
CCSER2,6,6,310,322,0
LEXM,7,7,308,322,0
NEMF,6,6,310,322,0
SEMA5B,11,11,300,322,0
DPEP3,0,0,322,322,0
TRBV16,3,3,316,322,0
NR2C2AP,11,11,300,322,0
NELL1,1,1,320,322,0
RESF1,8,8,306,322,0
OASL,4,4,314,322,0
CA14,13,13,296,322,0
LRAT,4,4,314,322,0
PGAM4,10,10,302,322,0
CPA3,0,0,322,322,0
ADAM33,2,2,318,322,0
LEMD3,4,4,314,322,0
ZBTB37,3,3,316,322,0
OR4M1,0,0,322,322,0
ADAMDEC1,0,0,322,322,0
TRAV21,0,0,322,322,0
REXO1,7,7,308,322,0
OR4L1,0,0,322,322,0
ZBTB17,10,10,302,322,0
GID4,6,6,310,322,0
GLI4,8,8,306,322,0
CAPN7,5,5,312,322,0
ZNF274,5,5,312,322,0
ZNF285,7,7,308,322,0
OR2I1P,1,1,320,322,0
LECT2,8,8,306,322,0
ZNF284,4,4,314,322,0
HOGA1,6,6,310,322,0
ZNF283,7,7,308,322,0
DENND6A,5,5,312,322,0
SEPTIN5,15,15,292,322,0
GIMAP1-GIMAP5,0,0,322,322,0
RETREG1,10,10,302,322,0
ADAM7,0,0,322,322,0
TRAJ50,0,0,322,322,0
CALCR,0,0,322,322,0
LUC7L,10,10,302,322,0
DHX33,3,3,316,322,0
HMG20A,9,9,304,322,0
MAGEB5,0,0,322,322,0
METTL16,5,5,312,322,0
NUDT19,5,5,312,322,0
RNASE3,4,4,314,322,0
OR5V1,0,0,322,322,0
C1orf112,7,7,308,322,0
C1orf115,6,6,310,322,0
CCDC169,6,6,310,322,0
SLC24A4,6,6,310,322,0
PYROXD2,5,5,312,322,0
KRTAP24-1,0,0,322,322,0
RPL13A,9,9,304,322,0
RNASE4,14,14,294,322,0
FBN1,4,4,314,322,0
SLC36A2,3,3,316,322,0
ZNF831,0,0,322,322,0
METTL23,10,10,302,322,0
GDF2,0,0,322,322,0
KRTAP20-2,8,8,306,322,0
MAP1S,12,12,298,322,0
DIAPH2,1,1,320,322,0
OR2W1,3,3,316,322,0
MAB21L4,10,10,302,322,0
RAB27A,3,3,316,322,0
SLC35G2,6,6,310,322,0
CCDC175,2,2,318,322,0
FEZF1,2,2,318,322,0
TRAJ24,0,0,322,322,0
GNPTAB,6,6,310,322,0
KRTAP19-7,3,3,316,322,0
SLC24A1,4,4,314,322,0
GNL1,8,8,306,322,0
SLC35F5,4,4,314,322,0
RIC3,10,10,302,322,0
OR1G1,0,0,322,322,0
ZNF32,11,11,300,322,0
WWOX,8,8,306,322,0
OR5T1,0,0,322,322,0
RAB40B,8,8,306,322,0
NPVF,0,0,322,322,0
ZNF135,3,3,316,322,0
OR2Z1,0,0,322,322,0
OR5M9,0,0,322,322,0
SLC39A11,9,9,304,322,0
OR5M8,0,0,322,322,0
OR6Q1,1,1,320,322,0
CCDC146,4,4,314,322,0
TRAJ34,0,0,322,322,0
SLC22A15,5,5,312,322,0
RAB3C,1,1,320,322,0
TRAF3,6,6,310,322,0
TRAJ3,2,2,318,322,0
ADGRG4,0,0,322,322,0
GDF3,1,1,320,322,0
CCDC160,8,8,306,322,0
SLC22A25,1,1,320,322,0
OR6N2,0,0,322,322,0
ZNF804A,1,1,320,322,0
CCER1,0,0,322,322,0
SLC22A4,1,1,320,322,0
KRTAP29-1,1,1,320,322,0
NUDT15,2,2,318,322,0
KRTAP27-1,0,0,322,322,0
KRTAP26-1,0,0,322,322,0
OR5T2,0,0,322,322,0
SLC25A35,7,7,308,322,0
CLDN8,0,0,322,322,0
CPXCR1,0,0,322,322,0
ANO2,5,5,312,322,0
C18orf63,0,0,322,322,0
CCDC195,6,6,310,322,0
OR6C65,0,0,322,322,0
KRTAP10-11,1,1,320,322,0
TRAJ14,0,0,322,322,0
KRTAP10-10,0,0,322,322,0
FEV,5,5,312,322,0
KRT9,2,2,318,322,0
TRGV3,21,21,280,322,0
KRTAP1-3,0,0,322,322,0
GCNT7,8,8,306,322,0
ZNF821,9,9,304,322,0
ZSWIM7,7,7,308,322,0
SLC26A9,0,0,322,322,0
SLC30A7,3,3,316,322,0
R3HCC1L,6,6,310,322,0
OR6C68,1,1,320,322,0
OR2T35,0,0,322,322,0
ZNF512B,8,8,306,322,0
CLDN7,17,17,288,322,0
CCDC189,13,13,296,322,0
TRH,1,1,320,322,0
SLC2A7,1,1,320,322,0
CCDC85A,1,1,320,322,0
CPB2,2,2,318,322,0
KRTAP10-9,0,0,322,322,0
KRTAP10-8,0,0,322,322,0
CT47A1,7,7,308,322,0
DEF6,6,6,310,322,0
MAGEA11,5,5,312,322,0
OR6C74,0,0,322,322,0
KRTAP13-1,1,1,320,322,0
OR1E1,1,1,320,322,0
RP1L1,0,0,322,322,0
OR6C1,0,0,322,322,0
FGA,1,1,320,322,0
RIN3,7,7,308,322,0
SLC35D2,5,5,312,322,0
KRTAP19-4,4,4,314,322,0
DEFA6,1,1,320,322,0
CCDC28A,5,5,312,322,0
PHF11,6,6,310,322,0
RNF26,9,9,304,322,0
OR2T2,0,0,322,322,0
KRTAP19-6,1,1,320,322,0
ROS1,1,1,320,322,0
OR2T10,0,0,322,322,0
TRAJ21,0,0,322,322,0
OR14K1,3,3,316,322,0
TRAJ2,2,2,318,322,0
FRA10AC1,3,3,316,322,0
RNF220,9,9,304,322,0
TRAJ19,0,0,322,322,0
OR14L1P,1,1,320,322,0
MAGEB1,1,1,320,322,0
HLA-DRB5,5,5,312,322,0
RIOK1,6,6,310,322,0
TRAJ18,2,2,318,322,0
FHL2,9,9,304,322,0
RMC1,8,8,306,322,0
KRTAP15-1,1,1,320,322,0
DEFA5,8,8,306,322,0
TRGV11,2,2,318,322,0
NEURL2,17,17,288,322,0
ZNF205,13,13,296,322,0
SLC26A5,6,6,310,322,0
MAP3K14,5,5,312,322,0
SLC2A4,7,7,308,322,0
ZNF234,4,4,314,322,0
WFDC1,8,8,306,322,0
KRT32,1,1,320,322,0
RNF149,5,5,312,322,0
KRT34,5,5,312,322,0
MFSD6,11,11,300,322,0
TRABD2B,0,0,322,322,0
EXTL1,4,4,314,322,0
RAB6D,4,4,314,322,0
CCL13,1,1,320,322,0
OR5L1,0,0,322,322,0
OR5L2,0,0,322,322,0
RNASEL,5,5,312,322,0
MFSD3,6,6,310,322,0
SLC16A8,4,4,314,322,0
PWWP4,0,0,322,322,0
TRAJ36,1,1,320,322,0
ADGRL4,9,9,304,322,0
CCDC60,5,5,312,322,0
OR5I1,0,0,322,322,0
TRIM14,1,1,320,322,0
KRT6B,0,0,322,322,0
TRAJ5,2,2,318,322,0
TRAJ45,3,3,316,322,0
OR1B1,4,4,314,322,0
KRTAP5-5,2,2,318,322,0
CLEC11A,9,9,304,322,0
TRAJ42,2,2,318,322,0
OR4A47,1,1,320,322,0
KRTAP5-4,7,7,308,322,0
SLC16A10,7,7,308,322,0
RHOBTB2,8,8,306,322,0
TRAJ47,0,0,322,322,0
RPP38,9,9,304,322,0
EXTL2,7,7,308,322,0
ZNF226,7,7,308,322,0
CDCP2,3,3,316,322,0
WDR92,4,4,314,322,0
FDXR,9,9,304,322,0
NXPE2,3,3,316,322,0
OFD1,3,3,316,322,0
ZNF239,7,7,308,322,0
CCDC105,0,0,322,322,0
NWD2,0,0,322,322,0
XKR4,2,2,318,322,0
KRTAP7-1,2,2,318,322,0
SLC48A1,5,5,312,322,0
OR5K3,1,1,320,322,0
OR2L13,0,0,322,322,0
GDPD4,1,1,320,322,0
CCDC78,17,17,288,322,0
KRTAP9-3,0,0,322,322,0
DIPK1B,14,14,294,322,0
DIPK2B,2,2,318,322,0
OR5M1,0,0,322,322,0
SLAMF6,3,3,316,322,0
TRIP6,10,10,302,322,0
SLC17A9,14,14,294,322,0
CCDC112,3,3,316,322,0
CD8B2,0,0,322,322,0
OR5J2,0,0,322,322,0
LUZP4,2,2,318,322,0
DMRT3,5,5,312,322,0
CLDN3,4,4,314,322,0
DMRTC2,2,2,318,322,0
FRMD4B,9,9,304,322,0
DEFB110,2,2,318,322,0
SLC45A1,6,6,310,322,0
SLC12A9,9,9,304,322,0
OR5M10,0,0,322,322,0
CCDC68,6,6,310,322,0
KRTAP4-3,0,0,322,322,0
HLA-DRA,5,5,312,322,0
OR2M5,0,0,322,322,0
DEFB106A,0,0,322,322,0
DDX54,9,9,304,322,0
SLC17A2,0,0,322,322,0
OR4A5,0,0,322,322,0
XBP1,6,6,310,322,0
TRMT2B,3,3,316,322,0
TRAJ44,2,2,318,322,0
MAP3K6,9,9,304,322,0
C16orf78,0,0,322,322,0
SLC41A2,5,5,312,322,0
SLC13A5,6,6,310,322,0
RNF144A,4,4,314,322,0
SLC17A6,0,0,322,322,0
KRT6C,0,0,322,322,0
CD72,13,13,296,322,0
MEP1A,0,0,322,322,0
DMBT1,9,9,304,322,0
CH25H,1,2,319,322,-1
OR51B6,0,1,321,322,-1
ATP2B2,4,5,313,322,-1
RLN1,12,13,297,322,-1
TTC12,9,10,303,322,-1
TBC1D3,3,4,315,322,-1
RDH13,2,3,317,322,-1
TMEM107,6,7,309,322,-1
TTI1,6,7,309,322,-1
TSPAN10,5,6,311,322,-1
TMOD1,2,3,317,322,-1
TAF11L3,1,2,319,322,-1
TTF2,5,6,311,322,-1
TRBJ2-2,1,2,319,322,-1
PKD1L2,4,5,313,322,-1
DNPH1,8,9,305,322,-1
NMBR,2,3,317,322,-1
CCDC192,3,4,315,322,-1
NME3,8,9,305,322,-1
COMTD1,8,9,305,322,-1
TBCB,4,5,313,322,-1
MYO15A,8,9,305,322,-1
PLEKHH2,4,5,313,322,-1
ARMC6,7,8,307,322,-1
EREG,3,4,315,322,-1
FFAR2,3,4,315,322,-1
FXYD6-FXYD2,6,7,309,322,-1
TTLL7,2,3,317,322,-1
ATP2A3,4,5,313,322,-1
TADA2A,6,7,309,322,-1
ZNF641,10,11,301,322,-1
ZNF189,5,6,311,322,-1
OR2T34,0,1,321,322,-1
OR10J5,0,1,321,322,-1
CALCRL,6,7,309,322,-1
ZNF251,6,7,309,322,-1
HMGB4,0,1,321,322,-1
POTEB,0,1,321,322,-1
GIMAP1,0,1,321,322,-1
ERCC1,7,8,307,322,-1
ZNF25,6,7,309,322,-1
TRBJ2-1,4,5,313,322,-1
MATN4,7,8,307,322,-1
ZNF595,4,5,313,322,-1
OR4M2,1,2,319,322,-1
GZMK,0,1,321,322,-1
TSNAXIP1,16,17,289,322,-1
IFNW1,3,4,315,322,-1
IL36A,1,2,319,322,-1
OAS3,3,4,315,322,-1
SAMD9,1,2,319,322,-1
PLCXD1,7,8,307,322,-1
TRBV20-1,16,17,289,322,-1
RITA1,6,7,309,322,-1
ZNF485,11,12,299,322,-1
CAPN14,1,2,319,322,-1
NUP88,5,6,311,322,-1
IFT27,10,11,301,322,-1
ENTPD8,3,4,315,322,-1
REV1,5,6,311,322,-1
ACOD1,0,1,321,322,-1
LRFN5,2,3,317,322,-1
DIRAS3,9,10,303,322,-1
OR1F1,19,20,283,322,-1
DGCR6L,11,12,299,322,-1
ARL15,5,6,311,322,-1
MTCP1,7,8,307,322,-1
ZDHHC16,5,6,311,322,-1
UGCG,5,6,311,322,-1
RNF180,7,8,307,322,-1
HCN4,3,4,315,322,-1
TAS1R2,0,1,321,322,-1
FIGNL2,2,3,317,322,-1
SCFD1,5,6,311,322,-1
NT5C3B,4,5,313,322,-1
POT1,4,5,313,322,-1
RELL2,4,5,313,322,-1
SCAI,4,5,313,322,-1
REEP1,12,13,297,322,-1
MASTL,5,6,311,322,-1
PLD6,5,6,311,322,-1
ZNF48,10,11,301,322,-1
GABBR2,6,7,309,322,-1
OPN1SW,11,12,299,322,-1
LNP1,2,3,317,322,-1
TTC16,1,2,319,322,-1
GABRB2,0,1,321,322,-1
NT5DC1,7,8,307,322,-1
TMEM138,6,7,309,322,-1
TMIGD1,1,2,319,322,-1
NAE1,6,7,309,322,-1
ANKRD31,0,1,321,322,-1
CYP4F12,6,7,309,322,-1
OPN4,0,1,321,322,-1
TANGO2,5,6,311,322,-1
IL20RA,2,3,317,322,-1
CYP4F11,3,4,315,322,-1
TTC31,7,8,307,322,-1
FAM107A,7,8,307,322,-1
IL1RAPL1,4,5,313,322,-1
EPX,1,2,319,322,-1
ZNF222,5,6,311,322,-1
EXOSC4,10,11,301,322,-1
SCARF1,1,2,319,322,-1
IL21,1,2,319,322,-1
RNF170,11,12,299,322,-1
LMNB1,11,12,299,322,-1
GTSE1,4,5,313,322,-1
FIP1L1,8,9,305,322,-1
TARBP1,4,5,313,322,-1
IL1F10,1,2,319,322,-1
PCOLCE2,10,11,301,322,-1
CYP4F3,2,3,317,322,-1
MAGEB16,0,1,321,322,-1
ZNF214,2,3,317,322,-1
RNF207,2,3,317,322,-1
NLRP11,2,3,317,322,-1
RNASEH1,2,3,317,322,-1
ANXA4,6,7,309,322,-1
SATL1,0,1,321,322,-1
CT47A6,2,3,317,322,-1
CISH,8,9,305,322,-1
CPZ,5,6,311,322,-1
TRIM50,1,2,319,322,-1
IFNA4,1,2,319,322,-1
TMEM121B,1,2,319,322,-1
TTC21B,3,4,315,322,-1
LPIN2,8,9,305,322,-1
NLRP1,5,6,311,322,-1
OR4N4C,1,2,319,322,-1
TBC1D19,6,7,309,322,-1
OR4N4,7,8,307,322,-1
IFNA7,1,2,319,322,-1
FOXD2,4,5,313,322,-1
RERGL,6,7,309,322,-1
IL33,4,5,313,322,-1
IFIH1,6,7,309,322,-1
OR2T1,0,1,321,322,-1
TMEM135,7,8,307,322,-1
TSPAN19,27,28,267,322,-1
TAS2R39,0,1,321,322,-1
OPRM1,1,2,319,322,-1
IFNA14,1,2,319,322,-1
TRIM51GP,0,1,321,322,-1
HCLS1,10,11,301,322,-1
UGT2A1,4,5,313,322,-1
EXOSC5,11,12,299,322,-1
PEAR1,2,3,317,322,-1
PLAGL2,5,6,311,322,-1
PCOLCE,4,5,313,322,-1
CHST5,6,7,309,322,-1
RNASE9,0,1,321,322,-1
SBF2,7,8,307,322,-1
IL13RA2,2,3,317,322,-1
CALML3,0,1,321,322,-1
IL13RA1,2,3,317,322,-1
MAN1C1,2,3,317,322,-1
ENTHD1,0,1,321,322,-1
IFNA2,0,1,321,322,-1
TMEM165,9,10,303,322,-1
TASP1,6,7,309,322,-1
IL17REL,1,2,319,322,-1
ATG9B,4,5,313,322,-1
FNIP1,5,6,311,322,-1
MAP3K21,3,4,315,322,-1
PKN3,3,4,315,322,-1
RSAD1,8,9,305,322,-1
TUBGCP6,9,10,303,322,-1
MAP3K19,6,7,309,322,-1
MAPK4,5,6,311,322,-1
TIMM23B,3,4,315,322,-1
ZNF474,17,18,287,322,-1
MYH13,0,1,321,322,-1
MYH11,3,4,315,322,-1
ARSL,5,6,311,322,-1
RPL37,9,10,303,322,-1
RRM2B,20,21,281,322,-1
LRRK2,1,2,319,322,-1
DMGDH,4,5,313,322,-1
CCDC137,6,7,309,322,-1
EN1,3,4,315,322,-1
TEX55,1,2,319,322,-1
CHL1,3,4,315,322,-1
TIGIT,22,23,277,322,-1
GFER,6,7,309,322,-1
IGHV5-10-1,4,5,313,322,-1
OR3A3,2,3,317,322,-1
LY75,0,1,321,322,-1
FGFBP2,2,3,317,322,-1
PCDHB1,3,4,315,322,-1
DNAH5,2,3,317,322,-1
TYR,0,1,321,322,-1
IGKJ4,0,1,321,322,-1
DMAC1,5,6,311,322,-1
FER1L6,1,2,319,322,-1
TINAGL1,6,7,309,322,-1
CCDC167,14,15,293,322,-1
TERT,1,2,319,322,-1
CHIT1,1,2,319,322,-1
ZNF140,5,6,311,322,-1
IGKV1-9,4,5,313,322,-1
RPL22L1,5,6,311,322,-1
ZNF136,8,9,305,322,-1
DLK2,5,6,311,322,-1
DNAJB11,8,9,305,322,-1
POF1B,2,3,317,322,-1
RSPH4A,10,11,301,322,-1
OR2K2,6,7,309,322,-1
CCDC15,3,4,315,322,-1
HTR4,2,3,317,322,-1
TEX101,9,10,303,322,-1
LYSMD4,8,9,305,322,-1
NKPD1,2,3,317,322,-1
DNAJA3,5,6,311,322,-1
MYH2,3,4,315,322,-1
IGKV1-17,5,6,311,322,-1
ACSM2A,3,4,315,322,-1
DNAI3,15,16,291,322,-1
POC1B-GALNT4,27,28,267,322,-1
NRSN2,13,14,295,322,-1
MUCL1,12,13,297,322,-1
ZNF134,8,9,305,322,-1
AMZ1,5,6,311,322,-1
TREML4,5,6,311,322,-1
GFOD1,6,7,309,322,-1
ASIC2,0,1,321,322,-1
RHD,5,6,311,322,-1
PNMA3,1,2,319,322,-1
CNGB3,14,15,293,322,-1
OR10Q1,0,1,321,322,-1
PCDHB16,6,7,309,322,-1
MYD88,3,4,315,322,-1
LTB4R2,8,9,305,322,-1
PCDHGA10,3,4,315,322,-1
THRB,6,7,309,322,-1
PNLIPRP2,0,1,321,322,-1
IGHV3-43,7,8,307,322,-1
ANXA10,2,3,317,322,-1
ZNF430,6,7,309,322,-1
RPRM,3,4,315,322,-1
IGHV1OR15-9,3,4,315,322,-1
ANKRD20A1,8,9,305,322,-1
A4GNT,1,2,319,322,-1
THAP7,10,11,301,322,-1
CLGN,4,5,313,322,-1
IGHV2-70,3,4,315,322,-1
THBD,2,3,317,322,-1
HYI,8,9,305,322,-1
LUM,4,5,313,322,-1
TXNDC11,4,5,313,322,-1
CBY3,10,11,301,322,-1
PCDHB7,1,2,319,322,-1
CC2D1B,3,4,315,322,-1
ACP4,8,9,305,322,-1
HLA-DQB2,8,9,305,322,-1
PNMA6A,6,7,309,322,-1
TGFA,5,6,311,322,-1
CCL1,0,1,321,322,-1
CCL11,0,1,321,322,-1
TFEC,2,3,317,322,-1
IGHV4-28,3,4,315,322,-1
DMP1,0,1,321,322,-1
PCDHB12,3,4,315,322,-1
LRTOMT,4,5,313,322,-1
PCDHB13,2,3,317,322,-1
PLXND1,10,11,301,322,-1
TXNRD3,6,7,309,322,-1
DHRS13,6,7,309,322,-1
TRDJ2,0,1,321,322,-1
RHOBTB1,3,4,315,322,-1
CNGA4,3,4,315,322,-1
NIPA1,6,7,309,322,-1
IGHV3OR16-10,2,3,317,322,-1
PM20D2,5,6,311,322,-1
MAP7D3,2,3,317,322,-1
CCDC113,4,5,313,322,-1
OR4A16,0,1,321,322,-1
IGHV3-74,3,4,315,322,-1
PCDHB15,8,9,305,322,-1
TGIF1,15,16,291,322,-1
TSPYL6,0,1,321,322,-1
ERICH1,6,7,309,322,-1
CXCR6,7,8,307,322,-1
RSPO4,3,4,315,322,-1
CASR,1,2,319,322,-1
ALG10,6,7,309,322,-1
CYP2U1,1,2,319,322,-1
ROBO4,1,2,319,322,-1
S100A5,28,29,265,322,-1
ZSCAN2,4,5,313,322,-1
MYL9,2,3,317,322,-1
OR2T5,0,1,321,322,-1
TCEAL8,5,6,311,322,-1
ZNF491,3,4,315,322,-1
ACTL9,0,1,321,322,-1
IGF2BP3,8,9,305,322,-1
TUBA3D,11,12,299,322,-1
IGLV3-12,2,3,317,322,-1
TUBA3E,8,9,305,322,-1
GGPS1,3,4,315,322,-1
NLE1,7,8,307,322,-1
UBE2U,10,11,301,322,-1
IGLV2-33,5,6,311,322,-1
NT5C1A,6,7,309,322,-1
RIOK2,7,8,307,322,-1
CHRNB1,4,5,313,322,-1
RFPL4B,2,3,317,322,-1
HNF1B,2,3,317,322,-1
OR2J1,1,2,319,322,-1
CCN5,4,5,313,322,-1
FCRL1,0,1,321,322,-1
GGCT,5,6,311,322,-1
NIF3L1,10,11,301,322,-1
PCGF1,8,9,305,322,-1
CNOT11,5,6,311,322,-1
ANGPTL1,11,12,299,322,-1
CARD6,2,3,317,322,-1
IGLV3-32,2,3,317,322,-1
PENK,5,6,311,322,-1
MARCHF9,6,7,309,322,-1
SAAL1,7,8,307,322,-1
TRBV27,4,5,313,322,-1
ZNF184,8,9,305,322,-1
GHR,2,3,317,322,-1
TBX2,5,6,311,322,-1
EOLA1,4,5,313,322,-1
CXCL2,10,11,301,322,-1
ACTR1B,9,10,303,322,-1
RIPOR3,6,7,309,322,-1
ANGPTL8,23,24,275,322,-1
S1PR2,5,6,311,322,-1
EPO,6,7,309,322,-1
GALNT7,8,9,305,322,-1
ABHD10,6,7,309,322,-1
ZNF180,6,7,309,322,-1
TMBIM4,5,6,311,322,-1
DNAJC22,3,4,315,322,-1
TST,6,7,309,322,-1
TMA16,6,7,309,322,-1
PCK2,9,10,303,322,-1
IGF1,4,5,313,322,-1
ATOH8,1,2,319,322,-1
NT5C1B,7,8,307,322,-1
OR2T4,1,2,319,322,-1
ALKAL2,18,19,285,322,-1
HAUS1,6,7,309,322,-1
OR10A2,1,2,319,322,-1
ATG4C,5,6,311,322,-1
IGKV5-2,1,2,319,322,-1
TLCD4-RWDD3,26,27,269,322,-1
DLGAP3,1,2,319,322,-1
TRGJ2,1,2,319,322,-1
PEDS1,7,8,307,322,-1
RIMBP2,3,4,315,322,-1
RILPL2,5,6,311,322,-1
CCL5,3,4,315,322,-1
H2BC9,9,10,303,322,-1
CLIC3,14,15,293,322,-1
CHEK2,3,4,315,322,-1
HTR1E,0,1,321,322,-1
ZNF416,6,7,309,322,-1
RTL6,9,10,303,322,-1
GAPDHS,10,11,301,322,-1
MTUS2,7,8,307,322,-1
F12,3,4,315,322,-1
CCDC170,3,4,315,322,-1
HTR1F,4,5,313,322,-1
DNAJB8,0,1,321,322,-1
RTF1,7,8,307,322,-1
MAPKAPK3,8,9,305,322,-1
MUC16,0,1,321,322,-1
HEBP2,8,9,305,322,-1
CHRNA6,3,4,315,322,-1
LRRC7,2,3,317,322,-1
CASQ2,2,3,317,322,-1
NXNL2,10,11,301,322,-1
POLN,9,10,303,322,-1
NINJ1,12,13,297,322,-1
OR10D3,0,1,321,322,-1
CYP2R1,4,5,313,322,-1
TCP11,10,11,301,322,-1
CYP2J2,3,4,315,322,-1
TLR5,7,8,307,322,-1
ALKBH4,5,6,311,322,-1
RORB,3,4,315,322,-1
RORC,3,4,315,322,-1
CARNS1,1,2,319,322,-1
TLR10,4,5,313,322,-1
IGLJ7,0,1,321,322,-1
ALKBH8,4,5,313,322,-1
TRIM49B,2,3,317,322,-1
NKX2-6,2,3,317,322,-1
RTP1,2,3,317,322,-1
ZFY,1,2,319,322,-1
CT47A7,4,5,313,322,-1
PELP1,6,7,309,322,-1
PLA2R1,0,1,321,322,-1
CCDC177,2,3,317,322,-1
DNAJC13,7,8,307,322,-1
TMEM239,1,2,319,322,-1
LRRC42,8,9,305,322,-1
CASP14,0,1,321,322,-1
OR2L3,2,3,317,322,-1
ATG10,3,4,315,322,-1
NYAP2,2,3,317,322,-1
C14orf180,1,2,319,322,-1
IQCJ-SCHIP1,7,8,307,322,-1
VENTX,2,3,317,322,-1
RABGGTA,10,11,301,322,-1
TRPM3,2,3,317,322,-1
ABHD18,4,5,313,322,-1
COL6A6,4,5,313,322,-1
SLAMF9,10,11,301,322,-1
C1QL2,1,2,319,322,-1
AGAP4,3,4,315,322,-1
KRTAP8-1,3,4,315,322,-1
TRAJ49,2,3,317,322,-1
KRTAP6-3,1,2,319,322,-1
NCCRP1,3,4,315,322,-1
OR5H2,1,2,319,322,-1
KEL,5,6,311,322,-1
DEFB107B,4,5,313,322,-1
SOX15,11,12,299,322,-1
SOX14,0,1,321,322,-1
C1orf94,0,1,321,322,-1
SLC12A8,4,5,313,322,-1
SP6,2,3,317,322,-1
NPFFR2,5,6,311,322,-1
OR5AN1,0,1,321,322,-1
SPACA1,0,1,321,322,-1
SPANXN2,1,2,319,322,-1
FAM90A18P,0,1,321,322,-1
ADCYAP1,0,1,321,322,-1
RAC2,11,12,299,322,-1
TOR1A,5,6,311,322,-1
NPEPL1,8,9,305,322,-1
PRRG3,8,9,305,322,-1
SPAG6,10,11,301,322,-1
TRAJ53,1,2,319,322,-1
SPAG16,8,9,305,322,-1
HPGDS,0,1,321,322,-1
HPGD,3,4,315,322,-1
TOR2A,9,10,303,322,-1
SPACA9,4,5,313,322,-1
OSMR,4,5,313,322,-1
CEBPB,7,8,307,322,-1
ZNF747,3,4,315,322,-1
SOWAHB,3,4,315,322,-1
PRSS45P,4,5,313,322,-1
CREB3L1,8,9,305,322,-1
C1orf68,1,2,319,322,-1
VSIG10L2,1,2,319,322,-1
KRTAP4-2,0,1,321,322,-1
RAB42,4,5,313,322,-1
SLC1A1,6,7,309,322,-1
MOCS3,2,3,317,322,-1
ECHDC2,6,7,309,322,-1
CLRN1,1,2,319,322,-1
SNX10,5,6,311,322,-1
SLC1A7,2,3,317,322,-1
VSTM2A,1,2,319,322,-1
TRAJ32,1,2,319,322,-1
TP73,6,7,309,322,-1
OLFM4,2,3,317,322,-1
SLC22A18,10,11,301,322,-1
C1orf158,4,5,313,322,-1
OLFM3,1,2,319,322,-1
EBLN2,7,8,307,322,-1
RAB43,9,10,303,322,-1
CDAN1,7,8,307,322,-1
KIF15,5,6,311,322,-1
TRAJ4,2,3,317,322,-1
SLC15A1,2,3,317,322,-1
TRAJ43,0,1,321,322,-1
MORC1,0,1,321,322,-1
CD93,0,1,321,322,-1
HFE,2,3,317,322,-1
SLC16A12,5,6,311,322,-1
CLEC12A,2,3,317,322,-1
TRAJ38,2,3,317,322,-1
PRYP3,2,3,317,322,-1
SOCS5,6,7,309,322,-1
COL9A3,10,11,301,322,-1
CST8,0,1,321,322,-1
HPCAL1,5,6,311,322,-1
APOA2,31,32,259,322,-1
SNX33,8,9,305,322,-1
XAGE5,18,19,285,322,-1
PRR5-ARHGAP8,11,12,299,322,-1
PRR4,55,56,211,322,-1
BMX,1,2,319,322,-1
AGO4,3,4,315,322,-1
KCNJ15,4,5,313,322,-1
ZNF727,0,1,321,322,-1
TACC2,7,8,307,322,-1
CENPE,4,5,313,322,-1
ZNF728,5,6,311,322,-1
CRK,4,5,313,322,-1
DSG2,2,3,317,322,-1
NSUN3,5,6,311,322,-1
OR2AT4,2,3,317,322,-1
SHROOM4,1,2,319,322,-1
PRR12,7,8,307,322,-1
KCNK1,4,5,313,322,-1
C22orf42,2,3,317,322,-1
SIAH3,0,1,321,322,-1
BLNK,3,4,315,322,-1
OTUB2,12,13,297,322,-1
SIGIRR,20,21,281,322,-1
CLEC14A,0,1,321,322,-1
GPR65,1,2,319,322,-1
PDHB,10,11,301,322,-1
SHCBP1,7,8,307,322,-1
FBXO31,10,11,301,322,-1
EFR3A,4,5,313,322,-1
HRH3,6,7,309,322,-1
VAX2,10,11,301,322,-1
TRAPPC10,6,7,309,322,-1
CD38,2,3,317,322,-1
MED18,3,4,315,322,-1
VCAM1,3,4,315,322,-1
DSCAM,0,1,321,322,-1
BHLHE22,1,2,319,322,-1
LAPTM5,6,7,309,322,-1
MED19,5,6,311,322,-1
KCNIP3,4,5,313,322,-1
SHF,7,8,307,322,-1
HRH2,1,2,319,322,-1
MED23,7,8,307,322,-1
COL4A6,2,3,317,322,-1
KCNK15,1,2,319,322,-1
TRAJ54,0,1,321,322,-1
BLOC1S5,5,6,311,322,-1
KCNQ4,0,1,321,322,-1
SPATC1,0,1,321,322,-1
RAD51,4,5,313,322,-1
SPATA7,10,11,301,322,-1
GPR31,1,2,319,322,-1
SPATA48,0,1,321,322,-1
L1TD1,4,5,313,322,-1
C20orf194,5,6,311,322,-1
SPATA31D3,0,1,321,322,-1
FBXL8,5,6,311,322,-1
RAD23A,9,10,303,322,-1
GPR26,0,1,321,322,-1
GNA14,5,6,311,322,-1
CELF4,8,9,305,322,-1
KXD1,6,7,309,322,-1
C1RL,8,9,305,322,-1
EEF2K,7,8,307,322,-1
BMP6,10,11,301,322,-1
CLCNKA,2,3,317,322,-1
ANO3,1,2,319,322,-1
ZNF735,0,1,321,322,-1
SPEF2,4,5,313,322,-1
SPECC1L-ADORA2A,21,22,279,322,-1
BLVRA,7,8,307,322,-1
TRAJ9,1,2,319,322,-1
OTOP3,0,1,321,322,-1
OR5D16,0,1,321,322,-1
CLCN5,5,6,311,322,-1
KCNMB3,2,3,317,322,-1
C21orf58,7,8,307,322,-1
GMNC,2,3,317,322,-1
GMNN,8,9,305,322,-1
AGK,5,6,311,322,-1
CEMIP,13,14,295,322,-1
OLIG3,0,1,321,322,-1
LACC1,2,3,317,322,-1
NTSR1,1,2,319,322,-1
EBI3,7,8,307,322,-1
RAB38,6,7,309,322,-1
SLC22A3,0,1,321,322,-1
SLC38A2,9,10,303,322,-1
OR6M1,0,1,321,322,-1
QPCTL,2,3,317,322,-1
SLFN13,3,4,315,322,-1
TRAF3IP2,5,6,311,322,-1
KRT79,3,4,315,322,-1
HOXB3,6,7,309,322,-1
CTNNAL1,7,8,307,322,-1
FARP1,12,13,297,322,-1
OGFOD1,5,6,311,322,-1
DDX60,2,3,317,322,-1
CDHR2,11,12,299,322,-1
C16orf91,9,10,303,322,-1
ADH7,1,2,319,322,-1
KRT77,0,1,321,322,-1
PZP,0,1,321,322,-1
KRT76,0,1,321,322,-1
FREM1,0,1,321,322,-1
COQ9,11,12,299,322,-1
OR6K6,0,1,321,322,-1
SLITRK1,0,1,321,322,-1
DUOX1,5,6,311,322,-1
SLC34A2,3,4,315,322,-1
GPATCH8,10,11,301,322,-1
OR2D3,5,6,311,322,-1
GPATCH4,5,6,311,322,-1
TRMT10C,8,9,305,322,-1
CDC42BPG,0,1,321,322,-1
WIPF1,7,8,307,322,-1
MKI67,7,8,307,322,-1
SLITRK3,3,4,315,322,-1
NPR1,1,2,319,322,-1
KRT84,0,1,321,322,-1
PTK2B,13,14,295,322,-1
KRT82,0,1,321,322,-1
GOLGA8G,0,1,321,322,-1
QRICH1,8,9,305,322,-1
ADGRG2,4,5,313,322,-1
KPNA2,10,11,301,322,-1
MFSD13A,4,5,313,322,-1
QTRT2,4,5,313,322,-1
MID2,3,4,315,322,-1
KRT15,4,5,313,322,-1
OR7A10,0,1,321,322,-1
ZNF793,4,5,313,322,-1
CDH18,2,3,317,322,-1
WDR93,4,5,313,322,-1
SLC46A2,2,3,317,322,-1
WDR83,11,12,299,322,-1
FRMD3,3,4,315,322,-1
C13orf46,1,2,319,322,-1
CDH11,5,6,311,322,-1
CDH1,2,3,317,322,-1
GALNT13,16,17,289,322,-1
KRT31,1,2,319,322,-1
SLC51B,15,16,291,322,-1
CTNNA2,6,7,309,322,-1
APBA1,14,15,293,322,-1
SLC4A8,3,4,315,322,-1
WDR7,5,6,311,322,-1
OR6S1,1,2,319,322,-1
WDSUB1,3,4,315,322,-1
MICALL2,5,6,311,322,-1
KRT71,0,1,321,322,-1
PTPRB,2,3,317,322,-1
HID1,10,11,301,322,-1
C12orf4,6,7,309,322,-1
C16orf82,0,1,321,322,-1
DDX3X,7,8,307,322,-1
SLC7A3,3,4,315,322,-1
MICALL1,4,5,313,322,-1
C15orf61,4,5,313,322,-1
SLC6A7,0,1,321,322,-1
ZNF786,7,8,307,322,-1
KRT36,3,4,315,322,-1
WEE2,6,7,309,322,-1
GOLGA8R,10,11,301,322,-1
SLC6A2,1,2,319,322,-1
CDH23,6,7,309,322,-1
KRTAP1-4,1,2,319,322,-1
SMAP2,4,5,313,322,-1
KRTAP3-1,8,9,305,322,-1
SMIM39,11,12,299,322,-1
TRPA1,2,3,317,322,-1
APLF,1,2,319,322,-1
NPSR1,4,5,313,322,-1
GNRHR,1,2,319,322,-1
TPH1,5,6,311,322,-1
PLCB4,7,8,307,322,-1
RAB22A,3,4,315,322,-1
C19orf85,8,9,305,322,-1
DCT,4,5,313,322,-1
SLC25A40,7,8,307,322,-1
DCTD,5,6,311,322,-1
C19orf81,20,21,281,322,-1
C19orf71,21,22,279,322,-1
C19orf54,5,6,311,322,-1
ANKS4B,0,1,321,322,-1
SMIM6,14,15,293,322,-1
OR8U3,0,1,321,322,-1
TRAJ25,1,2,319,322,-1
ZNF830,5,6,311,322,-1
HOXD8,3,4,315,322,-1
TRAJ27,0,1,321,322,-1
C1orf131,3,4,315,322,-1
OR5T3,0,1,321,322,-1
KIR2DL4,1,2,319,322,-1
TRAJ29,0,1,321,322,-1
TRAJ28,2,3,317,322,-1
FAM9A,2,3,317,322,-1
OR5W2,0,1,321,322,-1
FBP1,7,8,307,322,-1
MNX1,15,16,291,322,-1
TPD52,1,2,319,322,-1
KLB,5,6,311,322,-1
WSB1,9,10,303,322,-1
VWA5B1,4,5,313,322,-1
BSND,0,1,321,322,-1
KRTAP20-1,6,7,309,322,-1
E2F2,7,8,307,322,-1
KRTAP17-1,0,1,321,322,-1
METTL2B,2,3,317,322,-1
DDO,1,2,319,322,-1
KLHDC9,10,11,301,322,-1
DEFA1B,0,1,321,322,-1
ADGRE3,2,3,317,322,-1
TPO,4,5,313,322,-1
KLHL4,1,2,319,322,-1
BUB1,4,5,313,322,-1
SMCO3,5,6,311,322,-1
KRTAP10-7,0,1,321,322,-1
GOLGA6L2,1,2,319,322,-1
ADORA1,7,8,307,322,-1
KRTAP10-5,0,1,321,322,-1
TRAJ11,0,1,321,322,-1
C10orf105,0,1,321,322,-1
FAAP20,9,10,303,322,-1
KLK11,10,11,301,322,-1
KRTAP10-3,2,3,317,322,-1
C10orf143,7,8,307,322,-1
KRTAP10-2,0,1,321,322,-1
SMG9,7,8,307,322,-1
OR8I2,0,1,321,322,-1
FANCA,11,12,299,322,-1
SMIM21,0,1,321,322,-1
DEFA3,0,1,321,322,-1
KRTAP13-2,0,1,321,322,-1
WARS2,3,4,315,322,-1
MMP19,5,6,311,322,-1
ADRA1D,3,4,315,322,-1
CDKN2D,12,13,297,322,-1
KRTAP12-4,3,4,315,322,-1
APEX2,5,6,311,322,-1
CDKL1,24,25,273,322,-1
KRTAP12-3,4,5,313,322,-1
C19orf18,13,14,295,322,-1
OR6C3,0,1,321,322,-1
CTRC,3,4,315,322,-1
CDKN1B,10,11,301,322,-1
COMMD8,3,4,315,322,-1
PSPH,4,5,313,322,-1
DEFB131A,17,18,287,322,-1
OR2M2,1,2,319,322,-1
GRIN2D,4,5,313,322,-1
TRAV22,3,4,315,322,-1
HEPH,2,3,317,322,-1
MRPS18C,9,10,303,322,-1
NT5M,12,13,297,322,-1
AWAT2,0,1,321,322,-1
MRGPRX1,2,3,317,322,-1
RBP3,1,2,319,322,-1
ZNF687,7,8,307,322,-1
PAMR1,8,9,305,322,-1
PACRG,20,21,281,322,-1
USP26,0,1,321,322,-1
ZBTB14,10,11,301,322,-1
TNFRSF21,5,6,311,322,-1
PRDM11,6,7,309,322,-1
GJD2,2,3,317,322,-1
ZNF705D,1,2,319,322,-1
RBIS,8,9,305,322,-1
SDHAF3,7,8,307,322,-1
STPG1,6,7,309,322,-1
ELF3,2,3,317,322,-1
TRAV8-7,1,2,319,322,-1
PRAMEF25,0,1,321,322,-1
IRX1,0,1,321,322,-1
ZC3H6,3,4,315,322,-1
TRAV25,0,1,321,322,-1
GBX2,7,8,307,322,-1
PRAMEF9,0,1,321,322,-1
MCM3,5,6,311,322,-1
GBX1,9,10,303,322,-1
PRAMEF5,1,2,319,322,-1
ZBTB25,3,4,315,322,-1
CCR5,0,1,321,322,-1
PRAMEF8,0,1,321,322,-1
ITGA4,3,4,315,322,-1
CEP63,3,4,315,322,-1
SERPINA4,0,1,321,322,-1
ZC3HC1,7,8,307,322,-1
MRPL49,8,9,305,322,-1
STATH,3,4,315,322,-1
ANO9,2,3,317,322,-1
LDHD,7,8,307,322,-1
ITGB3,2,3,317,322,-1
FAM47C,0,1,321,322,-1
ZNF706,9,10,303,322,-1
NAMPT,6,7,309,322,-1
PDZD11,7,8,307,322,-1
C6orf58,5,6,311,322,-1
RASSF8,6,7,309,322,-1
PIK3C2A,6,7,309,322,-1
MRPL42,5,6,311,322,-1
AQP11,9,10,303,322,-1
CD180,2,3,317,322,-1
C7orf31,5,6,311,322,-1
DAW1,11,12,299,322,-1
TRAV17,0,1,321,322,-1
TRBC1,14,15,293,322,-1
PANX1,4,5,313,322,-1
PPP1R3A,1,2,319,322,-1
STEAP2,2,3,317,322,-1
CNTN5,0,1,321,322,-1
STEAP4,3,4,315,322,-1
OR52I2,1,2,319,322,-1
NAT14,11,12,299,322,-1
AKR1C1,12,13,297,322,-1
PABPC1L2B,0,1,321,322,-1
ITGA9,6,7,309,322,-1
INMT,5,6,311,322,-1
DAPL1,8,9,305,322,-1
SENP8,3,4,315,322,-1
SENP7,4,5,313,322,-1
DPH5,6,7,309,322,-1
CLUL1,10,11,301,322,-1
HSFY1,5,6,311,322,-1
LHFPL2,4,5,313,322,-1
OR51Q1,0,1,321,322,-1
CABLES2,8,9,305,322,-1
NOBOX,0,1,321,322,-1
TNFAIP2,3,4,315,322,-1
PGC,13,14,295,322,-1
TRAV4,1,2,319,322,-1
CER1,1,2,319,322,-1
GRXCR1,0,1,321,322,-1
IQCA1,1,2,319,322,-1
FKBP5,3,4,315,322,-1
CCR8,1,2,319,322,-1
ZNHIT2,8,9,305,322,-1
ZC3H12B,3,4,315,322,-1
TRIM61,6,7,309,322,-1
RBMS1,4,5,313,322,-1
OR2G3,0,1,321,322,-1
PINX1,6,7,309,322,-1
SEC23IP,6,7,309,322,-1
GSC,7,8,307,322,-1
MSH5,8,9,305,322,-1
CCR6,3,4,315,322,-1
PPP2R3B,11,12,299,322,-1
PPP2R2C,4,5,313,322,-1
NOA1,8,9,305,322,-1
SUPT20HL1,0,1,321,322,-1
PAK5,6,7,309,322,-1
NTN3,8,9,305,322,-1
INSYN2A,8,9,305,322,-1
CNTNAP5,0,1,321,322,-1
CABCOCO1,10,11,301,322,-1
PPWD1,6,7,309,322,-1
PGK2,0,1,321,322,-1
CACNA1E,1,2,319,322,-1
GRM1,0,1,321,322,-1
CSTL1,21,22,279,322,-1
LGALS8,6,7,309,322,-1
MCAT,9,10,303,322,-1
COA7,5,6,311,322,-1
FBXO6,7,8,307,322,-1
EMC8,8,9,305,322,-1
DOLPP1,9,10,303,322,-1
PIK3R6,0,1,321,322,-1
F5,2,3,317,322,-1
NOG,7,8,307,322,-1
MCEMP1,8,9,305,322,-1
PRAMEF18,0,1,321,322,-1
STRIP2,3,4,315,322,-1
IQSEC2,8,9,305,322,-1
B4GALT6,9,10,303,322,-1
RBMY1D,1,2,319,322,-1
SVIL,8,9,305,322,-1
SEMA3C,3,4,315,322,-1
PRAM1,6,7,309,322,-1
ELMO1,6,7,309,322,-1
CEP83,3,4,315,322,-1
ZNRD2,9,10,303,322,-1
SV2B,0,1,321,322,-1
HNRNPUL2,5,6,311,322,-1
ELMO3,10,11,301,322,-1
TRIM59,6,7,309,322,-1
NR2E3,5,6,311,322,-1
DDX53,0,1,321,322,-1
IQCJ,3,4,315,322,-1
EMB,4,5,313,322,-1
TRAV12-2,2,3,317,322,-1
PDGFB,8,9,305,322,-1
DPT,1,2,319,322,-1
SCUBE3,3,4,315,322,-1
C3orf62,5,6,311,322,-1
SGSM2,11,12,299,322,-1
C3orf56,0,1,321,322,-1
TRIM54,4,5,313,322,-1
C3orf49,15,16,291,322,-1
CENPU,5,6,311,322,-1
ZNF714,4,5,313,322,-1
BDNF,7,8,307,322,-1
KAZALD1,1,2,319,322,-1
KBTBD12,2,3,317,322,-1
RCHY1,9,10,303,322,-1
ATXN3L,3,4,315,322,-1
ABCB10,4,5,313,322,-1
SCRN2,14,15,293,322,-1
EGFL8,35,36,251,322,-1
AP3M2,8,9,305,322,-1
DRD1,0,1,321,322,-1
ANKRD50,6,7,309,322,-1
DEGS1,2,3,317,322,-1
CD248,4,5,313,322,-1
OR2AK2,3,4,315,322,-1
GLP1R,0,1,321,322,-1
MROH5,0,1,321,322,-1
DEGS2,12,13,297,322,-1
SGCD,2,3,317,322,-1
SGCG,5,6,311,322,-1
DRC1,8,9,305,322,-1
KANK4,3,4,315,322,-1
SGCZ,0,1,321,322,-1
FUT6,7,8,307,322,-1
PRKD3,6,7,309,322,-1
MROH2A,4,5,313,322,-1
BCLAF3,7,8,307,322,-1
ONECUT1,4,5,313,322,-1
OXSM,6,7,309,322,-1
PIRT,0,1,321,322,-1
SCNN1A,7,8,307,322,-1
ZNF354C,3,4,315,322,-1
C3orf22,1,2,319,322,-1
HOXA10,5,6,311,322,-1
DRD2,4,5,313,322,-1
SPTSSA,3,4,315,322,-1
SPTLC3,4,5,313,322,-1
KCND2,5,6,311,322,-1
NME6,3,4,315,322,-1
SH3D21,6,7,309,322,-1
ZNF546,6,7,309,322,-1
PROKR1,0,1,321,322,-1
EML5,3,4,315,322,-1
LIPH,6,7,309,322,-1
CRYAA2,4,5,313,322,-1
KCNB1,11,12,299,322,-1
AHSP,26,27,269,322,-1
CENPS,7,8,307,322,-1
NSUN7,4,5,313,322,-1
CYTL1,10,11,301,322,-1
ZNF722P,2,3,317,322,-1
PRMT8,0,1,321,322,-1
ULBP3,4,5,313,322,-1
SH2D2A,10,11,301,322,-1
PAQR4,8,9,305,322,-1
ZCCHC3,6,7,309,322,-1
KCNAB1,12,13,297,322,-1
PRMT9,3,4,315,322,-1
UIMC1,8,9,305,322,-1
SRD5A2,0,1,321,322,-1
OXR1,5,6,311,322,-1
FICD,10,11,301,322,-1
VANGL1,6,7,309,322,-1
ADAMTS5,1,2,319,322,-1
JPH2,1,2,319,322,-1
TRIM55,2,3,317,322,-1
SETD4,5,6,311,322,-1
SSU72P5,12,13,297,322,-1
SSU72P7,2,3,317,322,-1
C5,1,2,319,322,-1
SSX2IP,4,5,313,322,-1
FAM53C,7,8,307,322,-1
DENND2C,2,3,317,322,-1
CLP 1,6,7,309,322,-1
HSCB,6,7,309,322,-1
CD200R1L,1,2,319,322,-1
PRKAA1,3,4,315,322,-1
SETDB1,6,7,309,322,-1
ST3GAL5,7,8,307,322,-1
MBIP,8,9,305,322,-1
TNFSF8,0,1,321,322,-1
SSU72P3,9,10,303,322,-1
C5orf52,4,5,313,322,-1
ST6GALNAC3,10,11,301,322,-1
GREM2,5,6,311,322,-1
ZBBX,4,5,313,322,-1
OR10X1,0,1,321,322,-1
COL15A1,4,5,313,322,-1
SERTM2,0,1,321,322,-1
CROCC2,0,1,321,322,-1
PIGW,5,6,311,322,-1
NOP16,7,8,307,322,-1
STAC,3,4,315,322,-1
INF2,4,5,313,322,-1
OR52M1,0,1,321,322,-1
SDF2L1,8,9,305,322,-1
APPBP2,4,5,313,322,-1
CX3CL1,3,4,315,322,-1
SFI1,11,12,299,322,-1
GLOD5,12,13,297,322,-1
MROH9,0,1,321,322,-1
NME9,5,6,311,322,-1
NT5DC4,7,8,307,322,-1
GRAP,10,11,301,322,-1
PRKCD,11,12,299,322,-1
TRBJ1-2,0,1,321,322,-1
PAOX,20,21,281,322,-1
ADAD2,1,2,319,322,-1
RASAL3,2,3,317,322,-1
SFRP2,1,2,319,322,-1
IMPA1,6,7,309,322,-1
CACNG2,1,2,319,322,-1
TRAPPC9,11,12,299,322,-1
PDGFD,5,6,311,322,-1
CACNG1,5,6,311,322,-1
DENND2B,14,15,293,322,-1
LCE3B,0,1,321,322,-1
LCE3A,0,1,321,322,-1
P2RY13,2,3,317,322,-1
GSTT2,29,30,263,322,-1
NDUFC1,8,9,305,322,-1
EYA1,3,5,314,322,-2
TPRG1,2,4,316,322,-2
OR1N1,0,2,320,322,-2
TRAF5,3,5,314,322,-2
PLBD1,8,10,304,322,-2
TRMT12,5,7,310,322,-2
PEX11A,8,10,304,322,-2
OR14I1,0,2,320,322,-2
NEUROD6,0,2,320,322,-2
TPSG1,2,4,316,322,-2
EXTL3,11,13,298,322,-2
PIPOX,9,11,302,322,-2
HJV,4,6,312,322,-2
TRAV9-1,0,2,320,322,-2
PIN4,7,9,306,322,-2
FAM111A,3,5,314,322,-2
HELT,4,6,312,322,-2
HOXC12,3,5,314,322,-2
FAAP24,4,6,312,322,-2
NGB,1,3,318,322,-2
CT47A10,2,4,316,322,-2
ESRRG,4,6,312,322,-2
ANKRD33,5,7,310,322,-2
TMPRSS7,2,4,316,322,-2
TRBV7-7,4,6,312,322,-2
HDHD3,8,10,304,322,-2
NEUROG1,1,3,318,322,-2
TRDJ3,0,2,320,322,-2
CXCL3,11,13,298,322,-2
PDIA5,8,10,304,322,-2
TRBV6-1,2,4,316,322,-2
HMX2,4,6,312,322,-2
EXOSC9,6,8,308,322,-2
ANO7,3,5,314,322,-2
CLDN1,2,4,316,322,-2
NCAPG,5,7,310,322,-2
HMGCS2,4,6,312,322,-2
PHOX2A,10,12,300,322,-2
CTAGE1,2,4,316,322,-2
CLPS,16,18,288,322,-2
NFX1,5,7,310,322,-2
TRBV5-1,0,2,320,322,-2
TMEM60,8,10,304,322,-2
ABT1,5,7,310,322,-2
TRAJ48,0,2,320,322,-2
TSPAN4,7,9,306,322,-2
TRAJ46,1,3,318,322,-2
PI4K2B,2,4,316,322,-2
HERC3,4,6,312,322,-2
EXOC2,6,8,308,322,-2
HINT2,11,13,298,322,-2
GABRQ,2,4,316,322,-2
HOXA13,5,7,310,322,-2
EXOSC8,9,11,302,322,-2
ANKRD22,0,2,320,322,-2
APOC3,9,11,302,322,-2
CTXN2,4,6,312,322,-2
NBPF3,7,9,306,322,-2
HMGXB3,8,10,304,322,-2
CST5,5,7,310,322,-2
TRANK1,9,11,302,322,-2
GALNT12,6,8,308,322,-2
TRBV7-2,7,9,306,322,-2
PIDD1,4,6,312,322,-2
PDGFRL,8,10,304,322,-2
ABHD14B,4,6,312,322,-2
TMEM30B,1,3,318,322,-2
F9,0,2,320,322,-2
TNP1,7,9,306,322,-2
CXCR2,5,7,310,322,-2
HNF4G,3,5,314,322,-2
OR13D1,3,5,314,322,-2
PLAAT4,11,13,298,322,-2
F2RL2,4,6,312,322,-2
FIBIN,4,6,312,322,-2
HOATZ,2,4,316,322,-2
FGL2,1,3,318,322,-2
ARHGAP20,1,3,318,322,-2
TRGV10,3,5,314,322,-2
ERP27,2,4,316,322,-2
NAP1L5,6,8,308,322,-2
TRBV12-5,10,12,300,322,-2
ZNF567,4,6,312,322,-2
TRBV12-4,26,28,268,322,-2
IBSP,1,3,318,322,-2
ERFE,13,15,294,322,-2
PIMREG,10,12,300,322,-2
TMEM229B,5,7,310,322,-2
TRGV4,8,10,304,322,-2
ABHD8,13,15,294,322,-2
GAGE12C,4,6,312,322,-2
CLDN5,8,10,304,322,-2
OR10V1,10,12,300,322,-2
TRBV10-2,3,5,314,322,-2
CLEC4G,1,3,318,322,-2
ARHGAP6,1,3,318,322,-2
TRAJ26,1,3,318,322,-2
HK2,3,5,314,322,-2
PKHD1,0,2,320,322,-2
ZNF555,3,5,314,322,-2
CPSF3,6,8,308,322,-2
TP53TG3,14,16,292,322,-2
PDCD2,5,7,310,322,-2
FGR,1,3,318,322,-2
TRPC4,3,5,314,322,-2
HTN1,18,20,284,322,-2
HGH1,10,12,300,322,-2
TRBV25-1,14,16,292,322,-2
NAT1,6,8,308,322,-2
AQP5,3,5,314,322,-2
FHOD1,7,9,306,322,-2
NAPG,4,6,312,322,-2
HTD2,18,20,284,322,-2
PFN3,9,11,302,322,-2
PELI3,11,13,298,322,-2
FAM102B,3,5,314,322,-2
TSSK1B,1,3,318,322,-2
ARFRP1,7,9,306,322,-2
FAM86B2,32,34,256,322,-2
IDO2,0,2,320,322,-2
GNL3,8,10,304,322,-2
WNT7A,1,3,318,322,-2
WRAP53,6,8,308,322,-2
FPR3,0,2,320,322,-2
SLC25A28,6,8,308,322,-2
WSCD2,2,4,316,322,-2
RAB36,8,10,304,322,-2
SLC22A2,1,3,318,322,-2
RAB20,6,8,308,322,-2
ZNF837,8,10,304,322,-2
KRTAP4-1,3,5,314,322,-2
SLC20A1,8,10,304,322,-2
C1orf210,5,7,310,322,-2
C1orf232,5,7,310,322,-2
KRTAP4-7,6,8,308,322,-2
METTL25,7,9,306,322,-2
KRTAP19-2,4,6,312,322,-2
FLT3LG,4,6,312,322,-2
OR6K2,0,2,320,322,-2
CDCA2,4,6,312,322,-2
GOLGA8K,17,19,286,322,-2
C17orf100,6,8,308,322,-2
C17orf107,5,7,310,322,-2
C17orf113,4,6,312,322,-2
CDC42EP1,7,9,306,322,-2
CORO1A,17,19,286,322,-2
C19orf47,6,8,308,322,-2
SLC30A3,7,9,306,322,-2
FASTKD5,6,8,308,322,-2
SLC2A8,9,11,302,322,-2
NPS,0,2,320,322,-2
METTL8,5,7,310,322,-2
DEFA4,0,2,320,322,-2
DEFB106B,2,4,316,322,-2
SLC16A9,6,8,308,322,-2
C1orf53,16,18,288,322,-2
MED4,5,7,310,322,-2
DEFB121,1,3,318,322,-2
YBEY,7,9,306,322,-2
DSN1,5,7,310,322,-2
CD40,4,6,312,322,-2
LAMA2,2,4,316,322,-2
SHMT1,6,8,308,322,-2
CRB2,6,8,308,322,-2
SLC16A3,5,7,310,322,-2
LARGE2,12,14,296,322,-2
RANBP6,6,8,308,322,-2
SH3GL3,6,8,308,322,-2
YJU2,11,13,298,322,-2
C3orf18,9,11,302,322,-2
SGPP2,1,3,318,322,-2
RAD51AP1,8,10,304,322,-2
FBXO16,17,19,286,322,-2
XRCC2,3,5,314,322,-2
C20orf203,11,13,298,322,-2
SIRPB1,1,3,318,322,-2
SIRPD,2,4,316,322,-2
FOXS1,8,10,304,322,-2
GNAT3,3,5,314,322,-2
MELK,5,7,310,322,-2
SLC10A3,9,11,302,322,-2
XKR7,0,2,320,322,-2
CD86,2,4,316,322,-2
RAB7B,13,15,294,322,-2
SLC15A3,12,14,296,322,-2
RAB6C,1,3,318,322,-2
ODAM,2,4,316,322,-2
MEPE,0,2,320,322,-2
FREM3,0,2,320,322,-2
C16orf74,13,15,294,322,-2
KCNN4,6,8,308,322,-2
CEACAM21,2,4,316,322,-2
PRSS56,3,5,314,322,-2
EDA2R,5,7,310,322,-2
NPHP4,7,9,306,322,-2
CEACAM3,1,3,318,322,-2
GPR148,0,2,320,322,-2
PRY,0,2,320,322,-2
PSD2,3,5,314,322,-2
COL8A1,5,7,310,322,-2
VSTM2L,10,12,300,322,-2
BRINP2,3,5,314,322,-2
PSEN2,4,6,312,322,-2
BRMS1L,6,8,308,322,-2
SNED1,13,15,294,322,-2
KL,4,6,312,322,-2
SOX18,10,12,300,322,-2
PRSS2,3,5,314,322,-2
WFDC10A,11,13,298,322,-2
GPR20,6,8,308,322,-2
KCNU1,7,9,306,322,-2
SPATA3,4,6,312,322,-2
SPATA19,1,3,318,322,-2
KCTD16,0,2,320,322,-2
OSTN,5,7,310,322,-2
GPR22,4,6,312,322,-2
ACD,6,8,308,322,-2
EDN3,1,3,318,322,-2
MOV10L1,3,5,314,322,-2
COL6A3,2,4,316,322,-2
SPAG11A,7,9,306,322,-2
SPAG1,4,6,312,322,-2
MORN5,13,15,294,322,-2
SP5,3,5,314,322,-2
CDX1,0,2,320,322,-2
KLF14,2,4,316,322,-2
KLF15,6,8,308,322,-2
OR6Y1,1,3,318,322,-2
GP1BA,11,13,298,322,-2
SLCO1B1,0,2,320,322,-2
CDH9,23,25,274,322,-2
KPRP,0,2,320,322,-2
NUTM1,2,4,316,322,-2
FAS,6,8,308,322,-2
SLC5A4,1,3,318,322,-2
CDSN,2,4,316,322,-2
OR6V1,0,2,320,322,-2
MGAT4D,5,7,310,322,-2
WDR89,6,8,308,322,-2
WDR90,10,12,300,322,-2
C14orf93,11,13,298,322,-2
KRT35,0,2,320,322,-2
C11orf65,13,15,294,322,-2
SLITRK6,2,4,316,322,-2
FANCF,5,7,310,322,-2
PTER,1,3,318,322,-2
WDFY4,8,10,304,322,-2
SMC1B,1,3,318,322,-2
ADORA2B,6,8,308,322,-2
PSTPIP2,2,4,316,322,-2
DYNC2I1,10,12,300,322,-2
GPHN,8,10,304,322,-2
KLHL10,15,17,290,322,-2
OGN,4,6,312,322,-2
MMRN1,0,2,320,322,-2
KLF8,2,4,316,322,-2
VWDE,6,8,308,322,-2
BST1,5,7,310,322,-2
SMTNL2,7,9,306,322,-2
RAPGEF5,5,7,310,322,-2
GLRX2,7,9,306,322,-2
FLYWCH1,10,12,300,322,-2
RGPD8,29,31,262,322,-2
CCM2L,3,5,314,322,-2
ZSCAN23,5,7,310,322,-2
LRRC57,3,5,314,322,-2
LRRC61,9,11,302,322,-2
RTL1,1,3,318,322,-2
LRRC75A,9,11,302,322,-2
LRRC9,4,6,312,322,-2
RUNX2,1,3,318,322,-2
RGS18,0,2,320,322,-2
RRP1,7,9,306,322,-2
RGS9,1,3,318,322,-2
NXPH2,4,6,312,322,-2
RHBG,3,5,314,322,-2
GEMIN6,4,6,312,322,-2
COMMD3,8,10,304,322,-2
LRRC34,16,18,288,322,-2
LCE1C,2,4,316,322,-2
OR4F5,6,8,308,322,-2
MARCO,0,2,320,322,-2
SAA4,8,10,304,322,-2
OAS1,1,3,318,322,-2
DNAJC21,1,3,318,322,-2
ZFP28,3,5,314,322,-2
S100A2,9,11,302,322,-2
ZFP36L2,13,15,294,322,-2
LRRC32,3,5,314,322,-2
CCNA1,8,10,304,322,-2
RXYLT1,2,4,316,322,-2
RFX2,12,14,296,322,-2
GGA3,7,9,306,322,-2
RUSF1,7,9,306,322,-2
OR4F17,4,6,312,322,-2
DNAAF2,7,9,306,322,-2
GEMIN5,4,6,312,322,-2
DMWD,6,8,308,322,-2
GCNT3,6,8,308,322,-2
MAG,2,4,316,322,-2
MAGEA1,2,4,316,322,-2
RIPPLY2,18,20,284,322,-2
MAGEA12,2,4,316,322,-2
MANSC1,4,6,312,322,-2
ZNF20,7,9,306,322,-2
ZNF221,4,6,312,322,-2
ZSCAN9,9,11,302,322,-2
MAGEC3,2,4,316,322,-2
FOLR1,9,11,302,322,-2
MAGEL2,1,3,318,322,-2
MAGOHB,5,7,310,322,-2
MAN1A1,4,6,312,322,-2
ACOT11,3,5,314,322,-2
FNDC8,5,7,310,322,-2
GDAP1,7,9,306,322,-2
ZNF17,9,11,302,322,-2
MAD2L1BP,9,11,302,322,-2
MAOB,1,3,318,322,-2
RIN1,10,12,300,322,-2
OR2T8,0,2,320,322,-2
DLGAP5,5,7,310,322,-2
CCDC9B,9,11,302,322,-2
CCDC159,20,22,280,322,-2
CCDC157,2,4,316,322,-2
CCDC141,2,4,316,322,-2
LY6L,1,3,318,322,-2
RPP25,5,7,310,322,-2
RPP25L,9,11,302,322,-2
ZMYND8,22,24,276,322,-2
ZMYND19,5,7,310,322,-2
CCND1,8,10,304,322,-2
LRFN3,9,11,302,322,-2
LRFN2,0,2,320,322,-2
FOXN1,2,4,316,322,-2
LDLRAP1,4,6,312,322,-2
CRADD,7,9,306,322,-2
RBFA,8,10,304,322,-2
SEPTIN9,12,14,296,322,-2
FMN1,6,8,308,322,-2
FMNL1,6,8,308,322,-2
LGALS12,1,3,318,322,-2
LHFPL1,2,4,316,322,-2
FMO1,1,3,318,322,-2
CCR9,1,3,318,322,-2
GKN2,0,2,320,322,-2
OR52B2,4,6,312,322,-2
LGI2,4,6,312,322,-2
LGI4,2,4,316,322,-2
RBBP6,8,10,304,322,-2
SERPINA5,7,9,306,322,-2
GLIPR1L1,10,12,300,322,-2
SERPINA9,0,2,320,322,-2
SERPINB1,2,4,316,322,-2
SERPINB2,7,9,306,322,-2
ADAMTS12,0,2,320,322,-2
DPPA3,10,12,300,322,-2
C6orf47,6,8,308,322,-2
C6orf15,1,3,318,322,-2
NR1I3,9,11,302,322,-2
LCN8,4,6,312,322,-2
OR52N4,1,3,318,322,-2
ZNF879,7,9,306,322,-2
C4orf54,0,2,320,322,-2
ZNF878,6,8,308,322,-2
OR52W1,6,8,308,322,-2
CAB39L,4,6,312,322,-2
MC3R,1,3,318,322,-2
CAPG,7,9,306,322,-2
CAMK2N2,8,10,304,322,-2
SCGB1A1,21,23,278,322,-2
CALML5,1,3,318,322,-2
SCARF2,7,9,306,322,-2
REG1A,3,5,314,322,-2
LMX1B,2,4,316,322,-2
LOX,7,9,306,322,-2
LOXL3,7,9,306,322,-2
CABS1,0,2,320,322,-2
FNBP4,7,9,306,322,-2
LPAR2,12,14,296,322,-2
GINS1,4,6,312,322,-2
OR4P4,3,5,314,322,-2
SASH3,0,2,320,322,-2
LPXN,3,5,314,322,-2
ACY3,2,4,316,322,-2
CCNJL,4,6,312,322,-2
CALHM4,9,11,302,322,-2
SCN2A,4,6,312,322,-2
ZCCHC4,3,5,314,322,-2
RCOR3,7,9,306,322,-2
SCRT2,5,7,310,322,-2
MBD3L1,3,5,314,322,-2
SCYGR6,2,4,316,322,-2
SDC4,4,6,312,322,-2
FOXL2,1,3,318,322,-2
RBPJL,5,7,310,322,-2
MBNL3,3,5,314,322,-2
CRABP1,4,6,312,322,-2
RBMY1E,0,2,320,322,-2
MBOAT1,1,3,318,322,-2
LHX8,2,4,316,322,-2
KCNQ3,2,4,316,322,-2
PRXL2B,9,11,302,322,-2
KCNK9,3,5,314,322,-2
H2AC6,14,16,292,322,-2
IGLJ3,3,5,314,322,-2
MTPAP,4,6,312,322,-2
IGLV3-10,1,3,318,322,-2
ATL2,11,13,298,322,-2
ATOH1,2,4,316,322,-2
H2AC7,39,41,242,322,-2
TBX22,0,2,320,322,-2
CGNL1,2,4,316,322,-2
POP1,4,6,312,322,-2
ATP11C,4,6,312,322,-2
ATP12A,0,2,320,322,-2
ZNF649,8,10,304,322,-2
CHAF1B,2,4,316,322,-2
ALDH3B2,5,7,310,322,-2
POLR1H,9,11,302,322,-2
IGLC3,8,10,304,322,-2
ZNF625,10,12,300,322,-2
POLH,7,9,306,322,-2
IGKV3D-11,1,3,318,322,-2
IGKV3-20,0,2,320,322,-2
ALPK2,1,3,318,322,-2
ALPL,8,10,304,322,-2
UBE2A,5,7,310,322,-2
IGKV1D-16,3,5,314,322,-2
H3C11,26,28,268,322,-2
IGKV1-8,6,8,308,322,-2
TESMIN,4,6,312,322,-2
ALX3,7,9,306,322,-2
MUC5B,3,5,314,322,-2
IGKJ5,0,2,320,322,-2
TEX33,5,7,310,322,-2
NLRC5,16,18,288,322,-2
IHO1,3,5,314,322,-2
TEX51,2,4,316,322,-2
CYTH4,10,12,300,322,-2
FUT9,3,5,314,322,-2
TAF11L6,2,4,316,322,-2
TAF11L4,4,6,312,322,-2
TAF11L12,1,3,318,322,-2
CYRIA,4,6,312,322,-2
PAQR8,8,10,304,322,-2
IL7,11,13,298,322,-2
CRYGB,1,3,318,322,-2
SYTL2,9,11,302,322,-2
CNTN3,0,2,320,322,-2
GTF2B,9,11,302,322,-2
EMID1,11,13,298,322,-2
MSMP,12,14,296,322,-2
CFAP299,6,8,308,322,-2
UGT2A3,1,3,318,322,-2
PARP10,10,12,300,322,-2
MTBP,5,7,310,322,-2
ATP6V1E2,4,6,312,322,-2
ENOX2,3,5,314,322,-2
UGT1A10,5,7,310,322,-2
IL1RN,2,4,316,322,-2
PPFIA2,11,13,298,322,-2
IL1RAPL2,1,3,318,322,-2
IL1A,5,7,310,322,-2
GAS2,20,22,280,322,-2
FAM20A,11,13,298,322,-2
ENPP7,0,2,320,322,-2
NLRP14,1,3,318,322,-2
GUCY2D,0,2,320,322,-2
ENTPD2,2,4,316,322,-2
GULP1,2,4,316,322,-2
FZD10,3,5,314,322,-2
PCDHA4,2,4,316,322,-2
ZNF681,1,3,318,322,-2
CHST14,7,9,306,322,-2
GALNT6,1,3,318,322,-2
PCNA,8,10,304,322,-2
IFNLR1,3,5,314,322,-2
IFRD2,9,11,302,322,-2
ARMC3,5,7,310,322,-2
IFT81,4,6,312,322,-2
CHST13,5,7,310,322,-2
TUBA4B,8,10,304,322,-2
HBE1,8,10,304,322,-2
CNBD2,3,5,314,322,-2
ABCF2-H2BE1,11,13,298,322,-2
EPPIN,2,4,316,322,-2
PLN,7,9,306,322,-2
CYB5R1,8,10,304,322,-2
IFNK,5,7,310,322,-2
IFNGR2,6,8,308,322,-2
MYO16,2,4,316,322,-2
ANKFY1,9,11,302,322,-2
NHS,3,5,314,322,-2
TMEM132C,0,2,320,322,-2
TMEM140,12,14,296,322,-2
ANKK1,11,13,298,322,-2
TTC34,2,4,316,322,-2
MYO3B,0,2,320,322,-2
ZNF440,7,9,306,322,-2
PLEC,8,10,304,322,-2
IFIT2,8,10,304,322,-2
CHST9,3,5,314,322,-2
FIGNL1,7,9,306,322,-2
GALNT5,1,3,318,322,-2
TMEM185B,3,5,314,322,-2
TM4SF19,3,5,314,322,-2
ARPP21,5,7,310,322,-2
PNOC,8,10,304,322,-2
TGFBI,8,10,304,322,-2
FAM156A,15,17,290,322,-2
PNLIPRP3,0,2,320,322,-2
MXRA5,0,2,320,322,-2
CYLC2,1,3,318,322,-2
TXNDC8,7,9,306,322,-2
IGHV3-73,5,7,310,322,-2
IGHV3OR15-7,0,2,320,322,-2
CNFN,25,27,270,322,-2
H4C15,23,25,274,322,-2
TFRC,8,10,304,322,-2
TYMP,38,40,244,322,-2
IGHV3OR16-17,1,3,318,322,-2
ASH2L,9,11,302,322,-2
PNO1,3,5,314,322,-2
IGHV3-53,4,6,312,322,-2
IGHV3-48,3,5,314,322,-2
THBS2,7,9,306,322,-2
IGHV3-16,13,15,294,322,-2
THEM6,7,9,306,322,-2
ASB14,4,6,312,322,-2
AMTN,3,5,314,322,-2
PCDHB9,4,6,312,322,-2
PMEL,8,10,304,322,-2
ARVCF,9,11,302,322,-2
MYH1,0,2,320,322,-2
ART1,7,9,306,322,-2
FZD9,8,10,304,322,-2
MYH4,0,2,320,322,-2
PCDHGB3,2,4,316,322,-2
ARRDC2,5,7,310,322,-2
PLPPR3,14,16,292,322,-2
UNC5B,6,8,308,322,-2
ABRACL,6,8,308,322,-2
BCAS4,3,5,314,322,-2
FAM50A,7,9,306,322,-2
STAT5A,9,11,302,322,-2
DAXX,10,12,300,322,-2
STC1,3,5,314,322,-2
KCNE1,4,6,312,322,-2
PROK2,4,6,312,322,-2
STEAP1B,15,17,290,322,-2
FAM81B,21,23,278,322,-2
PABPC1L2A,0,2,320,322,-2
BATF,7,9,306,322,-2
KCNF1,7,9,306,322,-2
STK32C,10,12,300,322,-2
OR2AJ1,4,6,312,322,-2
GPR87,6,8,308,322,-2
ISX,0,2,320,322,-2
KCNIP1,6,8,308,322,-2
SRRM4,3,5,314,322,-2
USP17L5,0,2,320,322,-2
KCNIP2,8,10,304,322,-2
ISLR,8,10,304,322,-2
PRB4,4,6,312,322,-2
COL3A1,3,5,314,322,-2
BAHCC1,4,6,312,322,-2
IRF9,6,8,308,322,-2
STAT4,11,13,298,322,-2
STARD13,4,6,312,322,-2
USP17L13,0,2,320,322,-2
EIF4E3,3,5,314,322,-2
CENPVL3,0,2,320,322,-2
PRL,5,7,310,322,-2
P2RX2,4,6,312,322,-2
KATNB1,10,12,300,322,-2
SRSF5,12,14,296,322,-2
COL1A2,2,4,316,322,-2
MROH7,2,4,316,322,-2
MROH7-TTC4,2,4,316,322,-2
JAKMIP3,1,3,318,322,-2
MRPL15,7,9,306,322,-2
SREBF1,10,12,300,322,-2
SSX2,4,6,312,322,-2
DBF4,4,6,312,322,-2
BCHE,7,9,306,322,-2
ST18,1,3,318,322,-2
IZUMO4,18,20,284,322,-2
NOS3,3,5,314,322,-2
IVL,0,2,320,322,-2
SQLE,8,10,304,322,-2
ITM2A,2,4,316,322,-2
AIPL1,4,6,312,322,-2
ABCB5,1,3,318,322,-2
AJAP1,1,3,318,322,-2
PRAMEF19,0,2,320,322,-2
UTY,1,3,318,322,-2
PRAMEF13,1,3,318,322,-2
NMUR1,1,3,318,322,-2
MS4A18,0,2,320,322,-2
B3GNT4,16,18,288,322,-2
MSANTD3-TMEFF1,22,24,276,322,-2
B3GALT1,4,6,312,322,-2
ACAT2,6,8,308,322,-2
INSIG2,6,8,308,322,-2
GPR52,10,12,300,322,-2
DAB2IP,20,22,280,322,-2
GSG1L,8,10,304,322,-2
AZI2,4,6,312,322,-2
MS4A13,4,6,312,322,-2
NMU,4,6,312,322,-2
FAM236D,2,4,316,322,-2
FAM236C,0,2,320,322,-2
SPHKAP,0,2,320,322,-2
GSTA1,7,9,306,322,-2
CNTN6,1,3,318,322,-2
SYDE1,8,10,304,322,-2
PRR15,4,6,312,322,-2
EMCN,1,3,318,322,-2
MPPED1,2,4,316,322,-2
SUSD1,2,4,316,322,-2
VCY1B,4,6,312,322,-2
SUCLG2,5,7,310,322,-2
SPINT1,6,8,308,322,-2
IQSEC1,8,10,304,322,-2
VEPH1,13,15,294,322,-2
CENPB,9,11,302,322,-2
KCNJ11,6,8,308,322,-2
AKAP4,1,3,318,322,-2
AKAP7,7,9,306,322,-2
DCAF16,6,8,308,322,-2
HDAC4,14,17,291,322,-3
ZGRF1,3,6,313,322,-3
CRISPLD1,12,15,295,322,-3
HBQ1,14,17,291,322,-3
VSIG4,0,3,319,322,-3
VAMP4,6,9,307,322,-3
FEM1B,9,12,301,322,-3
ORC1,6,9,307,322,-3
ZNF230,2,5,315,322,-3
TTC32,7,10,305,322,-3
FAM83H,3,6,313,322,-3
TTC30A,3,6,313,322,-3
COL21A1,2,5,315,322,-3
PDCD2L,9,12,301,322,-3
NFXL1,4,7,311,322,-3
VCY,1,4,317,322,-3
PDGFRB,5,8,309,322,-3
VNN1,0,3,319,322,-3
TTLL11,8,11,303,322,-3
FAM90A22P,0,3,319,322,-3
ZNF165,2,5,315,322,-3
ACOT12,9,12,301,322,-3
FDPS,4,7,311,322,-3
GCLM,3,6,313,322,-3
GPR141,2,5,315,322,-3
ZMYM1,5,8,309,322,-3
CRIP1,13,16,293,322,-3
OVOL2,3,6,313,322,-3
ZMAT4,7,10,305,322,-3
FAM110C,3,6,313,322,-3
TRPM5,2,5,315,322,-3
GET1-SH3BGR,25,28,269,322,-3
ACCSL,1,4,317,322,-3
ZNF217,11,14,297,322,-3
NPHP3-ACAD11,13,16,293,322,-3
AGAP9,6,9,307,322,-3
ZNF22,8,11,303,322,-3
TRIM24,9,12,301,322,-3
GALNT4,15,18,289,322,-3
OR2AP1,5,8,309,322,-3
GFI1,0,3,319,322,-3
TUBAL3,3,6,313,322,-3
ZIC4,4,7,311,322,-3
FAM133A,2,5,315,322,-3
ZNF467,10,13,299,322,-3
ZNF19,7,10,305,322,-3
GPR158,2,5,315,322,-3
FAM228B,16,19,287,322,-3
PCDHB6,0,3,319,322,-3
ZBTB47,7,10,305,322,-3
ADAMTS20,1,4,317,322,-3
FBLIM1,4,7,311,322,-3
TSPAN18,10,13,299,322,-3
FAM207A,8,11,303,322,-3
ZADH2,8,11,303,322,-3
PATE2,6,9,307,322,-3
NLRP12,0,3,319,322,-3
WNT10A,2,5,315,322,-3
ZNF317,11,14,297,322,-3
USP12,5,8,309,322,-3
USP17L22,2,5,315,322,-3
FAM187A,18,21,283,322,-3
ANKZF1,11,14,297,322,-3
FAM178B,7,10,305,322,-3
ZNF319,9,12,301,322,-3
PAGE4,15,18,289,322,-3
GTSF1,3,6,313,322,-3
PAH,8,11,303,322,-3
UPK3BL1,17,20,285,322,-3
OR5H6,1,4,317,322,-3
GTF2A1,7,10,305,322,-3
XDH,0,3,319,322,-3
GNAT2,11,14,297,322,-3
UMOD,1,4,317,322,-3
FBXL5,9,12,301,322,-3
FAM216B,1,4,317,322,-3
VIPR2,3,6,313,322,-3
GSG1L2,3,6,313,322,-3
PARL,5,8,309,322,-3
CRB3,9,12,301,322,-3
OR6A2,2,5,315,322,-3
GLYATL2,6,9,307,322,-3
ADARB2,0,3,319,322,-3
ACAN,2,5,315,322,-3
FBXO43,3,6,313,322,-3
GPX5,4,7,311,322,-3
GOLGA8Q,5,8,309,322,-3
NFKBIE,11,14,297,322,-3
FAR2,17,20,285,322,-3
H4-16,6,9,307,322,-3
CRHR1,4,7,311,322,-3
GPD1L,5,8,309,322,-3
GRAP2,4,7,311,322,-3
GIMAP5,1,4,317,322,-3
NEK3,14,17,291,322,-3
ZFAND1,6,9,307,322,-3
ZFAND4,5,8,309,322,-3
ACTR5,7,10,305,322,-3
P2RX4,9,12,301,322,-3
CNIH3,3,6,313,322,-3
TXNDC15,3,6,313,322,-3
GPX6,1,4,317,322,-3
GNG11,0,3,319,322,-3
WDR44,4,7,311,322,-3
OR7G1,1,4,317,322,-3
ADAM12,3,6,313,322,-3
OR52D1,2,5,315,322,-3
H2BC13,34,37,251,322,-3
USP29,24,27,271,322,-3
COG2,5,8,309,322,-3
ZC2HC1B,9,12,301,322,-3
WDR91,3,6,313,322,-3
PCDH11X,0,3,319,322,-3
AMBN,4,7,311,322,-3
TRIM6,4,7,311,322,-3
GCA,8,11,303,322,-3
OR51I1,0,3,319,322,-3
GANC,3,6,313,322,-3
FBXW12,7,10,305,322,-3
GP1BB,33,36,253,322,-3
ADAMTSL1,4,7,311,322,-3
MAML3,6,9,307,322,-3
IGLV3-21,2,5,315,322,-3
MINDY4,6,9,307,322,-3
PNLIPRP1,2,5,315,322,-3
PTCHD1,1,4,317,322,-3
DDI1,2,5,315,322,-3
KLRB1,2,5,315,322,-3
THEM5,5,8,309,322,-3
PTGES,3,6,313,322,-3
THOC3,7,10,305,322,-3
IGHV2-26,0,3,319,322,-3
SLX1A,39,42,241,322,-3
FZD6,1,4,317,322,-3
MIS18BP1,8,11,303,322,-3
SLCO6A1,5,8,309,322,-3
KLHL31,0,3,319,322,-3
SLCO2A1,1,4,317,322,-3
SLCO1B3-SLCO1B7,2,5,315,322,-3
DUSP23,14,17,291,322,-3
PTPN3,2,5,315,322,-3
TIGD4,2,5,315,322,-3
KRT2,0,3,319,322,-3
FIZ1,8,11,303,322,-3
PLXNA4,2,5,315,322,-3
TIMP4,6,9,307,322,-3
MGAT4C,2,5,315,322,-3
TK1,4,7,311,322,-3
KLHL38,1,4,317,322,-3
PSORS1C1,17,20,285,322,-3
PXDNL,0,3,319,322,-3
PSMA8,0,3,319,322,-3
KIF23,4,7,311,322,-3
TEX26,3,6,313,322,-3
TEX30,5,8,309,322,-3
DCP1B,6,9,307,322,-3
MOB3C,3,6,313,322,-3
KIR2DL1,0,3,319,322,-3
SNRK,7,10,305,322,-3
ASPM,4,7,311,322,-3
PSMA2,12,15,295,322,-3
E2F6,6,9,307,322,-3
PNPLA3,3,6,313,322,-3
E2F3,3,6,313,322,-3
MMGT1,6,9,307,322,-3
MNS1,3,6,313,322,-3
CDS1,1,4,317,322,-3
IGHV3OR16-8,0,3,319,322,-3
TFPI2,11,14,297,322,-3
IGHV3OR16-13,1,4,317,322,-3
TFR2,6,9,307,322,-3
DZIP1L,8,11,303,322,-3
KLHDC1,7,10,305,322,-3
MX1,1,4,317,322,-3
SMIM3,4,7,311,322,-3
PSMG1,5,8,309,322,-3
SLC47A2,0,3,319,322,-3
ARR3,7,10,305,322,-3
SIGLEC9,1,4,317,322,-3
CDA,4,7,311,322,-3
PLEKHG3,11,14,297,322,-3
TMEM114,2,5,315,322,-3
C1orf105,22,25,275,322,-3
TMEM121,10,13,299,322,-3
KRTAP22-1,5,8,309,322,-3
KRTAP22-2,4,7,311,322,-3
MYO18B,2,5,315,322,-3
SLC22A9,0,3,319,322,-3
SLC20A2,6,9,307,322,-3
SLC18B1,6,9,307,322,-3
SLC18A3,1,4,317,322,-3
MEOX2,1,4,317,322,-3
KRTAP20-4,14,17,291,322,-3
MYO1D,3,6,313,322,-3
DEFB108B,12,15,295,322,-3
KRTAP6-2,4,7,311,322,-3
MYO1E,10,13,299,322,-3
MEIS1,7,10,305,322,-3
CD69,5,8,309,322,-3
EPYC,0,3,319,322,-3
TMEM17,4,7,311,322,-3
SIPA1,5,8,309,322,-3
MEGF6,0,3,319,322,-3
CHSY3,2,5,315,322,-3
METTL18,8,11,303,322,-3
TMEM106B,3,6,313,322,-3
C16orf54,1,4,317,322,-3
KRTAP10-6,0,3,319,322,-3
ODR4,3,6,313,322,-3
IGFL3,15,18,289,322,-3
NT5C1B-RDH14,1,4,317,322,-3
IGFL2,17,20,285,322,-3
EPHX3,18,21,283,322,-3
CDC45,6,9,307,322,-3
C16orf96,0,3,319,322,-3
SLC35A1,6,9,307,322,-3
C17orf78,4,7,311,322,-3
MYLK4,0,3,319,322,-3
KRTAP10-4,2,5,315,322,-3
PLK3,6,9,307,322,-3
RAB24,8,11,303,322,-3
TMC3,2,5,315,322,-3
AURKA,8,11,303,322,-3
KRTAP12-1,2,5,315,322,-3
TMCO6,11,14,297,322,-3
C19orf12,8,11,303,322,-3
SLC27A3,7,10,305,322,-3
SLC26A1,8,11,303,322,-3
KRTAP19-3,3,6,313,322,-3
SLC25A43,2,5,315,322,-3
SLC25A36,10,13,299,322,-3
IFT122,5,8,309,322,-3
IGKV1-33,11,14,297,322,-3
KIF22,10,13,299,322,-3
SNX20,1,4,317,322,-3
BARHL1,6,9,307,322,-3
TAGLN,11,14,297,322,-3
IL1R1,5,8,309,322,-3
TAPBPL,5,8,309,322,-3
ZNF705B,1,4,317,322,-3
PRAMEF33,1,4,317,322,-3
IRX3,4,7,311,322,-3
TARS2,6,9,307,322,-3
IRX4,7,10,305,322,-3
ISCA2,4,7,311,322,-3
ENPP5,1,4,317,322,-3
ISM1,3,6,313,322,-3
MRPS18B,4,7,311,322,-3
PRAMEF11,0,3,319,322,-3
ATP5MF-PTCD1,21,24,277,322,-3
ITGA11,4,7,311,322,-3
STING1,7,10,305,322,-3
TAT,3,6,313,322,-3
STH,28,31,263,322,-3
MTF2,5,8,309,322,-3
STEAP3,4,7,311,322,-3
PRDM9,4,7,311,322,-3
CEP295,7,10,305,322,-3
ITPKA,9,12,301,322,-3
ITPR1,6,9,307,322,-3
B9D1,11,14,297,322,-3
PRAMEF10,1,4,317,322,-3
POGLUT2,3,6,313,322,-3
CFAP74,27,30,265,322,-3
DAB1,6,9,307,322,-3
AWAT1,1,4,317,322,-3
PPP1R1B,8,11,303,322,-3
INO80,6,9,307,322,-3
OPN1LW,2,5,315,322,-3
SYS1-DBNDD2,34,37,251,322,-3
OPCML,0,3,319,322,-3
INPP1,3,6,313,322,-3
INPP5D,10,13,299,322,-3
ATXN10,10,13,299,322,-3
NTF3,9,12,301,322,-3
ZNF671,3,6,313,322,-3
STXBP3,6,9,307,322,-3
B3GALT5,1,4,317,322,-3
ATR,6,9,307,322,-3
CFAP91,4,7,311,322,-3
CES1,15,18,289,322,-3
DAGLA,7,10,305,322,-3
MS4A12,2,5,315,322,-3
TAF11L2,1,4,317,322,-3
PPT2-EGFL8,11,14,297,322,-3
TAF11L9,2,5,315,322,-3
ATP8A1,8,11,303,322,-3
MRPS31,7,10,305,322,-3
PRICKLE3,4,7,311,322,-3
ATP2C2,2,5,315,322,-3
IWS1,9,12,301,322,-3
EEFSEC,5,8,309,322,-3
SPDYE8,10,13,299,322,-3
KCNK2,5,8,309,322,-3
EFHC2,1,4,317,322,-3
MTRNR2L13,1,4,317,322,-3
CYP2C9,2,5,315,322,-3
SPATA31A6,0,3,319,322,-3
ZNF625-ZNF20,22,25,275,322,-3
IGLJ2,1,4,317,322,-3
SPATA25,17,20,285,322,-3
POLR2A,11,14,297,322,-3
TDRD10,3,6,313,322,-3
SPATA13,9,12,301,322,-3
TBC1D3D,24,27,271,322,-3
KCTD9,4,7,311,322,-3
EEF1AKMT4,9,12,301,322,-3
TEKT5,7,10,305,322,-3
SPACA6,7,10,305,322,-3
CYP26C1,3,6,313,322,-3
MUC15,2,5,315,322,-3
PRSS12,8,11,303,322,-3
SP100,1,4,317,322,-3
BPIFA2,1,4,317,322,-3
TEPP,7,10,305,322,-3
EDAR,8,11,303,322,-3
MPP3,3,6,313,322,-3
KCNK16,0,3,319,322,-3
BLOC1S3,6,9,307,322,-3
TCF21,3,6,313,322,-3
JAGN1,6,9,307,322,-3
TBC1D8,4,7,311,322,-3
IGLV8-61,6,9,307,322,-3
SSTR3,0,3,319,322,-3
FSTL5,1,4,317,322,-3
IGLV5-52,20,23,279,322,-3
BCL2L14,8,11,303,322,-3
JMJD7-PLA2G4B,18,21,283,322,-3
EID2B,2,5,315,322,-3
SRRD,2,5,315,322,-3
MRO,2,5,315,322,-3
EGFLAM,7,10,305,322,-3
KCNA5,0,3,319,322,-3
TBX15,3,6,313,322,-3
ATP11A,7,10,305,322,-3
SPSB1,8,11,303,322,-3
CENPJ,5,8,309,322,-3
MRGBP,5,8,309,322,-3
IGLV3-27,2,5,315,322,-3
TCAF2,3,6,313,322,-3
NTNG1,0,3,319,322,-3
KCNJ16,10,13,299,322,-3
EFNA1,6,9,307,322,-3
CXorf56,2,5,315,322,-3
SLC28A3,0,3,319,322,-3
RFC5,6,9,307,322,-3
TRAV38-1,1,4,317,322,-3
TNFRSF1B,3,6,313,322,-3
RCAN1,7,10,305,322,-3
DLK1,4,7,311,322,-3
RCAN2,0,3,319,322,-3
RHOXF2B,7,10,305,322,-3
RHOXF2,0,3,319,322,-3
RCE1,7,10,305,322,-3
FOXH1,7,10,305,322,-3
MAB21L2,7,10,305,322,-3
RHOV,5,8,309,322,-3
TNP2,3,6,313,322,-3
MATN1,0,3,319,322,-3
SCFD2,3,6,313,322,-3
CCDC14,8,11,303,322,-3
SCAND1,11,14,297,322,-3
PIEZO1,10,13,299,322,-3
PIK3R2,8,11,303,322,-3
PIM2,7,10,305,322,-3
MCCC1,2,5,315,322,-3
TRBJ2-4,4,7,311,322,-3
HSPB7,7,10,305,322,-3
LGALS2,14,17,291,322,-3
CLEC6A,0,3,319,322,-3
TRBV6-4,2,5,315,322,-3
RNF34,10,13,299,322,-3
GAL3ST4,6,9,307,322,-3
CCDC85B,10,13,299,322,-3
NUDT6,6,9,307,322,-3
TNFAIP8,6,9,307,322,-3
DES,3,6,313,322,-3
RBMXL3,1,4,317,322,-3
HSFY2,3,6,313,322,-3
TRAJ16,1,4,317,322,-3
LIG1,6,9,307,322,-3
ABHD12B,5,8,309,322,-3
CCDC178,4,7,311,322,-3
ZSWIM2,7,10,305,322,-3
LPCAT2,3,6,313,322,-3
PGGT1B,5,8,309,322,-3
RFX8,7,10,305,322,-3
NDC80,5,8,309,322,-3
TRAJ6,0,3,319,322,-3
LRRN4,8,11,303,322,-3
APCDD1,4,7,311,322,-3
LRRC3,2,5,315,322,-3
CBARP,8,11,303,322,-3
CAVIN3,3,6,313,322,-3
RTP4,1,4,317,322,-3
NDUFAF7,3,6,313,322,-3
CCL7,8,11,303,322,-3
TRAC,10,13,299,322,-3
FHDC1,4,7,311,322,-3
LRRC71,3,6,313,322,-3
LRRC74B,9,12,301,322,-3
TRAJ17,0,3,319,322,-3
HOXA9,8,11,303,322,-3
CCNB1,7,10,305,322,-3
CBLN4,0,3,319,322,-3
CARD19,8,11,303,322,-3
LSR,9,12,301,322,-3
DGKG,0,3,319,322,-3
CCNE1,4,7,311,322,-3
SAMD5,5,8,309,322,-3
ETV6,7,10,305,322,-3
MARCOL,0,3,319,322,-3
TRAV19,9,12,301,322,-3
LRIT1,2,5,315,322,-3
PGLYRP3,0,3,319,322,-3
NSRP1,7,10,305,322,-3
REX1BD,9,12,301,322,-3
NCF2,11,14,297,322,-3
HOOK2,8,11,303,322,-3
TP53RK,2,5,315,322,-3
OAF,3,6,313,322,-3
CCL15,18,21,283,322,-3
ARHGAP11A,4,7,311,322,-3
DLC1,4,7,311,322,-3
FOXB2,1,4,317,322,-3
DENND1C,4,7,311,322,-3
CT55,5,8,309,322,-3
C6orf136,8,11,303,322,-3
MAGEC1,0,3,319,322,-3
CCDC74A,8,11,303,322,-3
MAGEC2,4,7,311,322,-3
RASSF6,0,3,319,322,-3
PKLR,2,5,315,322,-3
CT47B1,0,3,319,322,-3
RASSF1,6,9,307,322,-3
MCTP2,1,4,317,322,-3
CCDC8,3,6,313,322,-3
CD22,10,13,299,322,-3
RNF128,3,6,313,322,-3
ZNF572,3,6,313,322,-3
HYDIN,12,15,295,322,-3
AOC1,7,10,305,322,-3
CCDC51,8,11,303,322,-3
PEX11G,17,20,285,322,-3
PLA2G3,1,4,317,322,-3
CD300LD,3,6,313,322,-3
MDM1,4,7,311,322,-3
RNF135,4,7,311,322,-3
SH2D4A,3,6,313,322,-3
PLA2G4E,2,5,315,322,-3
SFXN4,7,10,305,322,-3
ICAM1,6,9,307,322,-3
RNF139,5,8,309,322,-3
SH2D3C,5,8,309,322,-3
CIB4,5,8,309,322,-3
SH2B2,10,13,299,322,-3
LARP6,3,6,313,322,-3
SGIP1,2,5,315,322,-3
DPP10,2,5,315,322,-3
RBL1,3,6,313,322,-3
ARHGEF39,3,6,313,322,-3
PLAT,6,9,307,322,-3
FLVCR2,10,13,299,322,-3
ARHGEF35,0,3,319,322,-3
HLTF,5,8,309,322,-3
NAALADL2,11,14,297,322,-3
CCDC39,15,18,289,322,-3
RNF186,2,5,315,322,-3
CT83,0,3,319,322,-3
RBM11,3,6,313,322,-3
TRDV2,5,8,309,322,-3
TMEM61,4,7,311,322,-3
RNF175,5,8,309,322,-3
SERPINA6,1,4,317,322,-3
AARSD1,12,15,295,322,-3
RNF113A,6,9,307,322,-3
CCZ1B,5,8,309,322,-3
TMEM200A,1,4,317,322,-3
C7orf33,4,7,311,322,-3
DPRX,12,15,295,322,-3
ZNF729,0,4,318,322,-4
INO80B,10,14,298,322,-4
ZMYND12,10,14,298,322,-4
ZNF730,12,16,294,322,-4
SPICE1,9,13,300,322,-4
LTF,0,4,318,322,-4
JRK,5,9,308,322,-4
NOTCH4,0,4,318,322,-4
DHRS12,16,20,286,322,-4
KCNJ9,2,6,314,322,-4
ACSF3,10,14,298,322,-4
FAM236A,6,10,306,322,-4
INKA2,9,13,300,322,-4
SYCP2L,5,9,308,322,-4
RHBDF1,13,17,292,322,-4
GSTA3,9,13,300,322,-4
RPS6KL1,13,17,292,322,-4
SYCE1,8,12,302,322,-4
PRND,3,7,312,322,-4
CCL27,43,47,232,322,-4
SPTA1,0,4,318,322,-4
GPR88,2,6,314,322,-4
COL18A1,2,6,314,322,-4
MALL,6,10,306,322,-4
RGS8,1,5,316,322,-4
RNF212B,7,11,304,322,-4
ZMYND15,1,5,316,322,-4
GRAMD2B,3,7,312,322,-4
MAB21L1,9,13,300,322,-4
OR2W3,2,6,314,322,-4
STK32B,1,5,316,322,-4
OR2M7,1,5,316,322,-4
RIN2,5,9,308,322,-4
USH2A,1,5,316,322,-4
USP17L24,4,8,310,322,-4
RMI2,6,10,306,322,-4
ZWILCH,7,11,304,322,-4
RNF212,5,9,308,322,-4
CCDC196,1,5,316,322,-4
NRG1,7,11,304,322,-4
NOC4L,7,11,304,322,-4
ELL,8,12,302,322,-4
STUM,1,5,316,322,-4
IRAK3,0,4,318,322,-4
ABCB9,1,5,316,322,-4
RNF25,11,15,296,322,-4
GASK1B,2,6,314,322,-4
RPGR,3,7,312,322,-4
CEP57L1,1,5,316,322,-4
GSAP,2,6,314,322,-4
SSX3,4,8,310,322,-4
LY6D,2,6,314,322,-4
RPP14,5,9,308,322,-4
LY75-CD302,0,4,318,322,-4
CFAP100,2,6,314,322,-4
ZNF256,3,7,312,322,-4
SSU72P8,1,5,316,322,-4
AKNA,4,8,310,322,-4
SSX1,5,9,308,322,-4
ZNF691,9,13,300,322,-4
RICTOR,4,8,310,322,-4
RMI1,8,12,302,322,-4
RHOJ,5,9,308,322,-4
P3H4,3,7,312,322,-4
MSH6,5,9,308,322,-4
STAB2,16,20,286,322,-4
BBS4,7,11,304,322,-4
ZNF223,5,9,308,322,-4
RIBC1,5,9,308,322,-4
SSX5,9,13,300,322,-4
XYLT2,13,17,292,322,-4
CATSPER1,1,5,316,322,-4
ACSM5,8,12,302,322,-4
DECR2,6,10,306,322,-4
C8B,0,4,318,322,-4
SLC35C1,9,13,300,322,-4
SLC35F2,1,5,316,322,-4
C16orf95,11,15,296,322,-4
SERF1A,27,31,264,322,-4
SLC38A5,7,11,304,322,-4
GOLGA8N,10,14,298,322,-4
ADAM28,0,4,318,322,-4
C16orf87,3,7,312,322,-4
MGAM2,1,5,316,322,-4
CA5A,11,15,296,322,-4
ZBTB7A,5,9,308,322,-4
PUS7,5,9,308,322,-4
CA5B,3,7,312,322,-4
SLC52A1,4,8,310,322,-4
SELL,3,7,312,322,-4
DOK7,6,10,306,322,-4
RBM4B,7,11,304,322,-4
GOLGA8T,17,21,284,322,-4
ACKR2,5,9,308,322,-4
ADAM19,4,8,310,322,-4
KRT19,5,9,308,322,-4
SLC9A3,4,8,310,322,-4
C11orf97,8,12,302,322,-4
ZC3H11B,3,7,312,322,-4
MIER2,9,13,300,322,-4
C17orf97,5,9,308,322,-4
ADAMTS16,5,9,308,322,-4
DEFA1,6,10,306,322,-4
XCR1,12,16,294,322,-4
SIGLECL1,4,8,310,322,-4
ADCY8,3,7,312,322,-4
L3HYPDH,8,12,302,322,-4
MED7,4,8,310,322,-4
C20orf85,0,4,318,322,-4
KYAT3,9,13,300,322,-4
CD37,16,20,286,322,-4
C1QL3,6,10,306,322,-4
DRD4,19,23,280,322,-4
ADAT1,1,5,316,322,-4
DEFB133,2,6,314,322,-4
SH3BP1,2,6,314,322,-4
ZNF865,6,10,306,322,-4
OR6C70,1,5,316,322,-4
SLC24A2,0,4,318,322,-4
LCA5L,8,12,302,322,-4
RARRES2,13,17,292,322,-4
SFR1,4,8,310,322,-4
RAB27B,4,8,310,322,-4
SLC25A30,8,12,302,322,-4
RASIP1,7,11,304,322,-4
LCN2,12,16,294,322,-4
MCRIP2,10,14,298,322,-4
C6orf132,4,8,310,322,-4
SLC29A2,5,9,308,322,-4
ZNF816-ZNF321P,6,10,306,322,-4
CRH,2,6,314,322,-4
RBMY1F,0,4,318,322,-4
GPAT2,4,8,310,322,-4
PRRX1,0,4,318,322,-4
RFC3,4,8,310,322,-4
SIGLEC8,2,6,314,322,-4
NRL,10,14,298,322,-4
KIF18B,9,13,300,322,-4
GATB,4,8,310,322,-4
PRSS8,10,14,298,322,-4
S1PR4,0,4,318,322,-4
GGTLC1,0,4,318,322,-4
KDM8,12,16,294,322,-4
BORCS6,5,9,308,322,-4
S100A4,14,18,290,322,-4
S100A12,2,6,314,322,-4
LRRC17,6,10,306,322,-4
ECD,2,6,314,322,-4
ZFP62,6,10,306,322,-4
SPAG11B,11,15,296,322,-4
MOSPD2,5,9,308,322,-4
GPR182,8,12,302,322,-4
CELA3B,4,8,310,322,-4
DHCR7,7,11,304,322,-4
DHDDS,4,8,310,322,-4
FCRL2,0,4,318,322,-4
RGPD1,19,23,280,322,-4
DHODH,2,6,314,322,-4
KCNS3,1,5,316,322,-4
SPC24,4,8,310,322,-4
ORC2,4,8,310,322,-4
DNAJC25-GNG10,7,11,304,322,-4
FRMPD1,14,18,290,322,-4
ZP4,0,4,318,322,-4
WDR25,5,9,308,322,-4
CACNA2D3,3,7,312,322,-4
DUSP9,3,7,312,322,-4
DOCK9,4,8,310,322,-4
WDHD1,3,7,312,322,-4
KLK10,3,7,312,322,-4
SCYL3,2,6,314,322,-4
PTCD3,9,13,300,322,-4
MLPH,6,10,306,322,-4
LINGO2,0,4,318,322,-4
SCO2,12,16,294,322,-4
SCN5A,15,19,288,322,-4
SCGB2B2,7,11,304,322,-4
BRINP1,2,6,314,322,-4
MAST4,5,9,308,322,-4
DGKA,4,8,310,322,-4
COLEC10,0,4,318,322,-4
SMTN,7,11,304,322,-4
SMTNL1,3,7,312,322,-4
LPL,7,11,304,322,-4
VWA5A,4,8,310,322,-4
LRFN1,10,14,298,322,-4
FRS3,8,12,302,322,-4
AFAP1L2,3,7,312,322,-4
CCNB3,2,6,314,322,-4
ORAI1,3,7,312,322,-4
EME1,6,10,306,322,-4
PER2,3,7,312,322,-4
ANGPTL7,4,8,310,322,-4
TM4SF1,3,7,312,322,-4
IGHV2-5,0,4,318,322,-4
FAM153A,4,8,310,322,-4
IGHV1-69D,1,5,316,322,-4
THUMPD2,3,7,312,322,-4
FAM135B,1,5,316,322,-4
OR1R1P,0,4,318,322,-4
TIGD2,4,8,310,322,-4
CHRM2,0,4,318,322,-4
TIRAP,5,9,308,322,-4
MYL10,11,15,296,322,-4
CNEP1R1,4,8,310,322,-4
EPHX4,3,7,312,322,-4
CYB5R2,6,10,306,322,-4
PLP2,7,11,304,322,-4
HACD1,5,9,308,322,-4
PCIF1,10,14,298,322,-4
ANGPTL5,2,6,314,322,-4
ARMCX4,2,6,314,322,-4
NIBAN1,3,7,312,322,-4
TMEM115,9,13,300,322,-4
TMEM125,4,8,310,322,-4
NHSL2,2,6,314,322,-4
CXXC5,11,15,296,322,-4
CHST4,4,8,310,322,-4
HCFC2,3,7,312,322,-4
TTC4,6,10,306,322,-4
TMEM132D,0,4,318,322,-4
TTC39B,2,6,314,322,-4
FAM153B,25,29,268,322,-4
IGHV3-13,8,12,302,322,-4
ARL13A,6,10,306,322,-4
IGKV3-7,2,6,314,322,-4
POSTN,3,7,312,322,-4
PAXIP1,4,8,310,322,-4
UBOX5,4,8,310,322,-4
OR2A14,4,8,310,322,-4
TCAF2C,4,8,310,322,-4
POLR3F,6,10,306,322,-4
TCL1A,4,8,310,322,-4
ATG4D,11,15,296,322,-4
CHD9,9,13,300,322,-4
CYP20,10,14,298,322,-4
POLM,10,14,298,322,-4
IGKV3D-20,1,5,316,322,-4
ALOX5,3,7,312,322,-4
IGKV1D-8,1,5,316,322,-4
NIPSNAP3B,4,8,310,322,-4
UBD,12,16,294,322,-4
IGKV1-5,2,6,314,322,-4
UBALD1,12,16,294,322,-4
FAM163B,0,4,318,322,-4
CHKB-CPT1B,7,11,304,322,-4
ASPDH,14,18,290,322,-4
ASPA,2,6,314,322,-4
AMELX,5,9,308,322,-4
CSF2,15,19,288,322,-4
ASIC5,0,4,318,322,-4
IGHV3OR16-12,1,5,316,322,-4
TGDS,4,8,310,322,-4
THAP8,8,12,302,322,-4
TMEM139,8,12,302,322,-4
PLEK,0,4,318,322,-4
OR2A4,5,9,308,322,-4
TRAPPC6A,8,12,302,322,-4
TP53TG5,4,8,310,322,-4
HOXD12,6,10,306,322,-4
PHF7,2,6,314,322,-4
CTNNA3,9,13,300,322,-4
TPTE,6,10,306,322,-4
HIC2,8,12,302,322,-4
TRMT11,6,10,306,322,-4
TRAJ10,0,4,318,322,-4
ZNF469,0,4,318,322,-4
TRIQK,4,8,310,322,-4
ZNF511,6,10,306,322,-4
TRAJ7,0,4,318,322,-4
CLPSL2,21,25,276,322,-4
PGM2,4,8,310,322,-4
APOBEC3B,4,8,310,322,-4
CLEC1B,1,5,316,322,-4
CLEC20A,4,8,310,322,-4
TRAV38-2DV8,1,5,316,322,-4
TRIM63,1,5,316,322,-4
TRAV6,0,4,318,322,-4
CLMP,0,4,318,322,-4
TRBC2,6,10,306,322,-4
CTAGE6,14,18,290,322,-4
CLMN,8,12,302,322,-4
F13A1,5,9,308,322,-4
TRBV7-1,1,5,316,322,-4
TRBV7-9,6,10,306,322,-4
FGG,4,8,310,322,-4
TP53TG3D,7,11,304,322,-4
APOBEC3C,3,7,312,322,-4
PLD2,13,17,292,322,-4
HTR2C,0,4,318,322,-4
NGDN,6,10,306,322,-4
ARHGEF40,7,11,304,322,-4
CIAO3,11,15,296,322,-4
CMPK2,2,6,314,322,-4
MYZAP,6,10,306,322,-4
HEATR3,3,7,312,322,-4
OR1N2,0,4,318,322,-4
GABRA2,9,13,300,322,-4
PLA2G5,1,5,316,322,-4
TMEM252,0,4,318,322,-4
ERICH6,19,23,280,322,-4
ERMARD,8,12,302,322,-4
ARHGAP29,4,8,310,322,-4
ANKRD23,16,20,286,322,-4
PICK1,10,14,298,322,-4
CXCL5,0,4,318,322,-4
ZNF57,8,12,302,322,-4
TMEM62,9,13,300,322,-4
NAB2,12,16,294,322,-4
CXCL12,9,13,300,322,-4
PIGP,6,10,306,322,-4
ZNF552,11,15,296,322,-4
NBEAL2,4,8,310,322,-4
NBN,3,7,312,322,-4
ANKRD49,6,10,306,322,-4
NT5C,8,12,302,322,-4
PIGA,9,13,300,322,-4
HESX1,18,22,282,322,-4
IGLV6-57,11,15,296,322,-4
OXLD1,6,10,306,322,-4
PPOX,11,15,296,322,-4
CFAP47,0,4,318,322,-4
PPDPFL,3,7,312,322,-4
IMPACT,7,11,304,322,-4
FUT4,1,5,316,322,-4
CFHR2,10,14,298,322,-4
NLRX1,10,14,298,322,-4
TAS2R43,10,14,298,322,-4
ZNF680,8,12,302,322,-4
CYS1,1,5,316,322,-4
PPCS,4,8,310,322,-4
PAX1,1,5,316,322,-4
NLRP2,20,24,278,322,-4
PARS2,10,14,298,322,-4
CFI,6,10,306,322,-4
AUNIP,5,9,308,322,-4
PPIAL4A,31,35,256,322,-4
IKBIP,4,8,310,322,-4
TAFA1,0,4,318,322,-4
POU5F1B,3,7,312,322,-4
TAS2R30,9,14,299,322,-5
ADGRG3,6,11,305,322,-5
FBLN2,10,15,297,322,-5
ABCA12,4,9,309,322,-5
MYL2,7,12,303,322,-5
AKAP1,10,15,297,322,-5
EPS8L1,5,10,307,322,-5
TPK1,7,12,303,322,-5
WRN,1,6,315,322,-5
FAM118B,7,12,303,322,-5
MARCHF1,4,9,309,322,-5
IGFN1,1,6,315,322,-5
CDCA7,6,11,305,322,-5
MYL3,8,13,301,322,-5
CYB561D1,4,9,309,322,-5
ZNF658,11,16,295,322,-5
PARP9,6,11,305,322,-5
KRTAP1-1,1,6,315,322,-5
WIPI1,8,13,301,322,-5
CYP4A22,2,7,313,322,-5
NOL11,6,11,305,322,-5
TMED1,8,13,301,322,-5
SLC45A3,2,7,313,322,-5
PCMTD1,7,12,303,322,-5
PDK1,5,10,307,322,-5
HBG1,6,11,305,322,-5
ARMCX5,2,7,313,322,-5
WNT4,12,17,293,322,-5
FCN2,4,9,309,322,-5
ZNF696,5,10,307,322,-5
C17orf58,6,11,305,322,-5
DUS4L-BCAP29,4,9,309,322,-5
NOL12,4,9,309,322,-5
HAPLN1,9,14,299,322,-5
C10orf95,7,12,303,322,-5
PTCHD4,2,7,313,322,-5
IGHV3-15,4,9,309,322,-5
PALM3,4,9,309,322,-5
EMC6,10,15,297,322,-5
TGS1,4,9,309,322,-5
DHRS4L2,4,9,309,322,-5
DNAAF6,11,16,295,322,-5
FRMPD2,0,5,317,322,-5
HOXA11,5,10,307,322,-5
NEPRO,5,10,307,322,-5
HORMAD1,5,10,307,322,-5
CFAP46,2,7,313,322,-5
TGFBR2,3,8,311,322,-5
MMP17,4,9,309,322,-5
SMIM40,8,13,301,322,-5
MAP4K3,8,13,301,322,-5
KLRC4-KLRK1,8,13,301,322,-5
RGS19,6,11,305,322,-5
OR2D2,10,15,297,322,-5
SLC8A3,0,5,317,322,-5
ZNF391,4,9,309,322,-5
SLC52A2,7,12,303,322,-5
TULP1,3,8,311,322,-5
FASTKD3,4,9,309,322,-5
TIGD7,6,11,305,322,-5
RTKN,9,14,299,322,-5
RGPD4,1,6,315,322,-5
TICAM1,5,10,307,322,-5
DUSP7,5,10,307,322,-5
RSPO1,0,5,317,322,-5
CYYR1,0,5,317,322,-5
MAPK7,15,20,287,322,-5
PMM2,7,12,303,322,-5
RRP9,7,12,303,322,-5
NOL4,8,13,301,322,-5
TRAJ33,0,5,317,322,-5
KRT23,4,9,309,322,-5
S100A7L2,2,7,313,322,-5
IRF2BP1,9,14,299,322,-5
TMEM26,4,9,309,322,-5
OR52K2,0,5,317,322,-5
COQ10A,7,12,303,322,-5
RASSF5,0,5,317,322,-5
OR51B5,4,9,309,322,-5
GIPR,3,8,311,322,-5
RASSF10,6,11,305,322,-5
IQCF3,5,10,307,322,-5
TMEM265,17,22,283,322,-5
SFT2D3,2,7,313,322,-5
LPCAT3,3,8,311,322,-5
TMEM250,9,14,299,322,-5
TSPYL5,0,5,317,322,-5
HEATR6,9,14,299,322,-5
CD274,1,6,315,322,-5
GRM7,16,21,285,322,-5
SH2D7,2,7,313,322,-5
REEP4,5,10,307,322,-5
CMKLR1,4,9,309,322,-5
URB2,9,14,299,322,-5
LDLRAD2,2,7,313,322,-5
GALNT18,2,7,313,322,-5
LIN37,11,16,295,322,-5
TMPRSS15,8,13,301,322,-5
CABP7,6,11,305,322,-5
SELENOM,9,14,299,322,-5
SEC24B,6,11,305,322,-5
TSPAN1,2,7,313,322,-5
NAGPA,4,9,309,322,-5
RBM43,4,9,309,322,-5
PITPNM3,8,13,301,322,-5
ZBTB41,6,11,305,322,-5
SDK1,7,12,303,322,-5
DPH6,9,14,299,322,-5
ZBTB33,5,10,307,322,-5
PIK3IP1,11,16,295,322,-5
TNFSF13,14,19,289,322,-5
C8orf58,6,11,305,322,-5
MT-ND6,8,13,301,322,-5
C8orf37,1,6,315,322,-5
GABRA1,1,6,315,322,-5
SASS6,5,10,307,322,-5
SLC25A12,6,11,305,322,-5
ACTR3B,7,12,303,322,-5
DNAJC30,2,7,313,322,-5
KRTAP5-6,3,8,311,322,-5
SLC14A1,4,9,309,322,-5
FPGT,7,12,303,322,-5
FOXD1,4,9,309,322,-5
APOBEC2,7,12,303,322,-5
KRTAP5-10,3,8,311,322,-5
PPIAL4D,18,23,281,322,-5
APOBEC1,3,8,311,322,-5
IL27RA,4,9,309,322,-5
PLEKHA7,3,8,311,322,-5
TRPC6,0,5,317,322,-5
OR5P2,4,9,309,322,-5
NNMT,2,7,313,322,-5
RAB3IL1,8,13,301,322,-5
FPGT-TNNI3K,10,15,297,322,-5
H4C13,22,27,273,322,-5
IFNA21,1,6,315,322,-5
SAMD10,10,15,297,322,-5
TMEM144,6,11,305,322,-5
MSC,3,8,311,322,-5
MYO1H,9,14,299,322,-5
NPY4R2,13,18,291,322,-5
TOM1L2,11,16,295,322,-5
PCYOX1L,6,11,305,322,-5
APOBEC3H,15,20,287,322,-5
MEDAG,4,9,309,322,-5
IQSEC3,2,7,313,322,-5
SIGLEC7,0,5,317,322,-5
XXYLT1,10,15,297,322,-5
MT-CO3,10,15,297,322,-5
TOMM40L,5,10,307,322,-5
CTTNBP2,9,14,299,322,-5
CD58,4,9,309,322,-5
ACVR1,7,12,303,322,-5
MEGF8,17,22,283,322,-5
RAD21L1,13,18,291,322,-5
KTI12,6,11,305,322,-5
KSR2,0,5,317,322,-5
CBX7,5,10,307,322,-5
PIP4P2,5,10,307,322,-5
SOX13,6,11,305,322,-5
NRGN,8,13,301,322,-5
TRAV8-2,2,7,313,322,-5
HMGCLL1,0,5,317,322,-5
TENM4,12,17,293,322,-5
PEX3,5,10,307,322,-5
ATP4A,3,8,311,322,-5
PRRX2,8,13,301,322,-5
MRGPRF,4,9,309,322,-5
AGAP6,9,14,299,322,-5
CCDC153,8,13,301,322,-5
EDIL3,3,8,311,322,-5
CCER2,25,30,267,322,-5
RNF113B,4,9,309,322,-5
ZNF133,10,15,297,322,-5
NECAB1,8,13,301,322,-5
TRBV20OR9-2,27,32,263,322,-5
PRSS48,3,8,311,322,-5
CYP24A1,4,9,309,322,-5
TRIM38,1,6,315,322,-5
GPR150,0,5,317,322,-5
SSTR1,1,6,315,322,-5
EDA,3,8,311,322,-5
TRIM35,9,14,299,322,-5
ZNF723,3,8,311,322,-5
PCDH18,3,8,311,322,-5
ZNF229,3,8,311,322,-5
TRAV29DV5,0,5,317,322,-5
TRAV8-4,3,8,311,322,-5
TRAV9-2,4,9,309,322,-5
POGK,9,14,299,322,-5
EFHB,3,8,311,322,-5
MANSC4,5,10,307,322,-5
NSDHL,5,10,307,322,-5
IGLV3-16,2,7,313,322,-5
FOSL2,7,12,303,322,-5
MAGEA3,5,10,307,322,-5
BLOC1S4,6,11,305,322,-5
NKX6-2,1,6,315,322,-5
TBC1D2,2,7,313,322,-5
VIPR1,7,12,303,322,-5
FXYD4,10,15,297,322,-5
GYPB,12,17,293,322,-5
ALKBH2,9,14,299,322,-5
FOLR3,17,22,283,322,-5
KDELR3,5,10,307,322,-5
SPINT4,0,5,317,322,-5
MAK16,4,9,309,322,-5
EFCAB3,10,15,297,322,-5
CEP192,5,10,307,322,-5
MPZ,2,7,313,322,-5
SPOCD1,8,13,301,322,-5
SPOCK3,11,16,295,322,-5
PANK4,8,13,301,322,-5
CCDC179,1,6,315,322,-5
OVCH2,0,5,317,322,-5
FAM86B1,9,14,299,322,-5
SPP1,7,12,303,322,-5
BRCA1,2,7,313,322,-5
RNF43,7,12,303,322,-5
FYB2,0,5,317,322,-5
PRELID3A,4,9,309,322,-5
ZNF639,6,11,305,322,-5
NOTCH2NLR,11,16,295,322,-5
BEND5,2,7,313,322,-5
DMRTC1,4,9,309,322,-5
LY6G5B,6,11,305,322,-5
CENPVL2,0,5,317,322,-5
EGFL7,13,18,291,322,-5
H2AC13,27,32,263,322,-5
OLFML1,2,7,313,322,-5
ASTE1,13,18,291,322,-5
SNURF,18,23,281,322,-5
GPRIN2,0,5,317,322,-5
KIF24,4,9,309,322,-5
RPRML,20,25,277,322,-5
SNTG2,3,8,311,322,-5
TRAV13-2,5,10,307,322,-5
MRPL46,7,12,303,322,-5
CLIC6,2,7,313,322,-5
H2AC14,29,34,259,322,-5
EID2,3,8,311,322,-5
LY9,1,6,315,322,-5
PRDM8,5,10,307,322,-5
ZNF648,0,5,317,322,-5
SMYD5,8,13,301,322,-5
TBRG4,8,13,301,322,-5
EHD4,2,7,313,322,-5
RPP40,6,11,305,322,-5
CYP1A1,5,10,307,322,-5
IGHV4-4,3,8,311,322,-5
TBC1D3C,3,8,311,322,-5
SNX24,8,13,301,322,-5
CCDC57,16,21,285,322,-5
SRXN1,5,10,307,322,-5
KIFC1,6,11,305,322,-5
PDE8B,8,14,300,322,-6
OR2A7,2,8,312,322,-6
GRWD1,8,14,300,322,-6
PAX8,9,15,298,322,-6
AGTR1,1,7,314,322,-6
TBC1D3L,15,21,286,322,-6
C1QTNF5,10,16,296,322,-6
LIPT1,6,12,304,322,-6
FBXL6,7,13,302,322,-6
SERPINB8,2,8,312,322,-6
TMEM244,21,27,274,322,-6
ADAMTS14,0,6,316,322,-6
PAGE1,5,11,306,322,-6
UBXN10,0,6,316,322,-6
CPAMD8,5,11,306,322,-6
DCAF4,5,11,306,322,-6
SLC15A4,3,9,310,322,-6
GLI3,11,17,294,322,-6
PET100,11,17,294,322,-6
C1orf74,1,7,314,322,-6
H2AL1RP,5,11,306,322,-6
COL4A1,12,18,292,322,-6
SLC12A3,0,6,316,322,-6
FIBCD1,3,9,310,322,-6
ERVMER34-1,2,8,312,322,-6
CCT6B,6,12,304,322,-6
GRXCR2,3,9,310,322,-6
IFI16,4,10,308,322,-6
PFKFB2,8,14,300,322,-6
XPA,4,10,308,322,-6
NPY2R,0,6,316,322,-6
GASK1A,4,10,308,322,-6
ZNF232,6,12,304,322,-6
SERTAD4,6,12,304,322,-6
FBXO34,4,10,308,322,-6
ADAMTS2,3,9,310,322,-6
HYAL3,8,14,300,322,-6
IQCH,7,13,302,322,-6
RASA3,6,12,304,322,-6
GLUD2,3,9,310,322,-6
DEFB131B,3,9,310,322,-6
ZBTB39,8,14,300,322,-6
HROB,9,15,298,322,-6
FAM72A,5,11,306,322,-6
TRGV5,19,25,278,322,-6
ELP3,6,12,304,322,-6
CPT2,6,12,304,322,-6
CCNJ,6,12,304,322,-6
RAPGEFL1,14,20,288,322,-6
FOXO3B,10,16,296,322,-6
CENPP,5,11,306,322,-6
BEST1,7,13,302,322,-6
C4BPA,14,20,288,322,-6
NFE2L3,14,20,288,322,-6
GRM3,3,9,310,322,-6
PAK1IP1,4,10,308,322,-6
SYNC,3,9,310,322,-6
C2orf69,5,11,306,322,-6
SESN1,7,13,302,322,-6
MYOZ1,9,15,298,322,-6
NOXA1,8,14,300,322,-6
TRIM29,4,10,308,322,-6
CD5,3,9,310,322,-6
ZNF296,14,20,288,322,-6
CPNE5,11,17,294,322,-6
HLA-DOB,6,12,304,322,-6
TBXT,0,6,316,322,-6
AIM2,4,10,308,322,-6
SIAH1,5,11,306,322,-6
RAET1E,0,6,316,322,-6
YBX2,3,9,310,322,-6
INCENP,9,15,298,322,-6
MARS2,7,13,302,322,-6
YEATS4,5,11,306,322,-6
BGLAP,41,47,234,322,-6
PLAC1,12,18,292,322,-6
MT1M,31,37,254,322,-6
IFNL3,7,13,302,322,-6
IL37,17,23,282,322,-6
IGLV3-25,5,11,306,322,-6
C11orf87,1,7,314,322,-6
DUSP29,2,8,312,322,-6
PTH,1,7,314,322,-6
CHKB,8,14,300,322,-6
ALX4,4,10,308,322,-6
MIP,4,10,308,322,-6
EMILIN3,1,7,314,322,-6
CCL3L3,7,13,302,322,-6
FAM151A,2,8,312,322,-6
KNSTRN,6,12,304,322,-6
LRRC75B,12,18,292,322,-6
RSPO3,2,8,312,322,-6
ARTN,24,30,268,322,-6
HOXB7,4,10,308,322,-6
BRAT1,11,17,294,322,-6
ZBTB8OS,3,9,310,322,-6
WDR6,7,13,302,322,-6
TRAF1,2,8,312,322,-6
UMPS,17,23,282,322,-6
CFAP57,14,20,288,322,-6
FAM3B,5,11,306,322,-6
PUM3,6,12,304,322,-6
PRSS53,23,29,270,322,-6
TRBV11-3,16,22,284,322,-6
INS,7,13,302,322,-6
NIPSNAP2,8,14,300,322,-6
CCR7,7,13,302,322,-6
ANXA8,7,13,302,322,-6
STK32A,2,8,312,322,-6
PPAN,5,11,306,322,-6
PPAN-P2RY11,12,18,292,322,-6
TAS2R50,7,13,302,322,-6
TGFBR1,6,12,304,322,-6
MVB12B,4,10,308,322,-6
CSF3R,4,10,308,322,-6
FZD2,7,13,302,322,-6
OGFR,7,13,302,322,-6
TBC1D10A,8,14,300,322,-6
H3Y1,1,7,314,322,-6
PSTK,3,9,310,322,-6
ASCL5,6,12,304,322,-6
GSPT2,3,9,310,322,-6
MMAA,4,10,308,322,-6
HOXA3,9,15,298,322,-6
FDXACB1,3,9,310,322,-6
P2RY2,4,10,308,322,-6
TEX36,12,18,292,322,-6
ZKSCAN2,6,12,304,322,-6
STARD4,4,10,308,322,-6
CEP68,6,12,304,322,-6
NXT1,6,12,304,322,-6
THNSL1,3,9,310,322,-6
USP41,4,10,308,322,-6
TPTE2,7,13,302,322,-6
ACTL10,17,23,282,322,-6
LRRC18,1,7,314,322,-6
SUSD4,3,9,310,322,-6
PLGRKT,7,13,302,322,-6
PLEKHJ1,2,8,312,322,-6
AKR1C3,8,14,300,322,-6
GGT2,4,10,308,322,-6
SEMA4C,11,17,294,322,-6
H2BC4,10,16,296,322,-6
STRIP1,9,15,298,322,-6
PRR29,6,12,304,322,-6
CCR3,1,7,314,322,-6
SLC25A32,4,10,308,322,-6
ZNF362,5,11,306,322,-6
RAB26,15,21,286,322,-6
FAM120B,6,12,304,322,-6
RIPK3,7,13,302,322,-6
EFCAB8,13,19,290,322,-6
CDC20,8,14,300,322,-6
OTOG,3,9,310,322,-6
SPDYE13,9,15,298,322,-6
TAMM41,6,12,304,322,-6
RIPK4,7,13,302,322,-6
ZNF280C,3,9,310,322,-6
HGF,3,9,310,322,-6
RAB40C,8,14,300,322,-6
CDADC1,7,13,302,322,-6
DCBLD1,3,9,310,322,-6
MACIR,6,12,304,322,-6
TRIM13,4,10,308,322,-6
TLX1,3,9,310,322,-6
POLD3,7,13,302,322,-6
C16orf86,15,21,286,322,-6
HSF2BP,4,10,308,322,-6
CDC7,4,10,308,322,-6
MARCHF10,14,20,288,322,-6
PRB3,1,7,314,322,-6
ADGRE5,6,12,304,322,-6
TLDC2,10,16,296,322,-6
RBM44,2,8,312,322,-6
OR4F29,11,17,294,322,-6
POLE2,7,13,302,322,-6
ZFP69,5,11,306,322,-6
KRT81,4,10,308,322,-6
FOLH1,9,15,298,322,-6
ATF5,10,16,296,322,-6
CTAGE8,17,23,282,322,-6
USP43,3,9,310,322,-6
UNG,3,9,310,322,-6
DNAJC17,7,13,302,322,-6
GDF10,0,6,316,322,-6
ARPIN-AP3S2,15,21,286,322,-6
SEC14L2,13,20,289,322,-7
SDHAF1,8,15,299,322,-7
CACNA2D4,6,13,303,322,-7
MC4R,1,8,313,322,-7
NUPR2,22,29,271,322,-7
DOK1,7,14,301,322,-7
CKLF,5,12,305,322,-7
MBLAC2,2,9,311,322,-7
SWSAP1,8,15,299,322,-7
ZNF181,5,12,305,322,-7
TRGV8,21,28,273,322,-7
NFE2,13,20,289,322,-7
NMI,2,9,311,322,-7
OR4F21,16,23,283,322,-7
RWDD3,8,15,299,322,-7
ACSS3,6,13,303,322,-7
ZNF517,5,12,305,322,-7
TRADD,4,11,307,322,-7
NDP,5,12,305,322,-7
ZNF16,7,14,301,322,-7
F3,9,16,297,322,-7
ATXN7L2,6,13,303,322,-7
NEMP2,3,10,309,322,-7
CCDC110,14,21,287,322,-7
CBX2,9,16,297,322,-7
MAP6D1,14,21,287,322,-7
LRRC24,8,15,299,322,-7
CCDC87,2,9,311,322,-7
LIN7B,5,12,305,322,-7
TNS1,11,18,293,322,-7
B3GNT10,8,15,299,322,-7
RCSD1,0,7,315,322,-7
FAHD2B,8,15,299,322,-7
HS3ST5,3,10,309,322,-7
ZNF23,4,11,307,322,-7
CALML4,10,17,295,322,-7
ABO,23,30,269,322,-7
MAEL,2,9,311,322,-7
GCNT1,4,11,307,322,-7
PFKFB1,4,11,307,322,-7
RLBP1,6,13,303,322,-7
HPDL,9,16,297,322,-7
DNAJC28,4,11,307,322,-7
CFAP45,8,15,299,322,-7
IGSF23,18,25,279,322,-7
AURKB,8,15,299,322,-7
MYEOV,4,11,307,322,-7
SLC2A1,12,19,291,322,-7
SPATA12,3,10,309,322,-7
NINJ2,11,18,293,322,-7
ISOC2,8,15,299,322,-7
PUSL1,6,13,303,322,-7
FZR1,9,16,297,322,-7
TDO2,6,13,303,322,-7
TLCD3B,11,18,293,322,-7
MFSD6L,0,7,315,322,-7
MFSD5,6,13,303,322,-7
SLC35E4,6,13,303,322,-7
MFAP4,5,12,305,322,-7
HAUS7,8,15,299,322,-7
MTNR1B,5,12,305,322,-7
UNC5CL,3,10,309,322,-7
SPINT2,21,28,273,322,-7
HBB,12,19,291,322,-7
TCF19,4,11,307,322,-7
AGPAT2,4,11,307,322,-7
BLACAT1,5,12,305,322,-7
TTK,10,17,295,322,-7
BIVM-ERCC5,31,38,253,322,-7
IGHV4-39,9,16,297,322,-7
SLC22A11,3,10,309,322,-7
RAB41,10,17,295,322,-7
UGT1A6,4,11,307,322,-7
KRTAP4-9,5,12,305,322,-7
SLC16A6,7,14,301,322,-7
ATOH7,5,12,305,322,-7
POLI,4,11,307,322,-7
ZNF746,8,15,299,322,-7
GRHL3,5,12,305,322,-7
OSR1,4,11,307,322,-7
MMP7,5,12,305,322,-7
KLHL13,10,17,295,322,-7
CDKN3,9,16,297,322,-7
MXD3,9,16,297,322,-7
NKG7,9,16,297,322,-7
SMIM10L2B,3,10,309,322,-7
POC5,7,14,301,322,-7
ECHDC3,8,15,299,322,-7
KIF11,4,11,307,322,-7
TGOLN2,4,11,307,322,-7
KIAA1586,10,17,295,322,-7
UBASH3B,2,9,311,322,-7
GPC2,12,19,291,322,-7
CHMP6,8,15,299,322,-7
PABPN1L,6,13,303,322,-7
GPATCH3,10,17,295,322,-7
TAS2R46,9,16,297,322,-7
CEP72,4,11,307,322,-7
WDR43,5,12,305,322,-7
CKAP2L,5,12,305,322,-7
IGKV1OR2-108,27,34,261,322,-7
ASAH2,26,33,263,322,-7
COG1,10,17,295,322,-7
OSGIN2,4,11,307,322,-7
C12orf42,1,8,313,322,-7
SLC7A2,2,9,311,322,-7
SPAAR,7,14,301,322,-7
SLC11A1,4,11,307,322,-7
SPIN2A,7,14,301,322,-7
CMTM7,5,12,305,322,-7
RBM12,10,17,295,322,-7
CMIP,11,18,293,322,-7
ARHGEF19,6,13,303,322,-7
ARHGEF10L,7,14,301,322,-7
SPRTN,4,11,307,322,-7
GRM5,12,19,291,322,-7
SSC5D,9,16,297,322,-7
CEP85,5,12,305,322,-7
CXCL10,3,10,309,322,-7
NRROS,9,16,297,322,-7
C9orf72,8,15,299,322,-7
MTLN,9,16,297,322,-7
MRFAP1L1,4,11,307,322,-7
ARHGAP25,9,16,297,322,-7
TMEM52,5,12,305,322,-7
SERPINB3,0,7,315,322,-7
IL36RN,1,8,313,322,-7
KCNAB2,6,13,303,322,-7
GLIPR1,7,14,301,322,-7
GPSM3,4,11,307,322,-7
TMEM86B,9,16,297,322,-7
FKBPL,6,13,303,322,-7
BCL3,6,13,303,322,-7
SSX4,13,20,289,322,-7
ZNF280B,4,11,307,322,-7
TMOD4,20,27,275,322,-7
VCPKMT,4,11,307,322,-7
ZC2HC1A,7,14,301,322,-7
XKRX,3,10,309,322,-7
ZNF354A,6,13,303,322,-7
EQTN,8,15,299,322,-7
CA9,8,15,299,322,-7
CYP3A7,2,9,311,322,-7
DOP1A,8,15,299,322,-7
ST6GALNAC6,5,12,305,322,-7
ACKR3,7,14,301,322,-7
IRAG1,15,22,285,322,-7
C8orf48,5,12,305,322,-7
MRAP,11,18,293,322,-7
H1-5,18,25,279,322,-7
SPRN,4,11,307,322,-7
RALGDS,9,16,297,322,-7
ERCC6L,6,13,303,322,-7
YDJC,5,12,305,322,-7
HOMEZ,4,12,306,322,-8
RIBC2,2,10,310,322,-8
E4F1,7,15,300,322,-8
KIAA1755,12,20,290,322,-8
H3C6,9,17,296,322,-8
TRIM62,6,14,302,322,-8
BORCS7-ASMT,24,32,266,322,-8
SRSF6,10,18,294,322,-8
SSTR5,3,11,308,322,-8
CSTF1,7,15,300,322,-8
H3C4,35,43,244,322,-8
KIAA0040,2,10,310,322,-8
NPIPA3,35,43,244,322,-8
ZNF414,7,15,300,322,-8
IKBKE,7,15,300,322,-8
ZNF174,6,14,302,322,-8
AKR1C2,14,22,286,322,-8
VDR,2,10,310,322,-8
SPNS2,5,13,304,322,-8
SPINK13,7,15,300,322,-8
CLEC3A,2,10,310,322,-8
H2AW,12,20,290,322,-8
MPZL2,2,10,310,322,-8
MAGEB17,3,11,308,322,-8
MRC2,8,16,298,322,-8
MPP2,8,16,298,322,-8
ZXDA,4,12,306,322,-8
ZNF346,10,18,294,322,-8
TBX5,0,8,314,322,-8
TRIM32,8,16,298,322,-8
SPRYD3,5,13,304,322,-8
ATF7-NPFF,25,33,264,322,-8
PEX14,8,16,298,322,-8
BNIP1,6,14,302,322,-8
GPR19,8,16,298,322,-8
PRF1,1,9,312,322,-8
TEKT1,3,11,308,322,-8
H2AC20,13,21,288,322,-8
EFNA3,7,15,300,322,-8
SPTY2D1OS,26,34,262,322,-8
NXF2B,1,9,312,322,-8
BORA,2,10,310,322,-8
TATDN3,2,10,310,322,-8
HSPA12A,9,17,296,322,-8
MVK,10,18,294,322,-8
TTLL6,4,12,306,322,-8
LPIN3,5,13,304,322,-8
SARS2,7,15,300,322,-8
SAPCD2,2,10,310,322,-8
TMEM187,14,22,286,322,-8
CXorf65,6,14,302,322,-8
SAMD13,16,24,282,322,-8
IFI44L,11,19,292,322,-8
PI15,1,9,312,322,-8
CD70,8,16,298,322,-8
TAF5,6,14,302,322,-8
ATP6V1G3,19,27,276,322,-8
DGKQ,7,15,300,322,-8
KRTAP4-12,2,10,310,322,-8
TP53TG3C,8,16,298,322,-8
GGTLC3,9,17,296,322,-8
TP53TG3F,12,20,290,322,-8
SLC24A5,1,9,312,322,-8
B3GALT6,5,13,304,322,-8
FAH,9,17,296,322,-8
SH3TC2,0,8,314,322,-8
ANKRD39,6,14,302,322,-8
PIP4P1,9,17,296,322,-8
RBM45,3,11,308,322,-8
TMTC4,12,20,290,322,-8
NAGLU,7,15,300,322,-8
ZBTB42,7,15,300,322,-8
C9orf135,17,25,280,322,-8
C9orf116,7,15,300,322,-8
TMEM71,12,20,290,322,-8
C3AR1,7,15,300,322,-8
LINC00634,19,27,276,322,-8
B3GNT3,5,13,304,322,-8
GJA5,5,13,304,322,-8
FAM110A,9,17,296,322,-8
DENND3,7,15,300,322,-8
MECOM,6,14,302,322,-8
MAT1A,2,10,310,322,-8
ACP6,3,11,308,322,-8
TPGS1,12,20,290,322,-8
CSGALNACT1,5,13,304,322,-8
CRHBP,7,15,300,322,-8
SLFN5,3,11,308,322,-8
CDK15,1,9,312,322,-8
KLRC3,8,16,298,322,-8
CTF1,4,12,306,322,-8
BUD13,11,19,292,322,-8
CTDSP1,9,17,296,322,-8
GPCPD1,9,17,296,322,-8
GEMIN7,9,17,296,322,-8
AP5B1,6,14,302,322,-8
RHCE,16,24,282,322,-8
BUB1B,3,11,308,322,-8
PSRC1,9,17,296,322,-8
TGIF2-RAB5IF,37,45,240,322,-8
LTBP2,4,12,306,322,-8
CBWD6,12,20,290,322,-8
CDPF1,7,15,300,322,-8
CCN6,8,16,298,322,-8
MEIKIN,8,16,298,322,-8
MICAL2,3,11,308,322,-8
LRRC53,0,8,314,322,-8
ARNT2,9,17,296,322,-8
GOLGA8H,15,23,284,322,-8
TLR6,2,10,310,322,-8
DUS2,8,16,298,322,-8
DUS4L,3,11,308,322,-8
WDR81,12,20,290,322,-8
RFXAP,3,11,308,322,-8
DHFR2,5,13,304,322,-8
WDR75,9,17,296,322,-8
TRABD2A,3,11,308,322,-8
RTN4IP1,4,12,306,322,-8
NUDT12,6,14,302,322,-8
MGST1,18,26,278,322,-8
PTX3,6,14,302,322,-8
ZNF628,10,19,293,322,-9
FGF20,11,20,291,322,-9
ZNF365,2,11,309,322,-9
ABCC10,7,16,299,322,-9
ZNF710,8,17,297,322,-9
ZNF500,4,13,305,322,-9
ZNF30,7,16,299,322,-9
ZNF311,0,9,313,322,-9
ASB12,4,13,305,322,-9
TBC1D16,9,18,295,322,-9
MOB2,10,19,293,322,-9
PHOSPHO2,9,18,295,322,-9
LIMD2,6,15,301,322,-9
CALCB,5,14,303,322,-9
EVA1C,5,14,303,322,-9
CNTNAP3C,13,22,287,322,-9
SMIM5,5,14,303,322,-9
PAGR1,3,12,307,322,-9
CDRT4,31,40,251,322,-9
NOD1,7,16,299,322,-9
AK8,3,12,307,322,-9
CEACAM1,9,18,295,322,-9
CXCL17,7,16,299,322,-9
PABPC5,0,9,313,322,-9
CALHM2,6,15,301,322,-9
HS1BP3,11,20,291,322,-9
HS3ST1,3,12,307,322,-9
DNMT3B,3,12,307,322,-9
SNX4,6,15,301,322,-9
CLYBL,18,27,277,322,-9
PINLYP,15,24,283,322,-9
VPS18,8,17,297,322,-9
DBR1,4,13,305,322,-9
HOXD9,4,13,305,322,-9
APLN,1,10,311,322,-9
SMIM10,4,13,305,322,-9
PTP4A3,8,17,297,322,-9
METTL14,7,16,299,322,-9
TRMT5,6,15,301,322,-9
ANKFN1,5,14,303,322,-9
HAUS8,5,14,303,322,-9
HASPIN,8,17,297,322,-9
C1QL4,8,17,297,322,-9
C22orf31,6,15,301,322,-9
F8A1,6,15,301,322,-9
RAB11FIP4,7,16,299,322,-9
IL15RA,10,19,293,322,-9
CDC42EP5,7,16,299,322,-9
DDX60L,7,16,299,322,-9
HNF4A,3,12,307,322,-9
TRBV10-3,6,15,301,322,-9
CTAGE4,16,25,281,322,-9
LBX2,6,15,301,322,-9
TRAV30,0,9,313,322,-9
C5orf34,6,15,301,322,-9
CTHRC1,11,20,291,322,-9
HOXB2,5,14,303,322,-9
CLDN34,1,10,311,322,-9
AGA,5,14,303,322,-9
SLC23A2,6,15,301,322,-9
CCNA2,5,14,303,322,-9
NPY4R,7,16,299,322,-9
LYSMD2,4,13,305,322,-9
LZTS1,7,16,299,322,-9
IMMP2L,7,16,299,322,-9
XRCC3,6,15,301,322,-9
IFNL1,6,15,301,322,-9
GMEB2,3,12,307,322,-9
TEDC1,6,15,301,322,-9
IGKC,12,21,289,322,-9
GLP2R,3,12,307,322,-9
PLK1,9,18,295,322,-9
EMC2,7,16,299,322,-9
DKK1,5,14,303,322,-9
STARD8,0,9,313,322,-9
RNASE6,0,9,313,322,-9
GGNBP2,5,14,303,322,-9
SUSD3,7,16,299,322,-9
MTM1,8,17,297,322,-9
IFI44,12,21,289,322,-9
DIPK1A,10,19,293,322,-9
RNF31,11,20,291,322,-9
GDF5,2,11,309,322,-9
CHURC1-FNTB,27,36,259,322,-9
EMILIN1,4,13,305,322,-9
TBCC,8,17,297,322,-9
MRTFB,9,18,295,322,-9
TBCD,10,19,293,322,-9
ADPRM,3,12,307,322,-9
LTBR,2,11,309,322,-9
TAS2R38,3,12,307,322,-9
PPP4R4,9,18,295,322,-9
RNF103-CHMP3,22,31,269,322,-9
PPP1R3E,5,14,303,322,-9
SLC49A3,12,22,288,322,-10
PPFIA4,2,12,308,322,-10
IL22RA1,2,12,308,322,-10
PEX11B,7,17,298,322,-10
TRBV12-3,17,27,278,322,-10
CHAMP1,7,17,298,322,-10
METTL7B,6,16,300,322,-10
TSKU,10,20,292,322,-10
TRBV13,10,20,292,322,-10
DDTL,12,22,288,322,-10
ABCC6,10,20,292,322,-10
PIGBOS1,7,17,298,322,-10
ARHGAP8,17,27,278,322,-10
STX16-NPEPL1,17,27,278,322,-10
SPIN2B,7,17,298,322,-10
PLCB2,13,23,286,322,-10
TNFRSF10C,4,14,304,322,-10
CUEDC1,14,24,284,322,-10
FKRP,10,20,292,322,-10
MSH5-SAPCD1,11,21,290,322,-10
SLC6A6,8,18,296,322,-10
PPP1R8,8,18,296,322,-10
PLEKHF1,7,17,298,322,-10
ARMC2,5,15,302,322,-10
EPOP,5,15,302,322,-10
TLR1,15,25,282,322,-10
CTLA4,4,14,304,322,-10
INAFM2,2,12,308,322,-10
EEF2KMT,7,17,298,322,-10
KRTAP1-5,3,13,306,322,-10
ZNF280D,5,15,302,322,-10
MARCHF11,6,16,300,322,-10
C4orf36,17,27,278,322,-10
ZCCHC24,10,20,292,322,-10
C4BPB,12,22,288,322,-10
ZNF287,2,12,308,322,-10
SERTM1,2,12,308,322,-10
H3C2,22,32,268,322,-10
MARCHF7,8,18,296,322,-10
C2CD4D,1,11,310,322,-10
FCER1G,17,27,278,322,-10
S100A3,4,14,304,322,-10
H4C1,31,41,250,322,-10
CCNE2,7,17,298,322,-10
MAGEE1,2,12,308,322,-10
FBXO5,4,14,304,322,-10
GLYATL1,10,20,292,322,-10
DHX32,8,18,296,322,-10
GDPD3,19,29,274,322,-10
GLI1,7,17,298,322,-10
RTL10,9,19,294,322,-10
GLDN,6,16,300,322,-10
GEMIN4,10,20,292,322,-10
SEL1L3,11,21,290,322,-10
GARNL3,18,28,276,322,-10
FAM89A,3,14,305,322,-11
FOSL1,10,21,291,322,-11
COIL,5,16,301,322,-11
KIF2C,7,18,297,322,-11
AHRR,10,21,291,322,-11
TLR3,0,11,311,322,-11
CCDC190,10,21,291,322,-11
SPAG8,8,19,295,322,-11
MNT,9,20,293,322,-11
TNFRSF6B,34,45,243,322,-11
SLC25A13,7,18,297,322,-11
TMCC1,26,37,259,322,-11
SAMD9L,6,17,299,322,-11
HSF2,5,16,301,322,-11
CCDC120,6,17,299,322,-11
GOLGA8O,8,19,295,322,-11
TMEM158,4,15,303,322,-11
TMEM220,12,23,287,322,-11
ICOS,0,11,311,322,-11
AFAP1,9,20,293,322,-11
GOLGA8B,3,14,305,322,-11
CASKIN2,6,17,299,322,-11
YAE1,4,15,303,322,-11
MRM1,7,18,297,322,-11
EGFR,10,21,291,322,-11
BIK,10,21,291,322,-11
ARHGAP11B,2,13,307,322,-11
GRPR,1,12,309,322,-11
RIOX1,2,13,307,322,-11
DNAJC27,2,13,307,322,-11
ZNF449,5,16,301,322,-11
USP13,16,27,279,322,-11
SEPHS2,7,18,297,322,-11
KLHL29,4,15,303,322,-11
SLC16A13,6,17,299,322,-11
TBK1,8,19,295,322,-11
ZFPM1,5,16,301,322,-11
CDC25A,4,15,303,322,-11
ANXA3,5,16,301,322,-11
TVP23C-CDRT4,17,28,277,322,-11
HFM1,10,21,291,322,-11
MTMR6,3,14,305,322,-11
NUDT18,10,21,291,322,-11
ATG16L2,9,20,293,322,-11
CLTCL1,6,17,299,322,-11
AMACR,3,14,305,322,-11
CD3D,6,17,299,322,-11
ENO4,2,13,307,322,-11
ANKRD63,6,17,299,322,-11
ZC3H3,5,16,301,322,-11
PBDC1,6,17,299,322,-11
PTPRE,10,21,291,322,-11
CFAP73,10,21,291,322,-11
MAGEA2,4,15,303,322,-11
CORO7-PAM16,25,36,261,322,-11
SERPINA3,1,12,309,322,-11
TPTEP2-CSNK1E,12,23,287,322,-11
CLDN23,2,13,307,322,-11
ZBTB26,6,17,299,322,-11
FANCE,7,18,297,322,-11
CYBA,7,18,297,322,-11
LIG3,12,23,287,322,-11
ARSI,2,13,307,322,-11
CORO7,10,21,291,322,-11
IGSF10,5,17,300,322,-12
CCDC61,8,20,294,322,-12
MAGED4,27,39,256,322,-12
EPSTI1,7,19,296,322,-12
WNT9A,1,13,308,322,-12
FXYD7,21,33,268,322,-12
ZNF629,7,19,296,322,-12
TAS2R19,8,20,294,322,-12
TLCD1,13,25,284,322,-12
FERMT1,4,16,302,322,-12
ZNF689,8,20,294,322,-12
PLD1,7,19,296,322,-12
GCLC,3,15,304,322,-12
H1-0,7,19,296,322,-12
FAM3D,3,15,304,322,-12
EXOC6,14,26,282,322,-12
EXOC3L4,10,22,290,322,-12
TRGV2,10,22,290,322,-12
TRAM1L1,0,12,310,322,-12
PHETA2,10,22,290,322,-12
H2AC18,17,29,276,322,-12
MICU3,8,20,294,322,-12
C11orf68,6,18,298,322,-12
FAM160A2,10,22,290,322,-12
RBM14-RBM4,18,30,274,322,-12
EVI2A,4,16,302,322,-12
FRAT1,2,14,306,322,-12
NEIL3,5,17,300,322,-12
NCAPH,5,17,300,322,-12
USP27X,5,17,300,322,-12
BATF2,13,25,284,322,-12
ITIH4,1,13,308,322,-12
SLC16A5,5,17,300,322,-12
STX19,6,18,298,322,-12
ZNF575,11,23,288,322,-12
BARD1,7,19,296,322,-12
OXGR1,3,15,304,322,-12
OR2A1,7,19,296,322,-12
NIPAL4,4,16,302,322,-12
SLC2A10,5,17,300,322,-12
HSPA12B,3,15,304,322,-12
NUFIP1,2,14,306,322,-12
KIF20B,6,18,298,322,-12
METTL27,14,27,281,322,-13
SLC16A14,10,23,289,322,-13
RAI1,7,20,295,322,-13
SLC25A2,10,23,289,322,-13
SLC38A4,5,18,299,322,-13
LTV1,6,19,297,322,-13
MFSD2A,5,18,299,322,-13
TAF6L,12,25,285,322,-13
PUDP,7,20,295,322,-13
ZSCAN5A,8,21,293,322,-13
MMEL1,4,17,301,322,-13
LIPE,12,25,285,322,-13
EFCAB5,8,21,293,322,-13
SSMEM1,4,17,301,322,-13
SUV39H1,6,19,297,322,-13
IREB2,7,20,295,322,-13
RGS14,5,18,299,322,-13
RGS3,8,21,293,322,-13
PRR22,8,21,293,322,-13
NUTM2A,9,22,291,322,-13
CSAG2,25,38,259,322,-13
MX2,3,16,303,322,-13
H3C13,22,35,265,322,-13
H2BS1,11,24,287,322,-13
NAA80,8,21,293,322,-13
TMEM131L,5,18,299,322,-13
PLEKHG4,2,15,305,322,-13
CHRFAM7A,8,21,293,322,-13
TRBV14,7,20,295,322,-13
PHC2,8,21,293,322,-13
NCOA5,10,23,289,322,-13
GPR39,1,14,307,322,-13
VSTM5,8,21,293,322,-13
AEN,9,22,291,322,-13
EVI2B,6,19,297,322,-13
GBP1,2,15,305,322,-13
WDR74,7,20,295,322,-13
GOLGA8J,6,19,297,322,-13
GDF15,13,26,283,322,-13
ZBED2,3,16,303,322,-13
OR4N2,3,16,303,322,-13
APOL2,5,18,299,322,-13
TCIRG1,12,25,285,322,-13
E2F8,5,19,298,322,-14
TRIB3,5,19,298,322,-14
TSNARE1,11,25,286,322,-14
CLCF1,4,18,300,322,-14
PRAMEF17,2,16,304,322,-14
PDIK1L,5,19,298,322,-14
KIF20A,8,22,292,322,-14
KANK1,6,20,296,322,-14
PYM1,5,19,298,322,-14
SNN,8,22,292,322,-14
HMGXB4,4,18,300,322,-14
NAGS,4,18,300,322,-14
HOXC4,6,20,296,322,-14
SIN3A,9,23,290,322,-14
SPSB2,7,21,294,322,-14
TOE1,6,20,296,322,-14
HCST,26,40,256,322,-14
MTERF3,5,19,298,322,-14
AMER1,3,17,302,322,-14
PAQR5,5,19,298,322,-14
TAS2R20,10,24,288,322,-14
RPUSD2,7,21,294,322,-14
GPR183,7,21,294,322,-14
SYNDIG1,0,14,308,322,-14
PPP1R35,5,19,298,322,-14
H3C7,15,29,278,322,-14
PALB2,6,20,296,322,-14
LEO1,5,19,298,322,-14
PATZ1,11,25,286,322,-14
PET117,11,26,285,322,-15
TP53INP1,9,24,289,322,-15
PRSS36,12,27,283,322,-15
ETAA1,4,19,299,322,-15
ZBTB24,2,17,303,322,-15
CCDC188,1,16,305,322,-15
ADGRF1,4,19,299,322,-15
RASSF7,5,20,297,322,-15
FGD3,4,19,299,322,-15
S100A1,28,43,251,322,-15
FADD,10,25,287,322,-15
GPR146,10,25,287,322,-15
DDX58,7,22,293,322,-15
CLPX,5,20,297,322,-15
TRIM21,3,18,301,322,-15
RDH14,5,20,297,322,-15
C16orf71,9,24,289,322,-15
PYCR3,5,20,297,322,-15
MBD4,5,20,297,322,-15
CRYBG2,4,19,299,322,-15
KDM4D,1,16,305,322,-15
TEX38,12,27,283,322,-15
SYCE1L,29,44,249,322,-15
TIGD5,7,22,293,322,-15
TMEM18,5,20,297,322,-15
KBTBD3,6,21,295,322,-15
CENPC,4,19,299,322,-15
BEGAIN,5,20,297,322,-15
IL2RG,10,25,287,322,-15
ZNF627,6,21,295,322,-15
BMF,8,23,291,322,-15
JMJD4,6,21,295,322,-15
ESPL1,6,21,295,322,-15
INMT-MINDY4,18,33,271,322,-15
TIFA,3,18,301,322,-15
RTP3,8,24,290,322,-16
SYT12,3,19,300,322,-16
GPR1,6,22,294,322,-16
TAB1,7,23,292,322,-16
C1GALT1C1L,2,18,302,322,-16
TBCEL-TECTA,18,34,270,322,-16
TMEM86A,2,18,302,322,-16
PPP1R3D,4,20,298,322,-16
ST3GAL1,8,24,290,322,-16
CCR1,1,17,304,322,-16
H3C1,16,32,274,322,-16
CBY2,4,20,298,322,-16
PPRC1,7,23,292,322,-16
ZNF775,8,24,290,322,-16
MAMSTR,5,21,296,322,-16
POLA2,4,20,298,322,-16
ZBTB45,7,23,292,322,-16
GLCE,5,21,296,322,-16
SH3TC1,14,30,278,322,-16
SOWAHD,11,27,284,322,-16
PPARGC1B,5,21,296,322,-16
CEMP1,16,32,274,322,-16
APOM,12,28,282,322,-16
CCNF,8,25,289,322,-17
NOTCH2NLC,13,30,279,322,-17
DOLK,7,24,291,322,-17
PSCA,10,27,285,322,-17
TMEM89,28,45,249,322,-17
PRR15L,8,25,289,322,-17
PCSK9,2,19,301,322,-17
INSYN2B,0,17,305,322,-17
RFESD,5,22,295,322,-17
ZNF564,9,26,287,322,-17
LCMT2,7,24,291,322,-17
WNT5B,11,28,283,322,-17
PLK4,2,19,301,322,-17
IFIT5,5,23,294,322,-18
ALDH1B1,6,24,292,322,-18
PLPP6,6,24,292,322,-18
ASB13,6,24,292,322,-18
HJURP,5,23,294,322,-18
SSPN,6,24,292,322,-18
GPR68,5,23,294,322,-18
AGFG2,2,20,300,322,-18
IMP3,5,23,294,322,-18
FLI1,3,21,298,322,-18
KLHDC7A,2,20,300,322,-18
TNS4,1,19,302,322,-18
NAT2,5,23,294,322,-18
ZNF579,5,23,294,322,-18
ACCS,4,23,295,322,-19
PCED1B,9,28,285,322,-19
RGS4,16,35,271,322,-19
GGACT,16,35,271,322,-19
SPATA2L,10,29,283,322,-19
CDCA8,4,23,295,322,-19
C14orf39,25,44,253,322,-19
NDST2,16,35,271,322,-19
PTPRCAP,20,39,263,322,-19
CDCA4,6,25,291,322,-19
TRAV18,5,24,293,322,-19
C14orf28,1,20,301,322,-19
NANP,4,23,295,322,-19
NUDT8,8,28,286,322,-20
SPOUT1,15,35,272,322,-20
BDKRB2,0,20,302,322,-20
MAP10,0,20,302,322,-20
EFNA4,9,29,284,322,-20
PRMT6,7,27,288,322,-20
PEDS1-UBE2V1,28,48,246,322,-20
VPS33B,8,28,286,322,-20
H2AC21,30,50,242,322,-20
FASTKD2,2,22,298,322,-20
IER3,8,28,286,322,-20
ADPRS,11,31,280,322,-20
D2HGDH,14,35,273,322,-21
DHX35,6,27,289,322,-21
GPR3,3,24,295,322,-21
TADA1,8,29,285,322,-21
MUSTN1,41,62,219,322,-21
CRY2,11,32,279,322,-21
DGAT2,3,24,295,322,-21
SH3BP4,8,29,285,322,-21
TMEM177,6,27,289,322,-21
HYAL2,8,30,284,322,-22
NPIPA7,17,39,266,322,-22
H1-4,14,36,272,322,-22
HYLS1,4,26,292,322,-22
LENG9,9,31,282,322,-22
NGF,5,27,290,322,-22
HILPDA,2,24,296,322,-22
ARHGAP40,7,29,286,322,-22
ARHGAP22,1,23,298,322,-22
UFSP1,14,36,272,322,-22
ZNF624,5,27,290,322,-22
ZHX2,5,28,289,322,-23
KCNQ5,10,33,279,322,-23
FJX1,11,34,277,322,-23
GLI2,11,34,277,322,-23
METTL1,9,32,281,322,-23
PLAU,6,29,287,322,-23
CCRL2,3,26,293,322,-23
EML1,7,30,285,322,-23
INKA1,11,34,277,322,-23
HAS2,5,29,288,322,-24
LIF,4,28,290,322,-24
TUBGCP5,6,30,286,322,-24
CAMKK1,7,31,284,322,-24
ZBED5,5,29,288,322,-24
KRTAP2-3,8,33,281,322,-25
LFNG,11,36,275,322,-25
DDX28,5,30,287,322,-25
APOL3,10,36,276,322,-26
GIMAP2,2,28,292,322,-26
PIF1,2,28,292,322,-26
TTC30B,3,29,290,322,-26
RSC1A1,18,44,260,322,-26
PWP2,15,41,266,322,-26
CITED4,10,36,276,322,-26
TREX2,9,35,278,322,-26
CSNK2A3,12,38,272,322,-26
S1PR5,1,28,293,322,-27
ZNF792,4,31,287,322,-27
TREX1,28,56,238,322,-28
IL1B,7,35,280,322,-28
HOXC5,7,36,279,322,-29
LIPT2,4,33,285,322,-29
MIEF2,5,35,282,322,-30
H1-2,11,42,269,322,-31
CCDC71,9,40,273,322,-31
IFIT3,8,39,275,322,-31
SAPCD1,46,78,198,322,-32
CLDND2,17,49,256,322,-32
STARD6,11,44,267,322,-33
HPS6,5,41,276,322,-36
N4BP1,3,44,275,322,-41
ZNF784,8,50,264,322,-42
TSSK3,28,71,223,322,-43
HRCT1,7,59,256,322,-52
H1-3,10,81,231,322,-71