GeneName,up5,dn5,unchange5,all,HN5
Hspa1b,152,3,87,242,149
Hspa1a,140,3,99,242,137
Hspb1,112,1,129,242,111
Gm20481,95,7,140,242,88
Atf3,81,3,158,242,78
Dnajb1,71,0,171,242,71
Hsph1,66,2,174,242,64
Bag3,53,2,187,242,51
Fos,59,8,175,242,51
Edn1,46,1,195,242,45
Egr1,51,7,184,242,44
Phlda1,43,1,198,242,42
Ccnb1ip1,57,19,166,242,38
Hsp90aa1,39,2,201,242,37
Hspb8,39,3,200,242,36
Kcnk4,40,5,197,242,35
Best2,35,0,207,242,35
Dnaja4,40,5,197,242,35
Fgf21,37,4,201,242,33
Xirp1,39,6,197,242,33
Gm44505,43,11,188,242,32
Hspa1l,39,7,196,242,32
Gml,37,7,198,242,30
Ccn1,34,4,204,242,30
Chac1,37,7,198,242,30
Phlda2,32,3,207,242,29
Myo1g,36,7,199,242,29
Tex52,32,3,207,242,29
Jun,33,5,204,242,28
Egr2,39,11,192,242,28
Mc4r,27,0,215,242,27
Clu,31,4,207,242,27
Acta1,33,6,203,242,27
Pspn,40,13,189,242,27
Dnaja1,29,3,210,242,26
Gm21738,46,20,176,242,26
Ddit4,28,2,212,242,26
Serpinf2,28,2,212,242,26
Ly6g6c,38,12,192,242,26
H1f8,29,4,209,242,25
Lrrc26,27,3,212,242,24
Pmaip1,28,4,210,242,24
Gml2,27,3,212,242,24
Gm38100,24,0,218,242,24
Prtn3,30,6,206,242,24
Arc,34,11,197,242,23
Gm14406,40,17,185,242,23
Lrg1,28,5,209,242,23
Gm49356,53,30,159,242,23
Lbx2,26,4,212,242,22
Gm11563,27,5,210,242,22
Mt2,28,6,208,242,22
Dedd2,24,2,216,242,22
Il1r2,32,10,200,242,22
Cebpb,22,0,220,242,22
Cdkn1a,23,1,218,242,22
Serpina3n,22,0,220,242,22
Hspe1,22,0,220,242,22
Wfdc18,34,12,196,242,22
Ly6k,24,2,216,242,22
Gdf15,28,6,208,242,22
Ifitm5,36,14,192,242,22
Gm16253,31,9,202,242,22
Krtap4-16,21,0,221,242,21
Tnfrsf23,26,5,211,242,21
Lman1l,24,3,215,242,21
Cyp2e1,27,6,209,242,21
Fam71d,32,11,199,242,21
Nfil3,23,2,217,242,21
Spp1,26,5,211,242,21
Iqcf1,31,10,201,242,21
Pla2g4c,23,2,217,242,21
Defb42,26,5,211,242,21
Krtap1-5,25,5,212,242,20
S100a9,29,9,204,242,20
Ifitm10,24,4,214,242,20
Dnajb4,24,4,214,242,20
Cys1,23,3,216,242,20
Rsrp1,22,2,218,242,20
Trib3,23,3,216,242,20
Ahsa2,22,2,218,242,20
Serpinh1,22,3,217,242,19
Cldn11,23,4,215,242,19
Arl9,39,20,183,242,19
Mt1,23,4,215,242,19
Maff,22,3,217,242,19
Krt6a,23,4,215,242,19
Ccl11,22,3,217,242,19
Defa24,21,2,219,242,19
Ism2,19,0,223,242,19
Nr4a3,24,5,213,242,19
Crybb3,24,5,213,242,19
Cldn4,25,6,211,242,19
Snap25,19,1,222,242,18
Mansc1,22,4,216,242,18
Oxt,35,17,190,242,18
Ubc,18,0,224,242,18
Gpr75,18,0,224,242,18
Lgals7,29,11,202,242,18
Rhox8,31,13,198,242,18
Cd79a,22,4,216,242,18
S100a3,29,11,202,242,18
Rrad,25,7,210,242,18
Ccer2,23,5,214,242,18
Kcnj14,22,4,216,242,18
Mndal,25,7,210,242,18
Adora2a,20,3,219,242,17
Saa1,29,12,201,242,17
P2rx7,21,4,217,242,17
Fgf17,20,3,219,242,17
Junb,22,5,215,242,17
Muc13,18,1,223,242,17
Ighg2b,20,3,219,242,17
Cryab,19,2,221,242,17
Socs3,23,6,213,242,17
Arl5c,22,5,215,242,17
Lcn2,25,8,209,242,17
Gm21976,22,5,215,242,17
Mzb1,40,23,179,242,17
Cyp2d40,18,1,223,242,17
Il10,21,4,217,242,17
Gm6169,31,14,197,242,17
Banp,18,2,222,242,16
Gm45234,36,20,186,242,16
Cplx3,23,7,212,242,16
Mpo,22,6,214,242,16
Gadd45g,20,4,218,242,16
Mpzl2,18,2,222,242,16
Tex43,30,14,198,242,16
Avp,25,9,208,242,16
Rbmy,18,2,222,242,16
Tmem252,16,0,226,242,16
Ptcra,23,7,212,242,16
Igfbp3,16,0,226,242,16
Pin1rt1,30,14,198,242,16
H4c18,30,14,198,242,16
Slc5a5,18,2,222,242,16
Trpc2,20,4,218,242,16
Elf3,19,3,220,242,16
Hsd17b1,20,4,218,242,16
Hrk,17,1,224,242,16
Gm38999,22,6,214,242,16
Ly6g6d,22,6,214,242,16
Gm5741,40,24,178,242,16
AF366264,21,5,216,242,16
H3c8,33,17,192,242,16
Myocos,22,6,214,242,16
Best3,18,2,222,242,16
Spry4,19,3,220,242,16
Actc1,21,5,216,242,16
Asns,18,2,222,242,16
Apoc3,24,9,209,242,15
Fermt3,21,6,215,242,15
Btg2,19,4,219,242,15
Apoc1,26,11,205,242,15
Gm10720,22,7,213,242,15
Bglap,36,21,185,242,15
Gm3376,17,2,223,242,15
Nme5,24,9,209,242,15
Cabp5,17,2,223,242,15
Ighg2c,21,6,215,242,15
Gm10800,37,22,183,242,15
Gm10801,39,24,179,242,15
Ifi205,24,9,209,242,15
P4ha1,19,4,219,242,15
Gm28035,22,7,213,242,15
Hmgcs2,20,5,217,242,15
Ccdc194,20,5,217,242,15
Fthl17c,17,2,223,242,15
Crygs,20,5,217,242,15
Xlr5b,21,6,215,242,15
Psca,26,11,205,242,15
Cldn7,24,9,209,242,15
Nmu,21,6,215,242,15
Retn,29,14,199,242,15
Iqcn,15,0,227,242,15
Hmox1,15,1,226,242,14
Id1,20,6,216,242,14
Hspe1-rs1,41,27,174,242,14
Havcr1,16,2,224,242,14
Parvg,21,7,214,242,14
A3galt2,18,4,220,242,14
Hhatl,23,9,210,242,14
Tnfrsf12a,19,5,218,242,14
Defb19,21,7,214,242,14
Nr0b2,17,3,222,242,14
Fut1,19,5,218,242,14
Gal,16,2,224,242,14
Nat8f7,23,9,210,242,14
Ramp3,20,6,216,242,14
Vpreb1,30,16,196,242,14
Spon2,17,3,222,242,14
1700007K13Rik,25,11,206,242,14
Krtap3-2,15,1,226,242,14
Noxred1,22,8,212,242,14
Cldn19,24,10,208,242,14
Cldn6,18,4,220,242,14
Rnf224,17,3,222,242,14
Snapc1l,32,18,192,242,14
Klf6,15,1,226,242,14
Rasl11a,21,7,214,242,14
Acnat1,17,3,222,242,14
Ugt1a10,20,6,216,242,14
H2-Bl,25,11,206,242,14
Gm10718,36,22,184,242,14
Susd3,15,1,226,242,14
Iqca1l,18,4,220,242,14
Serpina3i,20,6,216,242,14
Igkv8-28,16,2,224,242,14
Obp2a,16,2,224,242,14
Cfd,24,10,208,242,14
Myc,16,3,223,242,13
Trim72,15,2,225,242,13
Rnf223,13,0,229,242,13
Cldn15,16,3,223,242,13
Retnlg,22,9,211,242,13
Msantd1,19,6,217,242,13
Trib2,17,4,221,242,13
Bst2,17,4,221,242,13
Mt4,21,8,213,242,13
Tceal5,22,9,211,242,13
Gm11032,34,21,187,242,13
Fosb,21,8,213,242,13
Apoa1,21,8,213,242,13
Hba-a2,28,15,199,242,13
Igha,18,5,219,242,13
Igfbp7,16,3,223,242,13
Dusp8,19,6,217,242,13
Acbd7,24,11,207,242,13
Gabrr2,17,4,221,242,13
Klrb1b,14,1,227,242,13
Tnfsf9,18,5,219,242,13
Adig,30,17,195,242,13
Krt20,13,0,229,242,13
Fpr2,26,13,203,242,13
Hspa4l,16,3,223,242,13
A730049H05Rik,18,5,219,242,13
Col6a3,15,2,225,242,13
Fgf8,16,3,223,242,13
Defa3,17,4,221,242,13
Mroh6,13,0,229,242,13
Sphk1,22,9,211,242,13
Ccl21a,15,2,225,242,13
Cd3e,14,1,227,242,13
Ccr5,27,14,201,242,13
Gpnmb,19,6,217,242,13
Ctrb1,21,8,213,242,13
Potegl,14,1,227,242,13
Gm28053,26,13,203,242,13
Cysrt1,27,14,201,242,13
Gsta2,19,6,217,242,13
H3c2,34,21,187,242,13
Ctsk,22,9,211,242,13
Gm3285,13,0,229,242,13
Pla2g12b,16,3,223,242,13
Tdgf1,16,4,222,242,12
Wfdc10,17,5,220,242,12
Olfr1033,22,10,210,242,12
Sytl1,14,2,226,242,12
Prrg4,21,9,212,242,12
Rragd,14,2,226,242,12
Gcg,17,5,220,242,12
Tmem200b,18,6,218,242,12
Idi2,14,2,226,242,12
Prm1,28,16,198,242,12
Ren1,17,5,220,242,12
Aqp5,24,12,206,242,12
Hpn,12,0,230,242,12
Apol9a,24,12,206,242,12
Pdk4,15,3,224,242,12
Orm1,22,10,210,242,12
Hpd,17,5,220,242,12
Olfr1039,20,8,214,242,12
Maob,14,2,226,242,12
Mmp23,17,5,220,242,12
Gjc2,12,0,230,242,12
Rplp2-ps1,24,12,206,242,12
Lyst,27,15,200,242,12
Lypd1,14,2,226,242,12
Gm21854,17,5,220,242,12
Gm21778,21,9,212,242,12
Serping1,13,1,228,242,12
Gstp3,21,9,212,242,12
Slc38a3,16,4,222,242,12
Hsd17b6,13,1,228,242,12
Rpl36a-ps1,39,27,176,242,12
Hsd11b2,20,8,214,242,12
Espn,14,2,226,242,12
Amhr2,17,5,220,242,12
Selplg,22,10,210,242,12
Islr2,14,2,226,242,12
Timp1,20,8,214,242,12
Adm2,14,2,226,242,12
Alpk2,17,5,220,242,12
Gm17728,26,14,202,242,12
Evpl,14,2,226,242,12
Hhipl2,19,7,216,242,12
Klhl40,15,3,224,242,12
Cck,20,8,214,242,12
Gm11213,14,2,226,242,12
Fibcd1,13,1,228,242,12
Cxcr4,21,9,212,242,12
Gm9999,23,11,208,242,12
Fthl17d,13,1,228,242,12
H2ac10,39,27,176,242,12
Ccl8,32,20,190,242,12
H2ac15,35,23,184,242,12
Cuzd1,13,1,228,242,12
4930486L24Rik,32,20,190,242,12
Tsc22d3,19,7,216,242,12
Slc6a8,13,1,228,242,12
Igflr1,41,29,172,242,12
Mrgprh,12,0,230,242,12
Adam30,18,6,218,242,12
Cd83,14,2,226,242,12
Hspd1,15,3,224,242,12
Ighv1-55,16,4,222,242,12
Scx,20,8,214,242,12
Card9,16,4,222,242,12
Vsig4,15,3,224,242,12
Cx3cl1,15,3,224,242,12
Gadd45a,13,1,228,242,12
Zfand2a,15,3,224,242,12
Angptl4,17,5,220,242,12
Zbtb16,15,3,224,242,12
Ch25h,19,7,216,242,12
Fgf18,20,8,214,242,12
Cd79b,17,5,220,242,12
Guca1b,15,4,223,242,11
Tmigd1,14,3,225,242,11
Gm21693,12,1,229,242,11
Creb5,13,2,227,242,11
Cyp2c55,17,6,219,242,11
Sbk3,14,3,225,242,11
Ephx3,14,3,225,242,11
Igkv2-109,13,2,227,242,11
Fam71a,15,4,223,242,11
Olfr286,12,1,229,242,11
Trav6d-6,13,2,227,242,11
Dlk1,14,3,225,242,11
Gm10563,34,23,185,242,11
Unc93a,13,2,227,242,11
Hbb-bs,15,4,223,242,11
Rpl9-ps6,26,15,201,242,11
Sfn,15,4,223,242,11
Gadd45b,14,3,225,242,11
Trbv14,13,2,227,242,11
Ppargc1a,11,0,231,242,11
Ptprn,14,3,225,242,11
Kitl,15,4,223,242,11
Klhdc7b,14,3,225,242,11
Fxyd4,21,10,211,242,11
Slc5a3,15,4,223,242,11
Gpr132,22,11,209,242,11
Klrd1,28,17,197,242,11
Edn2,13,2,227,242,11
Scgb1c1,30,19,193,242,11
Slfn1,14,3,225,242,11
Nkx2-5,12,1,229,242,11
Chrna4,16,5,221,242,11
Lrit3,11,0,231,242,11
Sectm1b,18,7,217,242,11
Areg,17,6,219,242,11
Tktl1,14,3,225,242,11
Olfr1369-ps1,14,3,225,242,11
Tceal6,11,0,231,242,11
Ppp1r15a,14,3,225,242,11
Apoa4,12,1,229,242,11
Ltc4s,26,15,201,242,11
Gm8251,15,4,223,242,11
Pipox,14,3,225,242,11
Slc45a1,11,0,231,242,11
Ltb4r1,14,3,225,242,11
Pip5kl1,18,7,217,242,11
Rasgef1b,11,0,231,242,11
Rrh,16,5,221,242,11
Itgb8,14,3,225,242,11
Pde6g,18,7,217,242,11
Tepp,21,10,211,242,11
Sycn,15,4,223,242,11
Laptm5,13,2,227,242,11
Hspa8,15,4,223,242,11
Msgn1,12,1,229,242,11
Gm13398,12,1,229,242,11
Gm49339,14,3,225,242,11
Slc10a5,11,0,231,242,11
Olfr907,16,5,221,242,11
Akr1b7,19,8,215,242,11
Slc10a6,13,2,227,242,11
Tnfrsf25,17,6,219,242,11
Gm17349,34,23,185,242,11
Mmp12,17,6,219,242,11
Etv2,16,5,221,242,11
Stip1,15,4,223,242,11
Ugt1a1,13,2,227,242,11
Pramel42,11,0,231,242,11
Themis,19,8,215,242,11
C1ql2,12,1,229,242,11
Fam180a,20,9,213,242,11
Slc23a3,17,6,219,242,11
4930444G20Rik,21,10,211,242,11
Tnfsf18,13,2,227,242,11
Hoxd10,11,0,231,242,11
Trim43b,18,7,217,242,11
H4c12,28,18,196,242,10
Cox8a,13,3,226,242,10
Alx3,13,3,226,242,10
Mmp3,13,3,226,242,10
Cmtm8,14,4,224,242,10
Rasgrp2,18,8,216,242,10
Tex29,23,13,206,242,10
Pawr,12,2,228,242,10
Serpina6,11,1,230,242,10
Gm49325,27,17,198,242,10
Ckmt1,12,2,228,242,10
Smim5,22,12,208,242,10
Mmp13,14,4,224,242,10
Pbld1,19,9,214,242,10
Olfr1419,15,5,222,242,10
Ghrh,26,16,200,242,10
Abhd3,12,2,228,242,10
Wnt1,15,5,222,242,10
Sparcl1,10,0,232,242,10
Cplx1,15,5,222,242,10
Slc39a4,12,2,228,242,10
Tnnt1,21,11,210,242,10
Lyl1,22,12,208,242,10
Gstt4,15,5,222,242,10
Prxl2b,10,0,232,242,10
Gm21961,30,20,192,242,10
Cpn1,14,4,224,242,10
Olfr847,16,6,220,242,10
Serpine1,16,6,220,242,10
Serpine2,14,4,224,242,10
Il33,15,5,222,242,10
Trac,30,20,192,242,10
Fcgr1,20,10,212,242,10
Krt19,12,2,228,242,10
Gm20683,15,5,222,242,10
Gpr3,21,11,210,242,10
Asgr1,16,6,220,242,10
Ftl1-ps1,19,9,214,242,10
Hey1,10,0,232,242,10
Flg,12,2,228,242,10
Cdcp2,10,0,232,242,10
Lepr,22,12,208,242,10
Fgl1,15,5,222,242,10
Tmc4,14,4,224,242,10
Rab44,13,3,226,242,10
Notch3,10,0,232,242,10
Slfn5,16,6,220,242,10
Nog,18,8,216,242,10
Cyp4a14,10,0,232,242,10
Gnat1,31,21,190,242,10
Nrn1l,26,16,200,242,10
Rhox2d,14,4,224,242,10
Serpina10,11,1,230,242,10
Nupr1,15,5,222,242,10
Ttc36,25,15,202,242,10
Fcgr2b,18,8,216,242,10
Cox6b2,19,9,214,242,10
Prickle1,13,3,226,242,10
Cox6a2,26,16,200,242,10
Hoxb7,13,3,226,242,10
Zfp948,11,1,230,242,10
Hamp,37,27,178,242,10
Rgs1,12,2,228,242,10
F2rl2,15,5,222,242,10
Uspl1,11,1,230,242,10
Ezhip,10,0,232,242,10
Gabra3,10,0,232,242,10
Tafa1,12,2,228,242,10
Ptpn5,11,1,230,242,10
Akr1c18,15,5,222,242,10
Magea6,11,1,230,242,10
Csn3,21,11,210,242,10
Gm11634,22,12,208,242,10
Gm49368,28,18,196,242,10
Gm49416,36,26,180,242,10
Glod5,15,5,222,242,10
Bcl6,11,1,230,242,10
Igkv4-74,13,3,226,242,10
1700001K19Rik,20,10,212,242,10
Prss22,14,4,224,242,10
Olfr71,19,9,214,242,10
Gm13090,12,2,228,242,10
Prr18,15,5,222,242,10
Ier2,14,4,224,242,10
Ccnb3,10,0,232,242,10
Marveld2,14,4,224,242,10
Igkv16-104,15,5,222,242,10
Igkv12-38,13,3,226,242,10
Rorc,11,1,230,242,10
Olfr655,16,6,220,242,10
Tent5a,11,1,230,242,10
Trim12a,19,9,214,242,10
Plat,12,2,228,242,10
Cpxm2,11,1,230,242,10
Cebpd,10,0,232,242,10
H2ac22,30,20,192,242,10
Gm10721,29,19,194,242,10
Fam209,31,21,190,242,10
A930017K11Rik,13,3,226,242,10
Proser2,13,3,226,242,10
Gm49388,34,24,184,242,10
Swt1,12,2,228,242,10
Zfp990,16,7,219,242,9
Kcne1l,10,1,231,242,9
Ppp1r3c,12,3,227,242,9
Gal3st2,17,8,217,242,9
Gm21677,9,0,233,242,9
Ptpn22,13,4,225,242,9
Spib,12,3,227,242,9
A630073D07Rik,10,1,231,242,9
Rhox7a,19,10,213,242,9
Nscme3l,21,12,209,242,9
Scn5a,10,1,231,242,9
Sct,18,9,215,242,9
Gprc5a,13,4,225,242,9
Ighv1-72,11,2,229,242,9
2510002D24Rik,12,3,227,242,9
Defb29,12,3,227,242,9
Sdsl,11,2,229,242,9
Uroc1,11,2,229,242,9
Defb25,21,12,209,242,9
Gm28374,26,17,199,242,9
E330021D16Rik,16,7,219,242,9
Defb23,10,1,231,242,9
Mgl2,17,8,217,242,9
Lrcol1,17,8,217,242,9
Elovl5,13,4,225,242,9
Mdfi,14,5,223,242,9
Fga,12,3,227,242,9
Trbv13-3,12,3,227,242,9
Kctd18,13,4,225,242,9
Tmem35a,9,0,233,242,9
Fut7,13,4,225,242,9
Elavl3,12,3,227,242,9
Gm10985,34,25,183,242,9
Rnd3,17,8,217,242,9
Asb11,16,7,219,242,9
Ubash3a,14,5,223,242,9
Krt5,11,2,229,242,9
1700102P08Rik,18,9,215,242,9
Gm21060,23,14,205,242,9
Chst11,11,2,229,242,9
Foxq1,9,0,233,242,9
Sat1,10,1,231,242,9
Fmod,13,4,225,242,9
Adamts1,13,4,225,242,9
Lad1,9,0,233,242,9
Ehf,12,3,227,242,9
Fosl2,15,6,221,242,9
Sbsn,16,7,219,242,9
C2,17,8,217,242,9
C3,12,3,227,242,9
Tnfrsf13c,13,4,225,242,9
Mrln,33,24,185,242,9
Sprr2a2,18,9,215,242,9
Fst,11,2,229,242,9
Mgarp,15,6,221,242,9
Crybb2,12,3,227,242,9
Trav13d-3,19,10,213,242,9
Tmem141,10,1,231,242,9
Mep1a,11,2,229,242,9
Pigz,23,14,205,242,9
Galp,15,6,221,242,9
Spry1,10,1,231,242,9
Neu2,14,5,223,242,9
Hba-a1,22,13,207,242,9
H2-T23,15,6,221,242,9
Tat,11,2,229,242,9
Bhlhe41,12,3,227,242,9
Slc18a1,18,9,215,242,9
Cyp2j9,11,2,229,242,9
Clec5a,15,6,221,242,9
Defa39,12,3,227,242,9
Hesx1,9,0,233,242,9
Eda2r,12,3,227,242,9
Nptx1,9,0,233,242,9
Tac2,18,9,215,242,9
Lrrc2,14,5,223,242,9
Hormad2,13,4,225,242,9
Grp,11,2,229,242,9
Cd53,13,4,225,242,9
ccdc198,11,2,229,242,9
Ly6g5c,22,13,207,242,9
Gstm3,11,2,229,242,9
Fam163a,14,5,223,242,9
H2bw2,11,2,229,242,9
Renbp,12,3,227,242,9
Cyp21a1,10,1,231,242,9
Gem,14,5,223,242,9
Derpc,47,38,157,242,9
Mylk2,12,3,227,242,9
Igkv10-94,12,3,227,242,9
Fam83b,10,1,231,242,9
Xlr3c,19,10,213,242,9
Mmp10,12,3,227,242,9
AB124611,14,5,223,242,9
Gm4064,11,2,229,242,9
Il6,23,14,205,242,9
Dpp7,10,1,231,242,9
Tulp1,15,6,221,242,9
Icam1,11,2,229,242,9
Synb,12,3,227,242,9
Wap,21,12,209,242,9
Prss39,10,1,231,242,9
Sim1,10,1,231,242,9
Olfr1391,10,1,231,242,9
Pla2g2e,21,12,209,242,9
Tex19.1,10,1,231,242,9
Syce3,23,14,205,242,9
Baat,12,3,227,242,9
Sfrp5,12,3,227,242,9
Hpx,15,6,221,242,9
Soat2,13,4,225,242,9
Slc30a2,13,4,225,242,9
Bsx,10,1,231,242,9
Jchain,12,3,227,242,9
Emb,10,1,231,242,9
Orm2,21,12,209,242,9
Alpl,12,3,227,242,9
Trim2,13,4,225,242,9
Prg2,16,7,219,242,9
Gast,29,20,193,242,9
Plekhg1,9,0,233,242,9
Dusp1,16,7,219,242,9
Robo4,14,5,223,242,9
Hoxb8,11,2,229,242,9
F3,13,4,225,242,9
Hoxb4,14,5,223,242,9
Thegl,15,6,221,242,9
Jdp2,13,4,225,242,9
Rasgef1c,11,2,229,242,9
Ms4a4a,13,4,225,242,9
Pla2g4b,22,14,206,242,8
Lilr4b,11,3,228,242,8
Ngef,9,1,232,242,8
Fbp2,8,0,234,242,8
Fcrl1,10,2,230,242,8
Tcim,12,4,226,242,8
Eif1ad12,14,6,222,242,8
Magea2,12,4,226,242,8
Myod1,8,0,234,242,8
Rnf125,11,3,228,242,8
Rsad2,12,4,226,242,8
Ccdc68,10,2,230,242,8
Gm49392,23,15,204,242,8
Mtnr1a,10,2,230,242,8
Misp,10,2,230,242,8
Cxcl2,16,8,218,242,8
Myoz2,12,4,226,242,8
Majin,10,2,230,242,8
Ccbe1,10,2,230,242,8
Tcf23,8,0,234,242,8
Lce1f,13,5,224,242,8
Sox8,16,8,218,242,8
Gm49354,31,23,188,242,8
Ret,9,1,232,242,8
Ankrd1,14,6,222,242,8
Zp1,19,11,212,242,8
Tfpi2,12,4,226,242,8
Lat2,17,9,216,242,8
Cyp2s1,12,4,226,242,8
Aldh3b2,11,3,228,242,8
Mup6,17,9,216,242,8
Amotl2,11,3,228,242,8
Zmynd8,14,6,222,242,8
Pnldc1,19,11,212,242,8
Adra2a,10,2,230,242,8
Spats2l,11,3,228,242,8
Ly6a,19,11,212,242,8
Trip6,11,3,228,242,8
Gm7592,12,4,226,242,8
Mapk13,10,2,230,242,8
Rhox2a,18,10,214,242,8
Smim41,12,4,226,242,8
Pnmt,11,3,228,242,8
Cxcl1,31,23,188,242,8
Rhox2c,16,8,218,242,8
Rhox2e,12,4,226,242,8
Fabp9,12,4,226,242,8
Arhgap27,10,2,230,242,8
Evi2b,25,17,200,242,8
Pnliprp1,10,2,230,242,8
Mfsd10,15,7,220,242,8
Cxcr2,17,9,216,242,8
Mmp25,8,0,234,242,8
Gm9745,13,5,224,242,8
Litaf,13,5,224,242,8
Aqp8,11,3,228,242,8
Trim10,11,3,228,242,8
Ccn2,13,5,224,242,8
Nbl1,11,3,228,242,8
Rhox1,8,0,234,242,8
Cidec,18,10,214,242,8
Cldn5,14,6,222,242,8
Adamtsl2,10,2,230,242,8
Aox1,11,3,228,242,8
Ncf1,11,3,228,242,8
Mia,26,18,198,242,8
Fkbp4,11,3,228,242,8
Gm49486,15,7,220,242,8
Gm5148,13,5,224,242,8
Myo15,9,1,232,242,8
Tfe3,11,3,228,242,8
Mboat7,11,3,228,242,8
Neurl2,15,7,220,242,8
Mvp,10,2,230,242,8
Kif28,9,1,232,242,8
Tubb4a,9,1,232,242,8
H4c2,21,13,208,242,8
Vegfc,12,4,226,242,8
Pcbd1,16,8,218,242,8
Auts2,8,0,234,242,8
Dsc2,9,1,232,242,8
Grn,9,1,232,242,8
Inhbb,11,3,228,242,8
Ildr2,11,3,228,242,8
Aldh1a3,16,8,218,242,8
Ifi204,12,4,226,242,8
Zfp36,15,7,220,242,8
H2bc24,26,18,198,242,8
H2bc15,38,30,174,242,8
Tmem33,9,1,232,242,8
Il27,12,4,226,242,8
Il22ra1,10,2,230,242,8
Tmem221,15,7,220,242,8
Tmem213,17,9,216,242,8
Slc25a34,9,1,232,242,8
Gm26938,31,23,188,242,8
Gpt2,11,3,228,242,8
Kcne1,14,6,222,242,8
Defb48,17,9,216,242,8
Stpg3,10,2,230,242,8
Galr2,12,4,226,242,8
Grb14,12,4,226,242,8
Habp2,10,2,230,242,8
Stra6,14,6,222,242,8
Cfap300,13,5,224,242,8
Itpk1,10,2,230,242,8
Hs6st1,10,2,230,242,8
Serpina1b,16,8,218,242,8
Olfr1,8,0,234,242,8
Serpina3f,13,5,224,242,8
H4c6,30,22,190,242,8
Gm11757,8,0,234,242,8
H2al1c,9,1,232,242,8
Cryba4,13,5,224,242,8
Il1a,12,4,226,242,8
Gm1140,15,7,220,242,8
Igfbp2,12,4,226,242,8
Ighv3-3,11,3,228,242,8
Gm10490,38,30,174,242,8
Gvin1,17,9,216,242,8
Gm10715,22,14,206,242,8
Cel,12,4,226,242,8
Prr29,12,4,226,242,8
A030014E15Rik,14,6,222,242,8
2610528A11Rik,21,13,208,242,8
Dlx2,14,6,222,242,8
A830018L16Rik,10,2,230,242,8
Ighe,8,0,234,242,8
A630095N17Rik,30,22,190,242,8
Bhmt,9,1,232,242,8
Slc26a5,9,1,232,242,8
Ighv9-4,11,3,228,242,8
Igkv1-135,14,6,222,242,8
Igkv6-20,16,8,218,242,8
Olfr1423,13,5,224,242,8
Sfrp4,12,4,226,242,8
Pck1,8,0,234,242,8
Tubb1,12,4,226,242,8
Glmp,10,2,230,242,8
Igkv6-32,20,12,210,242,8
Igkv4-71,10,2,230,242,8
Gm10142,8,0,234,242,8
Prom2,9,1,232,242,8
Igkv4-62,9,1,232,242,8
Ifrd1,12,4,226,242,8
Igkv3-4,13,5,224,242,8
Dcstamp,16,8,218,242,8
Diras1,8,0,234,242,8
Bst1,15,7,220,242,8
Cox7b2,16,8,218,242,8
Omt2a,11,3,228,242,8
Art5,13,5,224,242,8
Hkdc1,9,1,232,242,8
Tafa5,8,0,234,242,8
Cd1d1,13,5,224,242,8
Slc6a4,12,4,226,242,8
Krtap1-4,9,1,232,242,8
Spry2,14,6,222,242,8
Gpc3,11,3,228,242,8
Slc52a3,10,2,230,242,8
Foxr1,12,4,226,242,8
Ptprv,28,20,194,242,8
Slc15a2,8,0,234,242,8
Foxb1,9,1,232,242,8
Scgb1a1,24,16,202,242,8
Cspg5,9,1,232,242,8
Zcwpw2,14,6,222,242,8
Klk1b4,8,0,234,242,8
Krt18,9,1,232,242,8
Nr5a1,8,0,234,242,8
Krt1,10,2,230,242,8
Gm17416,9,1,232,242,8
Kncn,11,3,228,242,8
P4ha2,11,3,228,242,8
Foxc2,13,5,224,242,8
Fthl17f,8,0,234,242,8
Chchd10,12,4,226,242,8
Nlrp6,8,0,234,242,8
Atg4a,9,1,232,242,8
Hoxd13,12,4,226,242,8
Defa30,14,6,222,242,8
Gpr83,9,1,232,242,8
Cstdc2,18,10,214,242,8
Gm3250,8,0,234,242,8
Folr1,16,8,218,242,8
Golt1a,16,8,218,242,8
Ptpn7,13,5,224,242,8
Gp9,15,7,220,242,8
Osgin1,15,7,220,242,8
Hbb-bt,13,5,224,242,8
Nlrp3,9,1,232,242,8
Defb30,19,11,212,242,8
Lama3,9,1,232,242,8
Trbv12-1,8,0,234,242,8
Clec4e,14,7,221,242,7
Herpud1,10,3,229,242,7
Gm49373,17,10,215,242,7
Sult2a2,8,1,233,242,7
Clec4d,13,6,223,242,7
Gm11627,15,8,219,242,7
Wt1,11,4,227,242,7
Bglap3,13,6,223,242,7
Clec2h,17,10,215,242,7
Wfdc17,23,16,203,242,7
Tff1,13,6,223,242,7
Wdr95,13,6,223,242,7
Rnasek,11,4,227,242,7
C1qtnf4,8,1,233,242,7
Wfdc15b,13,6,223,242,7
Herc6,13,6,223,242,7
Mptx1,7,0,235,242,7
Gm2000,23,16,203,242,7
Rhoc,11,4,227,242,7
Slc22a1,10,3,229,242,7
Slc23a1,13,6,223,242,7
Slc26a3,8,1,233,242,7
Shisa4,13,6,223,242,7
Gm45837,27,20,195,242,7
H3c15,20,13,209,242,7
Uap1l1,9,2,231,242,7
Gm20772,8,1,233,242,7
H4c3,19,12,211,242,7
H4c4,10,3,229,242,7
F2,11,4,227,242,7
H60b,16,9,217,242,7
Haao,14,7,221,242,7
Gm21190,13,6,223,242,7
Vmn1r13,11,4,227,242,7
Gm15056,15,8,219,242,7
Hoxd1,7,0,235,242,7
Hoxd12,9,2,231,242,7
Gm4724,23,16,203,242,7
Gm47955,8,1,233,242,7
Six5,10,3,229,242,7
Gm47791,18,11,213,242,7
St6galnac1,8,1,233,242,7
Hpcal1,7,0,235,242,7
Trim47,11,4,227,242,7
Brap,8,1,233,242,7
Rhox2g,20,13,209,242,7
Gm20695,24,17,201,242,7
Vegfa,9,2,231,242,7
C5ar1,13,6,223,242,7
Rhox2b,9,2,231,242,7
St14,7,0,235,242,7
Slc16a2,7,0,235,242,7
Wnt4,10,3,229,242,7
Has1,12,5,225,242,7
Btc,15,8,219,242,7
Rln1,18,11,213,242,7
Ifi203,11,4,227,242,7
Fam167b,15,8,219,242,7
Ier5l,11,4,227,242,7
Mid1,13,6,223,242,7
H2bc7,32,25,185,242,7
Shmt2,7,0,235,242,7
Ripply3,14,7,221,242,7
Rhox2f,17,10,215,242,7
Bpifa1,11,4,227,242,7
Bpifa2,12,5,225,242,7
Rin3,9,2,231,242,7
Fam240a,17,10,215,242,7
Vnn1,9,2,231,242,7
Clec1b,14,7,221,242,7
Kcnk1,7,0,235,242,7
Scrg1,10,3,229,242,7
Ciart,17,10,215,242,7
Gm20661,15,8,219,242,7
Kif19b,9,2,231,242,7
Fgf16,7,0,235,242,7
G0s2,11,4,227,242,7
Lonrf3,10,3,229,242,7
Spsb1,12,5,225,242,7
Arg2,15,8,219,242,7
Cfi,14,7,221,242,7
Kcnk15,11,4,227,242,7
Tacc2,8,1,233,242,7
Itgb2,10,3,229,242,7
Gprc5c,10,3,229,242,7
Sec61b,9,2,231,242,7
Fcnb,7,0,235,242,7
Gm8439,14,7,221,242,7
Kcna6,8,1,233,242,7
Cfap97d1,18,11,213,242,7
Tssk6,10,3,229,242,7
Cish,15,8,219,242,7
Gata3,12,5,225,242,7
Fcgr3,21,14,207,242,7
Gbp2,8,1,233,242,7
Gm9376,10,3,229,242,7
Fgg,12,5,225,242,7
Scn3b,11,4,227,242,7
Schip1,10,3,229,242,7
Sbk2,11,4,227,242,7
Chrna10,15,8,219,242,7
Fmr1,10,3,229,242,7
Lbp,9,2,231,242,7
Foxa2,11,4,227,242,7
Chrdl1,8,1,233,242,7
Gm29797,21,14,207,242,7
Chrnb4,10,3,229,242,7
Fmo2,10,3,229,242,7
Sprr1a,15,8,219,242,7
Tas2r143,9,2,231,242,7
Fthl17b,13,6,223,242,7
Saa2,28,21,193,242,7
Ftl1,12,5,225,242,7
Klre1,12,5,225,242,7
Slc6a15,8,1,233,242,7
Lin7b,19,12,211,242,7
Chst8,7,0,235,242,7
Fkbp11,14,7,221,242,7
Scgb2b27,8,1,233,242,7
Fhl2,8,1,233,242,7
Lipg,10,3,229,242,7
Spink10,16,9,217,242,7
Apol9b,22,15,205,242,7
Gck,8,1,233,242,7
Ssc4d,14,7,221,242,7
Igkv2-137,16,9,217,242,7
Gm42517,10,3,229,242,7
Il13ra2,8,1,233,242,7
Fbrsl1,8,1,233,242,7
Tubb3,11,4,227,242,7
Laptm4b,8,1,233,242,7
Iglv2,15,8,219,242,7
Mal,10,3,229,242,7
Glycam1,14,7,221,242,7
Spag11a,7,0,235,242,7
Gm52955,13,6,223,242,7
Gm10024,7,0,235,242,7
Igkv15-103,11,4,227,242,7
Gm27021,30,23,189,242,7
Snx10,12,5,225,242,7
Gm10272,7,0,235,242,7
Camk4,9,2,231,242,7
Gm10352,10,3,229,242,7
Gvin2,21,14,207,242,7
Slc30a1,12,5,225,242,7
H1f1,16,9,217,242,7
Ighv1-80,12,5,225,242,7
Ighv1-78,9,2,231,242,7
Txndc2,10,3,229,242,7
Ighv1-39,11,4,227,242,7
Il1rl2,13,6,223,242,7
Il1rn,14,7,221,242,7
Clca3a2,19,12,211,242,7
Lyz2,15,8,219,242,7
Ces2g,11,4,227,242,7
Atxn1,8,1,233,242,7
Ltb4r2,9,2,231,242,7
Apoe,10,3,229,242,7
Apoc4,19,12,211,242,7
Ces2c,7,0,235,242,7
Syt7,9,2,231,242,7
Serpina5,7,0,235,242,7
Gm21992,25,18,199,242,7
Irs3,15,8,219,242,7
Irs2,9,2,231,242,7
Gdf9,8,1,233,242,7
Vwce,10,3,229,242,7
Aplp1,9,2,231,242,7
Serpinb6b,14,7,221,242,7
Snorc,25,18,199,242,7
Ildr1,9,2,231,242,7
Il7r,11,4,227,242,7
Il31,19,12,211,242,7
Il3,7,0,235,242,7
Rps23rg1,12,5,225,242,7
Gja6,14,7,221,242,7
Lyve1,11,4,227,242,7
Gipc3,7,0,235,242,7
Plin2,10,3,229,242,7
Sox9,10,3,229,242,7
Olfr1564,9,2,231,242,7
Nr1h3,10,3,229,242,7
Dppa3,13,6,223,242,7
Trim30a,7,0,235,242,7
Them5,10,3,229,242,7
Tmem121b,8,1,233,242,7
Npas3,20,13,209,242,7
Notum,8,1,233,242,7
Zfp36l1,9,2,231,242,7
Pramel51,7,0,235,242,7
Defb2,11,4,227,242,7
Qpct,9,2,231,242,7
Cnfn,18,11,213,242,7
Efna5,11,4,227,242,7
Crabp2,15,8,219,242,7
Pde2a,19,12,211,242,7
Traj34,9,2,231,242,7
Cxxc4,7,0,235,242,7
Enpep,7,0,235,242,7
Ctsd,11,4,227,242,7
Rab20,8,1,233,242,7
Aass,8,1,233,242,7
Tincr,10,3,229,242,7
Egr4,10,3,229,242,7
Xlr4a,23,16,203,242,7
Phlda3,13,6,223,242,7
Olfr209,7,0,235,242,7
Phkg1,11,4,227,242,7
Prkab2,8,1,233,242,7
Defb40,9,2,231,242,7
Prkag3,13,6,223,242,7
Nr1h4,12,5,225,242,7
Eci3,13,6,223,242,7
Echdc2,11,4,227,242,7
Myo1d,9,2,231,242,7
Ddit3,26,19,197,242,7
Epha4,12,5,225,242,7
Cxcl13,15,8,219,242,7
Nup62cl,12,5,225,242,7
Cyp2d26,14,7,221,242,7
Acmsd,14,7,221,242,7
Obscn,8,1,233,242,7
Ybx2,10,3,229,242,7
Zscan29,10,3,229,242,7
Cyp2d9,9,2,231,242,7
Pramel13,8,1,233,242,7
Myh9,8,1,233,242,7
Eppin,9,2,231,242,7
Ctla4,9,2,231,242,7
Defa22,9,2,231,242,7
Rbp1,8,1,233,242,7
Defa23,12,5,225,242,7
Dtx4,11,4,227,242,7
Cstb,11,4,227,242,7
Tmem210,27,20,195,242,7
Tmem151b,7,0,235,242,7
Tmem140,21,14,207,242,7
Pcdhga2,8,1,233,242,7
Olfr1251,7,0,235,242,7
Rcvrn,9,2,231,242,7
Cxcl10,19,12,211,242,7
Tmem135,9,2,231,242,7
Olfr1276,10,3,229,242,7
Mthfd2,9,2,231,242,7
Olfr272,8,1,233,242,7
Efr3a,13,6,223,242,7
Tgm2,10,3,229,242,7
Tnfsf4,7,0,235,242,7
Rassf5,13,6,223,242,7
Tlx3,7,0,235,242,7
Zhx2,7,0,235,242,7
Olfr458,8,1,233,242,7
Rgmb,10,3,229,242,7
Prkcq,8,1,233,242,7
Proca1,14,7,221,242,7
Plet1,15,8,219,242,7
6430628N08Rik,9,2,231,242,7
Prodh2,21,14,207,242,7
Cym,10,3,229,242,7
Ctss,11,4,227,242,7
Ctsh,9,2,231,242,7
Tmprss9,9,2,231,242,7
Prop1,20,13,209,242,7
Olfr523,7,0,235,242,7
Col4a1,9,2,231,242,7
Tle5,10,3,229,242,7
Rhbdl1,19,12,211,242,7
Trhr2,9,2,231,242,7
Ets2,10,3,229,242,7
Plekhf1,10,3,229,242,7
Olfr922,8,1,233,242,7
Creg1,10,3,229,242,7
Trgv5,8,1,233,242,7
Trim40,8,1,233,242,7
Rasd1,17,10,215,242,7
Nsg2,8,2,232,242,6
Sprr2g,11,5,226,242,6
Ass1,8,2,232,242,6
Kcnip2,15,9,218,242,6
Gpd1,10,4,228,242,6
Galnt15,10,4,228,242,6
Dcaf8l,7,1,234,242,6
Srsf12,7,1,234,242,6
Ptprn2,9,3,230,242,6
Tldc2,21,15,206,242,6
Gm21671,8,2,232,242,6
Nrp1,10,4,228,242,6
Trav12-1,12,6,224,242,6
Gm29735,7,1,234,242,6
Pcdha11,12,6,224,242,6
Trgc3,6,0,236,242,6
Calml4,15,9,218,242,6
Fgf1,8,2,232,242,6
H2-Ob,7,1,234,242,6
Acoxl,8,2,232,242,6
Vcl,8,2,232,242,6
Nt5c1a,10,4,228,242,6
St13,8,2,232,242,6
Kcnq1,11,5,226,242,6
Fchsd1,12,6,224,242,6
Kctd12,7,1,234,242,6
Adgrf2,6,0,236,242,6
Ptgs2,12,6,224,242,6
Adgrf1,7,1,234,242,6
Kctd19,15,9,218,242,6
Adgrg1,13,7,222,242,6
Pecam1,11,5,226,242,6
Cd209b,8,2,232,242,6
Rtl8a,9,3,230,242,6
Trbv13-1,8,2,232,242,6
2610528J11Rik,10,4,228,242,6
Ptgds,13,7,222,242,6
Tbx1,10,4,228,242,6
H2ac13,30,24,188,242,6
H2ac12,28,22,192,242,6
Sprr2a3,7,1,234,242,6
Sds,12,6,224,242,6
Tmc8,11,5,226,242,6
Chek1,17,11,214,242,6
Sbno2,9,3,230,242,6
S100z,24,18,200,242,6
Foxd4,6,0,236,242,6
Dbf4,9,3,230,242,6
Cartpt,7,1,234,242,6
Chrm1,10,4,228,242,6
Slc38a8,8,2,232,242,6
Tpd52l1,9,3,230,242,6
Pde11a,10,4,228,242,6
Lancl3,8,2,232,242,6
Vps37d,9,3,230,242,6
Lims2,14,8,220,242,6
Trdv4,20,14,208,242,6
Ppara,8,2,232,242,6
Slc4a1,8,2,232,242,6
Arl15,8,2,232,242,6
Lhfpl2,8,2,232,242,6
Samd1,9,3,230,242,6
Grem2,9,3,230,242,6
Adamts13,6,0,236,242,6
Car4,16,10,216,242,6
Lgi3,8,2,232,242,6
Car5b,7,1,234,242,6
Tmc6,12,6,224,242,6
Sars,8,2,232,242,6
Krtap5-1,7,1,234,242,6
Gpr84,15,9,218,242,6
Foxf1,10,4,228,242,6
Chordc1,10,4,228,242,6
Ndufb5,11,5,226,242,6
Raet1e,11,5,226,242,6
H1f6,19,13,210,242,6
Tle6,10,4,228,242,6
Actl7b,15,9,218,242,6
Casp16,22,16,204,242,6
Trav1,13,7,222,242,6
Nefh,8,2,232,242,6
Tmem132b,10,4,228,242,6
Chil3,10,4,228,242,6
Elane,15,9,218,242,6
Gypa,9,3,230,242,6
Pcdhgb5,7,1,234,242,6
Gm21704,7,1,234,242,6
Arhgap36,6,0,236,242,6
Gucy1b2,6,0,236,242,6
Art4,7,1,234,242,6
Krt83,6,0,236,242,6
Ppp1r16b,11,5,226,242,6
Neu1,9,3,230,242,6
Pcp4,12,6,224,242,6
Zbtb32,10,4,228,242,6
Efemp1,9,3,230,242,6
Tmem184a,15,9,218,242,6
C7,6,0,236,242,6
Slc25a45,9,3,230,242,6
Ighv14-4,12,6,224,242,6
Defb43,16,10,216,242,6
Ighv5-17,13,7,222,242,6
Ighv3-6,12,6,224,242,6
Olfr95,8,2,232,242,6
Ighv2-9,8,2,232,242,6
Cela3b,10,4,228,242,6
Olfr918,8,2,232,242,6
Hp,21,15,206,242,6
Sh2d4b,6,0,236,242,6
Bdh2,9,3,230,242,6
Ighv1-64,13,7,222,242,6
Hsd3b3,10,4,228,242,6
A730009L09Rik,7,1,234,242,6
Ighv1-61,10,4,228,242,6
Hpca,8,2,232,242,6
Igkv1-131,8,2,232,242,6
Igkv9-129,14,8,220,242,6
Prelp,10,4,228,242,6
Svs6,8,2,232,242,6
Ostm1,9,3,230,242,6
Svs5,10,4,228,242,6
Osm,11,5,226,242,6
Gm15433,16,10,216,242,6
Tmem41b,8,2,232,242,6
Igkv4-72,9,3,230,242,6
Igkv1-132,9,3,230,242,6
Cdhr5,7,1,234,242,6
Igkv4-54,9,3,230,242,6
Hoxb9,8,2,232,242,6
Aard,8,2,232,242,6
Hoxc6,12,6,224,242,6
Gm10197,33,27,182,242,6
Olfr433,8,2,232,242,6
Stum,9,3,230,242,6
Crisp1,8,2,232,242,6
Ifit1,10,4,228,242,6
Gm11808,13,7,222,242,6
Sult1d1,7,1,234,242,6
Htra3,13,7,222,242,6
Gm12248,15,9,218,242,6
Siglec1,12,6,224,242,6
Bmp8a,9,3,230,242,6
Gm12253,10,4,228,242,6
Txnip,14,8,220,242,6
Ifi207,9,3,230,242,6
Gm13276,12,6,224,242,6
Icam2,15,9,218,242,6
Shq1,8,2,232,242,6
Shox2,11,5,226,242,6
Olfr748,6,0,236,242,6
Gm13889,8,2,232,242,6
Shc2,7,1,234,242,6
Shbg,9,3,230,242,6
Dhh,10,4,228,242,6
Cdx1,7,1,234,242,6
Dll1,11,5,226,242,6
Dmkn,14,8,220,242,6
Ighg1,11,5,226,242,6
Dmrtc1c1,10,4,228,242,6
Bhlhe40,12,6,224,242,6
Crispld2,9,3,230,242,6
Gm11168,26,20,196,242,6
Tmprss3,6,0,236,242,6
Olfr464,6,0,236,242,6
Ighv1-18,11,5,226,242,6
Ighv1-22,12,6,224,242,6
Prkd1,8,2,232,242,6
Igkv9-124,8,2,232,242,6
Prdm14,7,1,234,242,6
Nxnl2,10,4,228,242,6
Gch1,9,3,230,242,6
Nceh1,10,4,228,242,6
Gc,12,6,224,242,6
Itih3,10,4,228,242,6
Atp6v1g2,13,7,222,242,6
Papolb,14,8,220,242,6
C4b,8,2,232,242,6
Zfp940,9,3,230,242,6
Atp6v0d2,10,4,228,242,6
Ttc7b,7,1,234,242,6
Psmb8,11,5,226,242,6
Isoc2b,8,2,232,242,6
Psmb2,11,5,226,242,6
Vmn2r10,7,1,234,242,6
Isg15,17,11,214,242,6
Defa20,6,0,236,242,6
Atp6v0d1,8,2,232,242,6
Hivep2,6,0,236,242,6
Obox6,8,2,232,242,6
Ddn,13,7,222,242,6
Ddr1,10,4,228,242,6
Kazn,7,1,234,242,6
H4c14,12,6,224,242,6
Zfp960,8,2,232,242,6
Tor3a,9,3,230,242,6
Ddx4,10,4,228,242,6
Paqr6,12,6,224,242,6
Gata6,8,2,232,242,6
Ctag2l1,6,0,236,242,6
Oca2,9,3,230,242,6
Gba,9,3,230,242,6
Parm1,9,3,230,242,6
Izumo1r,10,4,228,242,6
AU015836,8,2,232,242,6
Tmem233,7,1,234,242,6
Hcrt,15,9,218,242,6
Gjb2,6,0,236,242,6
Cdh1,9,3,230,242,6
Tmem270,10,4,228,242,6
B4galnt2,10,4,228,242,6
Il22ra2,6,0,236,242,6
Gm19684,10,4,228,242,6
Abcb8,8,2,232,242,6
Ttyh2,10,4,228,242,6
Cst9,10,4,228,242,6
Olfr1438-ps1,6,0,236,242,6
Slc17a4,8,2,232,242,6
Aldh1a2,7,1,234,242,6
P2ry10,6,0,236,242,6
Csrnp1,13,7,222,242,6
Ihh,9,3,230,242,6
Tmem269,11,5,226,242,6
Pabpn1l,8,2,232,242,6
Prss41,7,1,234,242,6
Slc1a1,7,1,234,242,6
Slc1a4,10,4,228,242,6
Sesn2,11,5,226,242,6
Inmt,13,7,222,242,6
Olfr1322,11,5,226,242,6
Dpt,12,6,224,242,6
Ggt5,9,3,230,242,6
Hecw2,6,0,236,242,6
Slc22a14,19,13,210,242,6
Syt12,11,5,226,242,6
Iqschfp,9,3,230,242,6
Avpr1a,7,1,234,242,6
Stat3,7,1,234,242,6
Avil,14,8,220,242,6
Ctxn3,12,6,224,242,6
Fshr,6,0,236,242,6
Ano4,8,2,232,242,6
1700020A23Rik,16,10,216,242,6
Rbp4,10,4,228,242,6
1700042G07Rik,12,6,224,242,6
Plscr2,10,4,228,242,6
Entpd1,7,1,234,242,6
Mgp,18,12,212,242,6
Rflna,10,4,228,242,6
Ypel2,9,3,230,242,6
Rfpl4b,6,0,236,242,6
Cltrn,10,4,228,242,6
Cx3cr1,16,10,216,242,6
Plk3,11,5,226,242,6
Methig1,10,4,228,242,6
Gm8334,6,0,236,242,6
Fabp2,9,3,230,242,6
Ankrd2,16,10,216,242,6
Magea3,10,4,228,242,6
Rhox3e,7,1,234,242,6
Gnai1,6,0,236,242,6
Tcaf2,7,1,234,242,6
Cnr2,9,3,230,242,6
Rhoq,11,5,226,242,6
Ltk,8,2,232,242,6
Alb,8,2,232,242,6
Phf1,8,2,232,242,6
Fam43a,13,7,222,242,6
Trim65,9,3,230,242,6
Aldh8a1,10,4,228,242,6
Fam13a,6,0,236,242,6
Smad7,11,5,226,242,6
Myoc,7,1,234,242,6
Map3k7cl,8,2,232,242,6
Slx1b,14,8,220,242,6
Wfdc11,7,1,234,242,6
Gm5065,6,0,236,242,6
Ccdc117,11,5,226,242,6
Wfdc13,7,1,234,242,6
Ms4a10,11,5,226,242,6
Rnasel,11,5,226,242,6
Rcan2,11,5,226,242,6
Enpp2,9,3,230,242,6
Magea5,8,2,232,242,6
Cnn3,12,6,224,242,6
Tesc,12,6,224,242,6
Aen,10,4,228,242,6
Erich4,13,7,222,242,6
Wee2,9,3,230,242,6
Naalad2,13,7,222,242,6
Eps8l1,18,12,212,242,6
Mab21l1,7,1,234,242,6
Xpot,7,1,234,242,6
Rgs17,10,4,228,242,6
Cnksr1,8,2,232,242,6
Clca3a1,12,6,224,242,6
Gm45208,40,34,168,242,6
Themis2,9,3,230,242,6
Cwc25,9,3,230,242,6
Mup7,14,8,220,242,6
Plekha7,8,2,232,242,6
Unc45b,8,2,232,242,6
Ugt1a2,9,3,230,242,6
Zpld2,6,0,236,242,6
Myog,10,4,228,242,6
Gm3880,9,3,230,242,6
Tbx3,8,2,232,242,6
Uncx,11,5,226,242,6
Slc7a5,9,3,230,242,6
Gm45716,11,5,226,242,6
Mybpc2,9,3,230,242,6
Cyp2c50,6,0,236,242,6
Tex46,7,1,234,242,6
Esp18,6,0,236,242,6
Smr3a,10,4,228,242,6
Tdrp,9,3,230,242,6
Epha2,11,5,226,242,6
Aldh1a1,9,3,230,242,6
Mc1r,11,5,226,242,6
Myl7,16,10,216,242,6
Mobp,11,5,226,242,6
Mapk4,6,0,236,242,6
Cyp4a12a,6,0,236,242,6
Cd164l2,10,4,228,242,6
Ccl5,25,19,198,242,6
Ampd1,14,8,220,242,6
Amh,15,9,218,242,6
Nat8f5,14,8,220,242,6
Ucma,21,15,206,242,6
Plekhg5,9,3,230,242,6
Apod,12,6,224,242,6
Ubxn2a,9,3,230,242,6
Cbarp,9,3,230,242,6
Mybpc1,7,1,234,242,6
Ajm1,12,6,224,242,6
Nat8,10,4,228,242,6
Eml2,6,0,236,242,6
Hrg,7,2,233,242,5
Pla2r1,7,2,233,242,5
Rbm47,9,4,229,242,5
Sntb1,7,2,233,242,5
Bricd5,11,6,225,242,5
Stard8,9,4,229,242,5
Cfh,8,3,231,242,5
Ceacam3,7,2,233,242,5
Mfsd1,9,4,229,242,5
Atp9a,5,0,237,242,5
Kcng2,9,4,229,242,5
Sec14l5,6,1,235,242,5
Tmem223,9,4,229,242,5
Hba-x,7,2,233,242,5
Hprt,9,4,229,242,5
Ticam2,8,3,231,242,5
Tmem80,9,4,229,242,5
Celsr2,5,0,237,242,5
Ticam1,8,3,231,242,5
Clec4a1,15,10,217,242,5
Ptges,7,2,233,242,5
Crip3,10,5,227,242,5
Dynlt5,7,2,233,242,5
Serpina1d,8,3,231,242,5
Gcnt2,10,5,227,242,5
Serpina3g,21,16,205,242,5
Upk1a,7,2,233,242,5
Mbnl2,7,2,233,242,5
Tent5c,5,0,237,242,5
Palmd,9,4,229,242,5
Ablim2,5,0,237,242,5
E030025P04Rik,7,2,233,242,5
AA467197,27,22,193,242,5
Mycbp,7,2,233,242,5
Olfml1,11,6,225,242,5
Atp7a,8,3,231,242,5
Wnt6,8,3,231,242,5
Gbp6,13,8,221,242,5
Ivns1abp,8,3,231,242,5
Gbp2b,6,1,235,242,5
Oaz3,18,13,211,242,5
Kap,6,1,235,242,5
Ighv14-3,11,6,225,242,5
Gas7,9,4,229,242,5
Zscan4-ps1,6,1,235,242,5
Cela1,13,8,221,242,5
Jak1,8,3,231,242,5
Olfr352,7,2,233,242,5
Olfr916,8,3,231,242,5
St6gal1,7,2,233,242,5
Hsd11b1,15,10,217,242,5
Septin14,7,2,233,242,5
Tecrl,6,1,235,242,5
Crem,10,5,227,242,5
Sparc,7,2,233,242,5
Gata4,6,1,235,242,5
Prr15,14,9,219,242,5
Gm10717,27,22,193,242,5
Ighv2-3,8,3,231,242,5
Ankrd33b,8,3,231,242,5
Rnf128,6,1,235,242,5
Gm5901,13,8,221,242,5
Agxt2,7,2,233,242,5
Obp2b,9,4,229,242,5
Serpina1c,11,6,225,242,5
Dgat2l6,5,0,237,242,5
Gm5767,26,21,195,242,5
Ppp2r2b,5,0,237,242,5
Crim1,9,4,229,242,5
Selenop,9,4,229,242,5
Ighv2-6,10,5,227,242,5
Adgrg7,5,0,237,242,5
Plxnb3,8,3,231,242,5
Dusp26,6,1,235,242,5
Cfap20,7,2,233,242,5
Atp6v1c1,8,3,231,242,5
Mdc1,9,4,229,242,5
Clec2e,5,0,237,242,5
Hs1bp3,12,7,223,242,5
Gm14744,5,0,237,242,5
Oas1f,5,0,237,242,5
Clec1a,9,4,229,242,5
8030474K03Rik,5,0,237,242,5
Gm20498,14,9,219,242,5
Susd2,8,3,231,242,5
Vmn1r37,5,0,237,242,5
Thbs4,5,0,237,242,5
Otud1,9,4,229,242,5
Cpz,9,4,229,242,5
Abca3,7,2,233,242,5
Oosp1,9,4,229,242,5
Slc13a3,7,2,233,242,5
Abca6,6,1,235,242,5
Cxcr5,14,9,219,242,5
Rergl,10,5,227,242,5
Prdm1,7,2,233,242,5
Oxct2b,8,3,231,242,5
Gm17374,21,16,205,242,5
Glb1l2,6,1,235,242,5
Msn,7,2,233,242,5
Igkv1-99,7,2,233,242,5
Bag2,8,3,231,242,5
Hid1,12,7,223,242,5
Il11,13,8,221,242,5
Abcb1a,7,2,233,242,5
Igkv1-88,11,6,225,242,5
Hic1,9,4,229,242,5
Dnajc28,11,6,225,242,5
Umod,7,2,233,242,5
Ttyh3,7,2,233,242,5
Milr1,10,5,227,242,5
Defb12,5,0,237,242,5
Plscr1,11,6,225,242,5
Hgd,6,1,235,242,5
Basp1,12,7,223,242,5
Igkv10-96,13,8,221,242,5
Rimklb,6,1,235,242,5
Gm10131,14,9,219,242,5
Igkv19-93,12,7,223,242,5
Aars,7,2,233,242,5
Gm15091,7,2,233,242,5
Cyp2ab1,6,1,235,242,5
Defb39,5,0,237,242,5
Defb35,12,7,223,242,5
Igkv4-53,9,4,229,242,5
Gm49352,7,2,233,242,5
Igkv4-55,13,8,221,242,5
Hoxb2,7,2,233,242,5
Mmgt2,12,7,223,242,5
Tex50,6,1,235,242,5
Igkv14-111,11,6,225,242,5
Cyp2b10,7,2,233,242,5
Batf3,15,10,217,242,5
Stmn4,19,14,209,242,5
Igkv4-81,7,2,233,242,5
Mlxipl,14,9,219,242,5
Igkv12-44,17,12,213,242,5
Gm16181,23,18,201,242,5
Svs3b,5,0,237,242,5
Igkv12-41,7,2,233,242,5
BC051019,12,7,223,242,5
Trav8d-1,6,1,235,242,5
1500009L16Rik,12,7,223,242,5
Akap12,5,0,237,242,5
Igkv8-19,10,5,227,242,5
Slc10a1,10,5,227,242,5
Gm43552,26,21,195,242,5
Gm43302,18,13,211,242,5
Hoxd9,9,4,229,242,5
Iqcf5,10,5,227,242,5
Prss51,10,5,227,242,5
Serpine3,9,4,229,242,5
C130026I21Rik,16,11,215,242,5
Omd,18,13,211,242,5
Pramel36,7,2,233,242,5
C130074G19Rik,5,0,237,242,5
Slc22a13,9,4,229,242,5
Hebp2,8,3,231,242,5
Gfra1,9,4,229,242,5
Prr5l,11,6,225,242,5
Olr1,15,10,217,242,5
Mmp27,10,5,227,242,5
Cers6,9,4,229,242,5
4930503B20Rik,8,3,231,242,5
Defa38,9,4,229,242,5
Kctd12b,7,2,233,242,5
Serpinb2,14,9,219,242,5
Mfsd2b,9,4,229,242,5
Rcsd1,8,3,231,242,5
Etnk2,9,4,229,242,5
Irf2bp2,8,3,231,242,5
Irf2bpl,8,3,231,242,5
Trav13n-4,11,6,225,242,5
Irf5,8,3,231,242,5
Irf8,12,7,223,242,5
Ces1e,5,0,237,242,5
Irgc1,16,11,215,242,5
C1qtnf9,6,1,235,242,5
Etd,8,3,231,242,5
Reep6,6,1,235,242,5
Zfp367,7,2,233,242,5
B3gnt6,5,0,237,242,5
Zfp366,10,5,227,242,5
Defa42,10,5,227,242,5
Igkc,18,13,211,242,5
Vmn1r59,5,0,237,242,5
1700003E16Rik,7,2,233,242,5
Cyp27a1,9,4,229,242,5
Il23a,12,7,223,242,5
Zfp853,5,0,237,242,5
Il27ra,6,1,235,242,5
Tmem30b,5,0,237,242,5
Ighv8-8,10,5,227,242,5
Spa17,17,12,213,242,5
Gm49673,9,4,229,242,5
Wfdc9,11,6,225,242,5
Ccnd2,7,2,233,242,5
Pacrg,8,3,231,242,5
Reg4,7,2,233,242,5
B3gnt2,13,8,221,242,5
Vmn1r66,6,1,235,242,5
Gipc2,9,4,229,242,5
Slc19a3,8,3,231,242,5
Gm49909,8,3,231,242,5
Cpne8,10,5,227,242,5
Abcg4,13,8,221,242,5
Impact,8,3,231,242,5
Mt3,21,16,205,242,5
Dppa5a,20,15,207,242,5
Reg3b,9,4,229,242,5
Drd4,7,2,233,242,5
Tppp2,8,3,231,242,5
Mars1,8,3,231,242,5
Ly86,13,8,221,242,5
Car3,7,2,233,242,5
Niban1,9,4,229,242,5
Lypd2,27,22,193,242,5
Sash1,12,7,223,242,5
Nab1,7,2,233,242,5
Usp17lb,7,2,233,242,5
Phgr1,12,7,223,242,5
Dio1,10,5,227,242,5
Adra2b,7,2,233,242,5
Cd300ld3,17,12,213,242,5
Nhlrc4,10,5,227,242,5
Tas2r126,6,1,235,242,5
Flrt1,7,2,233,242,5
Adamts3,6,1,235,242,5
Rab42,14,9,219,242,5
Ifnab,12,7,223,242,5
Gm28040,11,6,225,242,5
Phgdh,9,4,229,242,5
Lgmn,8,3,231,242,5
Lgsn,7,2,233,242,5
Eng,9,4,229,242,5
Htr1d,7,2,233,242,5
Lhfpl4,13,8,221,242,5
Dapl1,19,14,209,242,5
Tcap,15,10,217,242,5
Mpped2,8,3,231,242,5
Rgs8,6,1,235,242,5
Pdlim4,9,4,229,242,5
Lce1a2,6,1,235,242,5
Arl14,10,5,227,242,5
Cdo1,8,3,231,242,5
Nmnat3,8,3,231,242,5
Cyp11b1,6,1,235,242,5
L1td1,8,3,231,242,5
Foxa3,5,0,237,242,5
Birc3,8,3,231,242,5
Shank1,6,1,235,242,5
Gm21988,8,3,231,242,5
Gm11564,5,0,237,242,5
Rgs20,10,5,227,242,5
Lamc3,6,1,235,242,5
Blk,7,2,233,242,5
Spink1,9,4,229,242,5
Tcf21,7,2,233,242,5
Gm3336,18,13,211,242,5
Rab11fip1,8,3,231,242,5
Gm27029,16,11,215,242,5
Rprm,9,4,229,242,5
Capsl,13,8,221,242,5
Pigp,7,2,233,242,5
Nlgn3,6,1,235,242,5
6430548M08Rik,9,4,229,242,5
Gm26602,16,11,215,242,5
Ctsf,6,1,235,242,5
Olfr780,8,3,231,242,5
Rab27a,8,3,231,242,5
Gm26965,18,13,211,242,5
Layn,12,7,223,242,5
Fbxo16,8,3,231,242,5
Cdk2ap2,7,2,233,242,5
Dapk1,6,1,235,242,5
Nfkb2,8,3,231,242,5
Tshz2,5,0,237,242,5
Gm12845,5,0,237,242,5
Tle2,14,9,219,242,5
Trav3-3,11,6,225,242,5
Sult1b1,6,1,235,242,5
Cd209e,5,0,237,242,5
Lrrc10,7,2,233,242,5
Xaf1,13,8,221,242,5
Per2,8,3,231,242,5
Adh5,7,2,233,242,5
Percc1,13,8,221,242,5
Rtl4,6,1,235,242,5
Cblc,7,2,233,242,5
1700067K01Rik,10,5,227,242,5
Apol7e,22,17,203,242,5
Gm29666,11,6,225,242,5
Stxbp5l,6,1,235,242,5
Adh1,11,6,225,242,5
Ar,5,0,237,242,5
Apold1,8,3,231,242,5
Adgrg2,7,2,233,242,5
Lrrc43,10,5,227,242,5
Gm13102,7,2,233,242,5
Nckipsd,18,13,211,242,5
Polr2m,7,2,233,242,5
Shisal2a,11,6,225,242,5
Cited1,10,5,227,242,5
Rho,10,5,227,242,5
Pgf,10,5,227,242,5
Lrrfip1,7,2,233,242,5
Alcam,8,3,231,242,5
Rap2c,9,4,229,242,5
Ywhag,8,3,231,242,5
Ccl21d,15,10,217,242,5
Txnrd2,9,4,229,242,5
Napsa,12,7,223,242,5
Sox4,9,4,229,242,5
Cd28,5,0,237,242,5
Bmp2,5,0,237,242,5
Pdzd3,8,3,231,242,5
Adora2b,9,4,229,242,5
S100a8,37,32,173,242,5
Mrap,16,11,215,242,5
Htra4,11,6,225,242,5
S100a5,22,17,203,242,5
Gm12216,15,10,217,242,5
Rhof,10,5,227,242,5
Gpr6,9,4,229,242,5
Cbln4,10,5,227,242,5
S100a13,10,5,227,242,5
Fgfr4,5,0,237,242,5
Trgv6,9,4,229,242,5
Aldh5a1,5,0,237,242,5
Trav4-4-dv10,15,10,217,242,5
Peg10,6,1,235,242,5
Loxl2,12,7,223,242,5
Tle4,6,1,235,242,5
Rhod,9,4,229,242,5
Rhbdf2,7,2,233,242,5
Lpl,8,3,231,242,5
Tbkbp1,7,2,233,242,5
Sprr2k,14,9,219,242,5
Efna2,7,2,233,242,5
Lama1,7,2,233,242,5
Igf1,15,10,217,242,5
Olfr872,5,0,237,242,5
Klf13,9,4,229,242,5
A530084C06Rik,5,0,237,242,5
H2-Q6,9,4,229,242,5
Cldn2,9,4,229,242,5
Gm7138,5,0,237,242,5
Nrxn1,6,1,235,242,5
Nrl,9,4,229,242,5
Acsm2,7,2,233,242,5
Asphd2,6,1,235,242,5
Tspan7,8,3,231,242,5
Gm7582,15,10,217,242,5
H2-Oa,13,8,221,242,5
Fxyd2,8,3,231,242,5
5530401A14Rik,5,0,237,242,5
Scin,14,9,219,242,5
Gm45713,23,18,201,242,5
Acss3,7,2,233,242,5
Fut2,6,1,235,242,5
Eya2,6,1,235,242,5
Ccin,11,6,225,242,5
H1f9,15,10,217,242,5
Sh3gl3,6,1,235,242,5
Tpsg1,12,7,223,242,5
Tmprss5,9,4,229,242,5
Tcp10a,10,5,227,242,5
Ascl3,15,10,217,242,5
Pvr,7,2,233,242,5
Fzd5,7,2,233,242,5
Gm7137,5,0,237,242,5
Morc4,8,3,231,242,5
Calca,14,9,219,242,5
Fam71e2,9,4,229,242,5
Sdr9c7,7,2,233,242,5
Tmprss13,9,4,229,242,5
Trbv12-2,16,11,215,242,5
Pitrm1,9,4,229,242,5
Gm45717,29,24,189,242,5
Tpp1,8,3,231,242,5
Pmp2,8,3,231,242,5
Dnal1,11,6,225,242,5
Gm37988,28,23,191,242,5
Zfp987,14,9,219,242,5
Akr1b8,10,5,227,242,5
Ptpn13,5,0,237,242,5
Gm3696,15,10,217,242,5
G6pc,6,1,235,242,5
Calcb,11,6,225,242,5
Slc27a5,7,2,233,242,5
Myl2,19,14,209,242,5
Tmem170b,10,5,227,242,5
Gm21188,12,7,223,242,5
Trav12-2,8,3,231,242,5
Coro1a,15,10,217,242,5
Chat,6,1,235,242,5
Hsp90ab1,11,6,225,242,5
Fzd7,9,4,229,242,5
Trbv16,8,3,231,242,5
Slc2a2,7,2,233,242,5
Bglap2,31,26,185,242,5
Pcdhga9,6,1,235,242,5
Gtf2a1l,13,8,221,242,5
Frrs1,9,4,229,242,5
Acvr1c,7,2,233,242,5
Tmem117,7,2,233,242,5
Myof,9,4,229,242,5
Scg3,7,2,233,242,5
Scg2,5,0,237,242,5
Chm,7,2,233,242,5
Tarm1,14,9,219,242,5
Frk,6,1,235,242,5
Scgb2b15,5,0,237,242,5
Tnni1,18,13,211,242,5
Foxred2,7,2,233,242,5
Arrdc5,10,5,227,242,5
Vmn2r82,6,1,235,242,5
Pyroxd2,9,4,229,242,5
Pzp,8,3,231,242,5
Srgn,15,10,217,242,5
Akr1d1,9,4,229,242,5
Dlgap1,7,2,233,242,5
Krtap28-13,6,1,235,242,5
Tnnc1,13,8,221,242,5
Ap3b2,5,0,237,242,5
Dbil5,27,22,193,242,5
Magea10,5,0,237,242,5
Foxd2,10,5,227,242,5
Frzb,5,0,237,242,5
Tas1r2,7,2,233,242,5
Ighd,11,6,225,242,5
Guca2b,18,13,211,242,5
Slc30a10,8,3,231,242,5
Nprl2,10,5,227,242,5
Entpd2,6,1,235,242,5
Ednrb,9,4,229,242,5
Etv3l,5,0,237,242,5
Fbln1,10,5,227,242,5
Pcdhgc3,7,2,233,242,5
Tchhl1,5,0,237,242,5
Cckar,6,1,235,242,5
Xlr4c,15,10,217,242,5
Krt42,6,1,235,242,5
Slc35d3,8,3,231,242,5
Sos2,5,1,236,242,4
Gm13420,14,10,218,242,4
Trav15d-1-dv6d-1,10,6,226,242,4
Zyx,8,4,230,242,4
Dgkg,5,1,236,242,4
Sorcs2,7,3,232,242,4
6330409D20Rik,6,2,234,242,4
Hsd3b6,4,0,238,242,4
Bsph2,5,1,236,242,4
Plk2,9,5,228,242,4
Hpgds,10,6,226,242,4
Sp5,6,2,234,242,4
Gm45928,34,30,178,242,4
Plekha5,5,1,236,242,4
Hoxc8,6,2,234,242,4
Gm44596,11,7,224,242,4
Brcc3,10,6,226,242,4
Sorcs1,4,0,238,242,4
Plekhg4,14,10,218,242,4
Gm45194,5,1,236,242,4
Sp110,8,4,230,242,4
Tns3,6,2,234,242,4
Htatip2,6,2,234,242,4
Gm13290,19,15,208,242,4
Sowahb,5,1,236,242,4
Zxdc,6,2,234,242,4
Gm45337,4,0,238,242,4
Gm49318,12,8,222,242,4
Hspa12b,12,8,222,242,4
Ccl22,7,3,232,242,4
Onecut2,4,0,238,242,4
Soga3,8,4,230,242,4
Prl3d1,7,3,232,242,4
Hsd17b2,11,7,224,242,4
Ccl9,15,11,216,242,4
Gm47996,6,2,234,242,4
Trav17,5,1,236,242,4
Zfp706,6,2,234,242,4
Prkab1,5,1,236,242,4
Prkce,7,3,232,242,4
Iars,5,1,236,242,4
Gm4737,18,14,210,242,4
Gm45213,6,2,234,242,4
Gm13275,4,0,238,242,4
Gm14190,4,0,238,242,4
Gm13304,15,11,216,242,4
Stx18,7,3,232,242,4
Cyria,7,3,232,242,4
Defb36,14,10,218,242,4
Gm21987,29,25,188,242,4
Ppp1r14bl,4,0,238,242,4
Gm8909,10,6,226,242,4
Gstp1,10,6,226,242,4
Slc37a1,6,2,234,242,4
Gm9008,12,8,222,242,4
Gm9112,9,5,228,242,4
Cd44,7,3,232,242,4
Gm21985,15,11,216,242,4
Trank1,4,0,238,242,4
Pde4c,10,6,226,242,4
Pdcd2,7,3,232,242,4
Gsta1,21,17,204,242,4
Gse1,6,2,234,242,4
Ppm1n,8,4,230,242,4
Slc38a7,7,3,232,242,4
Ppm1k,12,8,222,242,4
Gm2244,15,11,216,242,4
Dazl,5,1,236,242,4
Slurp2,17,13,212,242,4
Pck2,9,5,228,242,4
Tpt1,7,3,232,242,4
Dbp,10,6,226,242,4
Tpsb2,7,3,232,242,4
2610002M06Rik,6,2,234,242,4
1700018G05Rik,15,11,216,242,4
Cxcl11,10,6,226,242,4
Trav10n,5,1,236,242,4
Trav10d,5,1,236,242,4
Smim40,14,10,218,242,4
Smgc,8,4,230,242,4
Calr4,8,4,230,242,4
Spem1,11,7,224,242,4
2410004B18Rik,8,4,230,242,4
Pip5k1b,7,3,232,242,4
Pip4k2a,8,4,230,242,4
Camk2d,7,3,232,242,4
Dcaf10,7,3,232,242,4
Id3,12,8,222,242,4
Gucy1b1,7,3,232,242,4
Cd34,10,6,226,242,4
Trap1a,5,1,236,242,4
Gm6812,7,3,232,242,4
Usp26,4,0,238,242,4
Cd101,6,2,234,242,4
Slc9a2,6,2,234,242,4
Dand5,5,1,236,242,4
Gpr21,10,6,226,242,4
Gpr176,4,0,238,242,4
Slc5a2,15,11,216,242,4
Slc8a2,5,1,236,242,4
Per1,6,2,234,242,4
Slc5a8,6,2,234,242,4
Pdf,12,8,222,242,4
Cd209d,10,6,226,242,4
Sprr2f,7,3,232,242,4
Ctsz,8,4,230,242,4
Cd200r3,9,5,228,242,4
Slc7a3,9,5,228,242,4
Cystm1,11,7,224,242,4
Pfdn6,7,3,232,242,4
Pgbd5,5,1,236,242,4
Dao,5,1,236,242,4
Spint1,4,0,238,242,4
Pdzrn3,5,1,236,242,4
Gpr62,10,6,226,242,4
Slc48a1,6,2,234,242,4
Pdlim3,4,0,238,242,4
Usp17le,6,2,234,242,4
Spink13,12,8,222,242,4
Gm28041,26,22,194,242,4
Gm28042,8,4,230,242,4
Dap,8,4,230,242,4
Gnaq,7,3,232,242,4
Cars,8,4,230,242,4
Cyp3a13,9,5,228,242,4
Gpr87,4,0,238,242,4
Pdyn,6,2,234,242,4
Gng12,8,4,230,242,4
Ppef1,11,7,224,242,4
Gm28434,9,5,228,242,4
Slc9a7,8,4,230,242,4
Gng4,7,3,232,242,4
1700018B08Rik,6,2,234,242,4
Smpd1,8,4,230,242,4
Stoml3,7,3,232,242,4
Defa32,6,2,234,242,4
Plag1,11,7,224,242,4
Stat6,10,6,226,242,4
Slc20a1,6,2,234,242,4
Slc22a17,4,0,238,242,4
Cst3,8,4,230,242,4
Ubash3b,5,1,236,242,4
Snx18,6,2,234,242,4
C1qtnf12,9,5,228,242,4
Vmn1r1,13,9,220,242,4
Zscan4e,8,4,230,242,4
Hcn4,8,4,230,242,4
Hcls1,7,3,232,242,4
Trav13n-3,11,7,224,242,4
Slc24a2,4,0,238,242,4
Hbq1a,16,12,214,242,4
Gm20547,13,9,220,242,4
Pak6,7,3,232,242,4
Vldlr,7,3,232,242,4
Gm49496,20,16,206,242,4
Defa41,4,0,238,242,4
Defa5,4,0,238,242,4
Hfm1,11,7,224,242,4
Stmnd1,5,1,236,242,4
Hoxa1,8,4,230,242,4
Oscar,5,1,236,242,4
Uggt1,8,4,230,242,4
Hnf4a,5,1,236,242,4
Slamf6,10,6,226,242,4
Prdx2,7,3,232,242,4
Gm49369,36,32,174,242,4
Slc10a4,5,1,236,242,4
Ccdc69,9,5,228,242,4
Slc13a2,7,3,232,242,4
Gm49378,26,22,194,242,4
Plcl1,4,0,238,242,4
1600014C10Rik,14,10,218,242,4
Plch2,6,2,234,242,4
Btn1a1,8,4,230,242,4
Gm17783,4,0,238,242,4
Defa29,7,3,232,242,4
Pamr1,4,0,238,242,4
Cd93,8,4,230,242,4
H2al2a,10,6,226,242,4
Pkn3,9,5,228,242,4
St3gal3,7,3,232,242,4
Tpd52,9,5,228,242,4
Cxcl14,10,6,226,242,4
H2bc18,26,22,194,242,4
H2bc12,24,20,198,242,4
Slc25a51,9,5,228,242,4
Gm38393,14,10,218,242,4
Ssty1,4,0,238,242,4
Gm5269,10,6,226,242,4
H2al1e,9,5,228,242,4
Snai1,9,5,228,242,4
Trav12d-1,15,11,216,242,4
Tpm1,7,3,232,242,4
Ube2ql1,6,2,234,242,4
Gm6217,4,0,238,242,4
H2ac19,16,12,214,242,4
Slc27a3,11,7,224,242,4
H3c3,21,17,204,242,4
Tox2,5,1,236,242,4
Gm3952,4,0,238,242,4
Vgf,6,2,234,242,4
Defa21,8,4,230,242,4
Hapln4,6,2,234,242,4
Hapln3,8,4,230,242,4
Vipr2,6,2,234,242,4
Plxdc2,7,3,232,242,4
Vipr1,5,1,236,242,4
1700009N14Rik,5,1,236,242,4
Pard6b,10,6,226,242,4
Pla2g5,8,4,230,242,4
Top2b,9,5,228,242,4
Cyp2d12,4,0,238,242,4
Cabp1,8,4,230,242,4
H4c8,8,4,230,242,4
Ccdc190,8,4,230,242,4
Gm5415,14,10,218,242,4
Pate6,6,2,234,242,4
Ddx3y,9,5,228,242,4
Gm42791,34,30,178,242,4
Aldh1a7,13,9,220,242,4
Prl8a1,8,4,230,242,4
Fkbp6,8,4,230,242,4
Runx1,8,4,230,242,4
Trgc2,10,6,226,242,4
Ramp1,6,2,234,242,4
Arhgap25,5,1,236,242,4
Col15a1,10,6,226,242,4
Fhl1,10,6,226,242,4
Treml1,10,6,226,242,4
Arhgap6,7,3,232,242,4
Eif4ebp3,18,14,210,242,4
Lingo4,5,1,236,242,4
Neurog2,10,6,226,242,4
Lingo3,8,4,230,242,4
Lima1,6,2,234,242,4
Fbxw15,5,1,236,242,4
Col4a5,6,2,234,242,4
Lhx9,7,3,232,242,4
Trpv6,4,0,238,242,4
Lgi2,7,3,232,242,4
Adamts4,8,4,230,242,4
Trub1,9,5,228,242,4
Lcn4,5,1,236,242,4
Nhs,5,1,236,242,4
Eid1,8,4,230,242,4
Col6a6,4,0,238,242,4
Rab39,6,2,234,242,4
Sbk1,11,7,224,242,4
Rundc3b,5,1,236,242,4
Arhgap1,5,1,236,242,4
Adgra3,8,4,230,242,4
Elovl3,7,3,232,242,4
Ltbp1,13,9,220,242,4
Adm,14,10,218,242,4
Rasgrp4,8,4,230,242,4
Apoh,18,14,210,242,4
Adh6a,5,1,236,242,4
Apol6,10,6,226,242,4
Tbx6,11,7,224,242,4
Rras2,6,2,234,242,4
Nccrp1,11,7,224,242,4
Trp53i11,6,2,234,242,4
Fcer2a,15,11,216,242,4
Zar1,6,2,234,242,4
Lrrn1,6,2,234,242,4
Rasa4,5,1,236,242,4
Lrrc57,6,2,234,242,4
Aqp2,11,7,224,242,4
Aqp4,6,2,234,242,4
Lrrc45,7,3,232,242,4
Lrrc31,7,3,232,242,4
Adgrf4,7,3,232,242,4
Elovl7,6,2,234,242,4
Adgre5,7,3,232,242,4
Trgv2,9,5,228,242,4
Rtn4,5,1,236,242,4
Lrp4,5,1,236,242,4
Chrna3,5,1,236,242,4
Nlrc3,12,8,222,242,4
Colec11,11,7,224,242,4
Scml4,6,2,234,242,4
Tspan8,13,9,220,242,4
Astl,5,1,236,242,4
Tagln,12,8,222,242,4
Tmem158,7,3,232,242,4
Tmem160,8,4,230,242,4
Atcay,6,2,234,242,4
Kif21a,7,3,232,242,4
Atf5,8,4,230,242,4
Ptpn18,9,5,228,242,4
Trbv13-2,18,14,210,242,4
Nts,7,3,232,242,4
Kdsr,7,3,232,242,4
Ntsr2,6,2,234,242,4
E130208F15Rik,9,5,228,242,4
Kdf1,8,4,230,242,4
Pth1r,5,1,236,242,4
Atg4a-ps,6,2,234,242,4
Acot12,4,0,238,242,4
Kcnt1,8,4,230,242,4
Vmn2r29,19,15,208,242,4
Gal3st1,12,8,222,242,4
Kcnmb2,10,6,226,242,4
Kcng3,4,0,238,242,4
Nutf2-ps1,14,10,218,242,4
Ptch2,8,4,230,242,4
Chd2,7,3,232,242,4
Nrip3,12,8,222,242,4
Egfr,6,2,234,242,4
Acss1,7,3,232,242,4
Folh1,4,0,238,242,4
Lamc2,9,5,228,242,4
Commd3,8,4,230,242,4
Armcx1,7,3,232,242,4
Lag3,10,6,226,242,4
L3mbtl3,6,2,234,242,4
Scarb2,7,3,232,242,4
Krtdap,16,12,214,242,4
Arpc3,8,4,230,242,4
Arpc4,7,3,232,242,4
Foxn1,9,5,228,242,4
Npc1l1,4,0,238,242,4
Frmd7,5,1,236,242,4
Bok,10,6,226,242,4
Tspan13,4,0,238,242,4
Krt33a,4,0,238,242,4
Krt26,4,0,238,242,4
Npffr2,4,0,238,242,4
Nphs1,11,7,224,242,4
Krt17,6,2,234,242,4
Krt14,7,3,232,242,4
Ecscr,8,4,230,242,4
Scgb2b26,4,0,238,242,4
Scgb2b7,4,0,238,242,4
Nr4a1,19,15,208,242,4
Apobec3,10,6,226,242,4
Apob,6,2,234,242,4
Galnt2l,23,19,200,242,4
Ripor3,8,4,230,242,4
Ak7,10,6,226,242,4
Wnk4,11,7,224,242,4
Cln8,10,6,226,242,4
Fam107b,12,8,222,242,4
Tex45,14,10,218,242,4
Amy1,10,6,226,242,4
Wipf3,8,4,230,242,4
Tex13c2,5,1,236,242,4
Fam155a,7,3,232,242,4
Wif1,7,3,232,242,4
Ern1,8,4,230,242,4
Clic1,7,3,232,242,4
Mideas,7,3,232,242,4
Tjp3,6,2,234,242,4
Mid2,7,3,232,242,4
Trim69,12,8,222,242,4
Wfdc6b,8,4,230,242,4
Mgmt,7,3,232,242,4
Mgat5b,4,0,238,242,4
Mtdh,5,1,236,242,4
Terb2,4,0,238,242,4
Eras,6,2,234,242,4
Wdyhv1,7,3,232,242,4
Eps8,6,2,234,242,4
Fam229a,20,16,206,242,4
Teddm1b,14,10,218,242,4
Esp22,4,0,238,242,4
Akap13,7,3,232,242,4
Fabp4,17,13,212,242,4
Tfap2a,10,6,226,242,4
Tfr2,25,21,196,242,4
Tff3,10,6,226,242,4
Tff2,15,11,216,242,4
Rhou,7,3,232,242,4
Mrpl27,8,4,230,242,4
Rgs5,9,5,228,242,4
Rhox12,6,2,234,242,4
Rgs2,14,10,218,242,4
Akr1c21,11,7,224,242,4
Eva1b,9,5,228,242,4
Alkbh2,8,4,230,242,4
Mospd3,6,2,234,242,4
Alox12,6,2,234,242,4
Rhox4b,10,6,226,242,4
Rhox4c,4,0,238,242,4
Akr1b10,7,3,232,242,4
Clrn3,4,0,238,242,4
Alox8,8,4,230,242,4
F2rl3,10,6,226,242,4
Rhox4g,4,0,238,242,4
Xkr4,5,1,236,242,4
Rhox7b,4,0,238,242,4
Akirin2,6,2,234,242,4
Rhox9,6,2,234,242,4
Mmp8,7,3,232,242,4
Myadml2,4,0,238,242,4
Ankrd34b,4,0,238,242,4
Ankrd35,5,1,236,242,4
Myo15b,10,6,226,242,4
Epas1,6,2,234,242,4
Agap2,6,2,234,242,4
Myo1f,10,6,226,242,4
Fas,14,10,218,242,4
Clcnka,6,2,234,242,4
Rbm33,8,4,230,242,4
Fbln2,11,7,224,242,4
Magea8,7,3,232,242,4
Tcf24,6,2,234,242,4
Enpp6,5,1,236,242,4
Maf,7,3,232,242,4
Fbxl22,8,4,230,242,4
Wasf3,5,1,236,242,4
N4bp2l1,11,7,224,242,4
Was,7,3,232,242,4
Cntnap2,11,7,224,242,4
Apbb2,7,3,232,242,4
Rps18,7,3,232,242,4
Lypd3,7,3,232,242,4
Lyg2,4,0,238,242,4
Rbbp7,7,3,232,242,4
Naip5,9,5,228,242,4
Ly6d,19,15,208,242,4
En1,5,1,236,242,4
Apmap,9,5,228,242,4
Tcp11,7,3,232,242,4
Cldn16,4,0,238,242,4
Meis1,6,2,234,242,4
Map3k6,7,3,232,242,4
Med31,6,2,234,242,4
Wdr72,5,1,236,242,4
Tead1,8,4,230,242,4
Epn1,8,4,230,242,4
Mdga1,8,4,230,242,4
Ankrd6,6,2,234,242,4
Cldn8,6,2,234,242,4
Mybpc3,8,4,230,242,4
Mcoln2,7,3,232,242,4
Myct1,7,3,232,242,4
Mbp,8,4,230,242,4
Rnpepl1,8,4,230,242,4
Matn3,4,0,238,242,4
Agmo,9,5,228,242,4
Masp1,8,4,230,242,4
Epdr1,11,7,224,242,4
Trmt10a,6,2,234,242,4
Cnpy1,6,2,234,242,4
Mapkapk3,7,3,232,242,4
Tdpoz6,9,5,228,242,4
Tdpoz4,6,2,234,242,4
Rpgrip1l,8,4,230,242,4
Map7,4,0,238,242,4
Fam90a1b,9,5,228,242,4
Epcam,6,2,234,242,4
Atp1a3,6,2,234,242,4
Il13ra1,7,3,232,242,4
Sgk1,14,10,218,242,4
Acaa1b,6,2,234,242,4
Il13,10,6,226,242,4
Tusc2,6,2,234,242,4
Tmprss2,4,0,238,242,4
Bex1,6,2,234,242,4
Cpe,9,5,228,242,4
Igkv14-130,7,3,232,242,4
Ighv1-42,9,5,228,242,4
Gm10053,7,3,232,242,4
Gm10974,22,18,202,242,4
Igkv12-46,15,11,216,242,4
Gm10964,10,6,226,242,4
Olfr396-ps1,4,0,238,242,4
Igkv6-29,11,7,224,242,4
Olfr1441,6,2,234,242,4
Irf4,5,1,236,242,4
Ighv1-34,11,7,224,242,4
Olfr1124,8,4,230,242,4
Serpina3m,7,3,232,242,4
Cpa1,4,0,238,242,4
Dnase2a,10,6,226,242,4
Igkv3-5,8,4,230,242,4
Gclm,5,1,236,242,4
Gcnt7,9,5,228,242,4
Olfr196,5,1,236,242,4
Igkv3-2,10,6,226,242,4
Tnf,8,4,230,242,4
Ighv1-19,11,7,224,242,4
Syt8,18,14,210,242,4
Prp2,5,1,236,242,4
Dtx1,7,3,232,242,4
Zfp36l2,10,6,226,242,4
Ces2e,8,4,230,242,4
Olfr1109,6,2,234,242,4
Olfr1224-ps1,16,12,214,242,4
Crb3,6,2,234,242,4
Sumf1,7,3,232,242,4
Syngr3,6,2,234,242,4
Abhd12b,5,1,236,242,4
Gm10401,22,18,202,242,4
Bcl11b,5,1,236,242,4
Ighv5-6,7,3,232,242,4
Ighv5-9-1,7,3,232,242,4
Il2,6,2,234,242,4
Dppa2,7,3,232,242,4
Tmem86a,16,12,214,242,4
Ighv7-1,6,2,234,242,4
Il4ra,7,3,232,242,4
Bcam,7,3,232,242,4
Prss40,4,0,238,242,4
Igkv1-35,10,6,226,242,4
Igkv1-110,15,11,216,242,4
Insr,6,2,234,242,4
Tmem239,16,12,214,242,4
Dnai1,12,8,222,242,4
Dnajb3,7,3,232,242,4
Ighv10-1,9,5,228,242,4
Sh2d2a,6,2,234,242,4
Olfr295,7,3,232,242,4
Ttpa,7,3,232,242,4
Olfr1417,7,3,232,242,4
Bcl3,9,5,228,242,4
Prss55,8,4,230,242,4
Serpinb9g,5,1,236,242,4
Il1f6,5,1,236,242,4
Olfr1406,4,0,238,242,4
Cers3,6,2,234,242,4
Dnajb7,18,14,210,242,4
Gfy,7,3,232,242,4
Serpinb9c,9,5,228,242,4
Gckr,10,6,226,242,4
Il2rg,11,7,224,242,4
Duox2,4,0,238,242,4
Crygf,5,1,236,242,4
Igsf1,6,2,234,242,4
Ifna6,7,3,232,242,4
Sult2a1,4,0,238,242,4
Sult1e1,7,3,232,242,4
Gm11983,13,9,220,242,4
Gm12166,19,15,208,242,4
Trav5d-4,9,5,228,242,4
Olfr1467,8,4,230,242,4
Odf3b,14,10,218,242,4
Serf2,5,1,236,242,4
Dusp4,8,4,230,242,4
Glyatl3,10,6,226,242,4
Galr3,11,7,224,242,4
Doc2b,9,5,228,242,4
Olfr1512,5,1,236,242,4
Bmp7,5,1,236,242,4
Septin9,8,4,230,242,4
Cryge,15,11,216,242,4
T,8,4,230,242,4
Jakmip1,7,3,232,242,4
Duxbl1,8,4,230,242,4
Ifi27l2b,5,1,236,242,4
Sema6a,6,2,234,242,4
Vmn1r35,4,0,238,242,4
Jmy,6,2,234,242,4
9230102O04Rik,17,13,212,242,4
Ifi27l2a,25,21,196,242,4
Tmem196,8,4,230,242,4
Crygb,8,4,230,242,4
Ogdhl,6,2,234,242,4
Ifne,11,7,224,242,4
Kbtbd11,5,1,236,242,4
Gm12887,5,1,236,242,4
Abca8a,8,4,230,242,4
Cdv3,9,5,228,242,4
Trav23,5,1,236,242,4
Gcdh,9,5,228,242,4
Bnipl,11,7,224,242,4
Shank3,9,5,228,242,4
Atp6v1g3,7,3,232,242,4
Itih4,4,0,238,242,4
Iho1,8,4,230,242,4
Dynlrb1,6,2,234,242,4
Bbc3,13,9,220,242,4
Igtp,8,4,230,242,4
Jund,6,2,234,242,4
Blnk,5,1,236,242,4
Gca,7,3,232,242,4
Zfp579,9,5,228,242,4
Igkv7-33,7,3,232,242,4
Igkv8-16,7,3,232,242,4
Atp6v1e1,7,3,232,242,4
Itm2c,8,4,230,242,4
Glyat,7,3,232,242,4
Igsf23,8,4,230,242,4
Ace2,6,2,234,242,4
Dio3,9,5,228,242,4
Olfr727,9,5,228,242,4
Glt1d1,3,0,239,242,3
Gm37389,4,1,237,242,3
Tulp2,10,7,225,242,3
Gm37240,22,19,201,242,3
Tmem50a,6,3,233,242,3
Ccr1,11,8,223,242,3
Dnase2b,3,0,239,242,3
Tcn2,6,3,233,242,3
Gm15262,3,0,239,242,3
Creb3l1,4,1,237,242,3
Cdhr3,3,0,239,242,3
Ccr8,3,0,239,242,3
Trav7n-6,3,0,239,242,3
Timp3,6,3,233,242,3
Cldn14,14,11,217,242,3
Trav7n-4,4,1,237,242,3
Tdo2,5,2,235,242,3
Cyp2j8,3,0,239,242,3
Cwh43,6,3,233,242,3
Ccr6,11,8,223,242,3
Spatc1l,12,9,221,242,3
Gm36079,3,0,239,242,3
Fam83g,3,0,239,242,3
Gm36176,3,0,239,242,3
Fam83f,5,2,235,242,3
Glud1,6,3,233,242,3
Dnajc5,4,1,237,242,3
Gm15093,7,4,231,242,3
Galnt6,7,4,231,242,3
Sv2a,7,4,231,242,3
Cmtm5,6,3,233,242,3
Faim2,5,2,235,242,3
Esam,14,11,217,242,3
Stx3,6,3,233,242,3
Tnn,8,5,229,242,3
Diras2,3,0,239,242,3
Cyb561,4,1,237,242,3
Tnik,3,0,239,242,3
Gm43951,19,16,207,242,3
Traj53,3,0,239,242,3
Esr1,8,5,229,242,3
Tfap2e,5,2,235,242,3
Trim50,7,4,231,242,3
Traj41,3,0,239,242,3
Cmtm3,11,8,223,242,3
Dkkl1,12,9,221,242,3
Cdk4,5,2,235,242,3
F2rl1,5,2,235,242,3
Ccl6,17,14,211,242,3
Sult1c2,7,4,231,242,3
Tfcp2l1,4,1,237,242,3
Cltb,7,4,231,242,3
Cdkn1c,5,2,235,242,3
Tgif1,8,5,229,242,3
Crym,3,0,239,242,3
Evx1,6,3,233,242,3
Tgfb2,6,3,233,242,3
Sugct,19,16,207,242,3
Tg,5,2,235,242,3
Gm11541,5,2,235,242,3
Dmrtc1b,3,0,239,242,3
Twist2,8,5,229,242,3
Tie1,4,1,237,242,3
Txlnb,4,1,237,242,3
Gm10320,32,29,181,242,3
Gm10334,3,0,239,242,3
Fam50a,7,4,231,242,3
Csn1s1,7,4,231,242,3
Trim21,6,3,233,242,3
Defb8,4,1,237,242,3
Cyp2d22,5,2,235,242,3
Crebrf,6,3,233,242,3
Tecpr1,6,3,233,242,3
Trio,7,4,231,242,3
Ucn2,11,8,223,242,3
Deptor,6,3,233,242,3
Tmie,7,4,231,242,3
Gm11239,5,2,235,242,3
Ucp2,10,7,225,242,3
Trav7-4,6,3,233,242,3
Gm4301,12,9,221,242,3
Ccnd3,6,3,233,242,3
Gm14393,32,29,181,242,3
Fam167a,5,2,235,242,3
Trim30c,6,3,233,242,3
Fam166c,4,1,237,242,3
Sult4a1,4,1,237,242,3
Cyp2c70,5,2,235,242,3
Cnga3,10,7,225,242,3
Csf2rb2,9,6,227,242,3
Sult2a5,3,0,239,242,3
Gm14399,22,19,201,242,3
Ubtf,6,3,233,242,3
Tinag,3,0,239,242,3
Cd68,11,8,223,242,3
Gm21915,7,4,231,242,3
Foxi1,5,2,235,242,3
Foxo1,6,3,233,242,3
Efcc1,8,5,229,242,3
Cd59a,6,3,233,242,3
Comt,9,6,227,242,3
Cd6,4,1,237,242,3
Dbx1,4,1,237,242,3
Ecrg4,16,13,213,242,3
Fscn2,7,4,231,242,3
Defa27,6,3,233,242,3
Tmem204,10,7,225,242,3
Tmem125,8,5,229,242,3
Tap1,6,3,233,242,3
Eef1a2,4,1,237,242,3
Tmem132c,5,2,235,242,3
Ctsa,9,6,227,242,3
Trdc,6,3,233,242,3
Gm20518,8,5,229,242,3
Csta3,7,4,231,242,3
Fn1,7,4,231,242,3
Egln3,4,1,237,242,3
Cd36,5,2,235,242,3
Ces1f,10,7,225,242,3
Cpeb4,6,3,233,242,3
Trdn,5,2,235,242,3
Dsg3,4,1,237,242,3
Ces2a,5,2,235,242,3
Tmem229b,6,3,233,242,3
Egfl6,7,4,231,242,3
Efr3b,5,2,235,242,3
Efnb2,4,1,237,242,3
Trdj1,7,4,231,242,3
Trbj1-1,3,0,239,242,3
Efnb1,4,1,237,242,3
Trbv20,7,4,231,242,3
Tspan31,8,5,229,242,3
Ehd3,5,2,235,242,3
Dynll1,8,5,229,242,3
Gabrr1,4,1,237,242,3
Sstr1,3,0,239,242,3
Tmem171,11,8,223,242,3
Sstr2,6,3,233,242,3
Ttc23l,9,6,227,242,3
Gap43,5,2,235,242,3
Sstr5,4,1,237,242,3
Tpbgl,4,1,237,242,3
Dusp3,8,5,229,242,3
Tph1,7,4,231,242,3
Trbv1,12,9,221,242,3
Dysf,6,3,233,242,3
Tmem178,10,7,225,242,3
Ctf2,7,4,231,242,3
Cfc1,3,0,239,242,3
Tmem184b,6,3,233,242,3
Gabrp,4,1,237,242,3
Ssh1,7,4,231,242,3
Gabrb3,4,1,237,242,3
Tspo,7,4,231,242,3
Fundc2,8,5,229,242,3
Trbv19,5,2,235,242,3
Tspan4,8,5,229,242,3
Fut11,6,3,233,242,3
Gbx2,5,2,235,242,3
Fxn,8,5,229,242,3
Cd81,7,4,231,242,3
Cox7a1,13,10,219,242,3
St8sia6,5,2,235,242,3
Ebf1,12,9,221,242,3
Dcaf12l1,4,1,237,242,3
Gbp7,5,2,235,242,3
St8sia2,4,1,237,242,3
Defa2,4,1,237,242,3
Gm20831,5,2,235,242,3
Syt4,5,2,235,242,3
Cd302,10,7,225,242,3
Tinf2,10,7,225,242,3
Csrp1,6,3,233,242,3
Tuba3b,8,5,229,242,3
Cdc34b,8,5,229,242,3
Syn1,7,4,231,242,3
Trav9-4,6,3,233,242,3
Cyp4f40,3,0,239,242,3
Defb13,5,2,235,242,3
Cited2,8,5,229,242,3
Trpa1,3,0,239,242,3
Fcrls,6,3,233,242,3
Trav9d-1,6,3,233,242,3
Ttr,15,12,215,242,3
Gm18336,3,0,239,242,3
Gm18596,3,0,239,242,3
D630023F18Rik,9,6,227,242,3
Sprr2b,5,2,235,242,3
Tbx2,5,2,235,242,3
Gm17571,24,21,197,242,3
Gjd4,5,2,235,242,3
Trp53bp1,6,3,233,242,3
Ckm,9,6,227,242,3
Tiparp,4,1,237,242,3
Trav8n-2,11,8,223,242,3
Enc1,5,2,235,242,3
Defb26,4,1,237,242,3
Spink14,9,6,227,242,3
Uba7,7,4,231,242,3
Gm3238,3,0,239,242,3
Cspg4b,8,5,229,242,3
Tbxa2r,13,10,219,242,3
Cpxm1,6,3,233,242,3
Spint3,14,11,217,242,3
Cd151,6,3,233,242,3
Emcn,4,1,237,242,3
Spon1,6,3,233,242,3
Dok3,11,8,223,242,3
Tle1,5,2,235,242,3
Cpt1a,8,5,229,242,3
Fmo5,8,5,229,242,3
Cd300ld2,7,4,231,242,3
Gm28051,27,24,191,242,3
Gfod2,6,3,233,242,3
Col4a6,3,0,239,242,3
Cpm,5,2,235,242,3
Ubb,7,4,231,242,3
Gfod1,8,5,229,242,3
Defa37,3,0,239,242,3
Stat4,3,0,239,242,3
Tbr1,8,5,229,242,3
Fmo4,6,3,233,242,3
Ubqln2,7,4,231,242,3
Syt14,3,0,239,242,3
Drp2,5,2,235,242,3
Ctsg,6,3,233,242,3
Tsc22d1,6,3,233,242,3
Cd300lf,13,10,219,242,3
Tm6sf2,11,8,223,242,3
Cd300a,6,3,233,242,3
Tlr9,4,1,237,242,3
Tlr8,6,3,233,242,3
Dok5,6,3,233,242,3
Elovl2,4,1,237,242,3
Gm29094,24,21,197,242,3
Fes,8,5,229,242,3
Sprr2h,4,1,237,242,3
Fetub,6,3,233,242,3
Dph5,7,4,231,242,3
Fgf15,4,1,237,242,3
Ghsr,3,0,239,242,3
Dpy19l3,5,2,235,242,3
Tlr12,5,2,235,242,3
Trex2,12,9,221,242,3
Elavl2,4,1,237,242,3
Tlr4,6,3,233,242,3
Ggcx,5,2,235,242,3
Tmem119,12,9,221,242,3
Ifnl3,6,3,233,242,3
Gm44965,34,31,177,242,3
Rpl7l1,6,3,233,242,3
Man1a,5,2,235,242,3
Wbp2nl,5,2,235,242,3
Man1c1,4,1,237,242,3
Aoc3,6,3,233,242,3
Map1lc3a,4,1,237,242,3
Anxa5,8,5,229,242,3
Ccl24,14,11,217,242,3
Rpgr,5,2,235,242,3
Marchf8,8,5,229,242,3
Matn4,5,2,235,242,3
Mbd4,6,3,233,242,3
Mcf2,3,0,239,242,3
Mcoln3,9,6,227,242,3
Rnf227,7,4,231,242,3
Rnf215,4,1,237,242,3
Meis2,6,3,233,242,3
Rnf151,14,11,217,242,3
Mepe,4,1,237,242,3
Mettl3,6,3,233,242,3
Mfsd14b,5,2,235,242,3
Wfdc2,11,8,223,242,3
Rpl3l,12,9,221,242,3
Magea4,5,2,235,242,3
S100a7a,10,7,225,242,3
Ap3s1,7,4,231,242,3
S100a10,11,8,223,242,3
Lmo2,8,5,229,242,3
Arhgap26,6,3,233,242,3
Lmo4,7,4,231,242,3
Lonrf2,4,1,237,242,3
Lpar3,5,2,235,242,3
Lpar6,4,1,237,242,3
Rufy4,9,6,227,242,3
Lratd1,6,3,233,242,3
Lrig3,7,4,231,242,3
Rtn4rl1,6,3,233,242,3
Vsir,12,9,221,242,3
Rtbdn,8,5,229,242,3
Lrrtm4,6,3,233,242,3
Vtn,7,4,231,242,3
Apol11b,6,3,233,242,3
Ltbp3,7,4,231,242,3
Lyg1,3,0,239,242,3
Lyrm9,11,8,223,242,3
Lyz1,10,7,225,242,3
Rprml,9,6,227,242,3
Rnase13,3,0,239,242,3
Mib2,5,2,235,242,3
Wfs1,7,4,231,242,3
Minar2,7,4,231,242,3
Xlr3b,15,12,215,242,3
Retnlb,3,0,239,242,3
Resf1,7,4,231,242,3
Xlr5c,9,6,227,242,3
Msmo1,7,4,231,242,3
Reps2,6,3,233,242,3
Rem2,7,4,231,242,3
Reg3g,10,7,225,242,3
Mtarc2,6,3,233,242,3
Rdh13,9,6,227,242,3
Mtus1,10,7,225,242,3
Mucl2,10,7,225,242,3
Ahdc1,6,3,233,242,3
Xylb,6,3,233,242,3
Mybl2,8,5,229,242,3
Xylt1,6,3,233,242,3
Mycs,3,0,239,242,3
Myh14,4,1,237,242,3
Myo1b,5,2,235,242,3
Myo5b,6,3,233,242,3
Aff1,8,5,229,242,3
Ms4a6b,8,5,229,242,3
Mrps34,6,3,233,242,3
Mrps26,4,1,237,242,3
Mob3b,4,1,237,242,3
Rinl,4,1,237,242,3
Rin1,7,4,231,242,3
Rims4,5,2,235,242,3
Rilpl1,6,3,233,242,3
Mme,11,8,223,242,3
Wnt10a,8,5,229,242,3
Mmp7,11,8,223,242,3
Ambp,12,9,221,242,3
Mmrn2,10,7,225,242,3
Alox5ap,20,17,205,242,3
Rgcc,5,2,235,242,3
Mogat2,6,3,233,242,3
Alox15,7,4,231,242,3
Morn1,10,7,225,242,3
Alkbh1,5,2,235,242,3
Mpp5,8,5,229,242,3
Mptx2,3,0,239,242,3
Xdh,9,6,227,242,3
Akr1c13,12,9,221,242,3
Akr1c12,9,6,227,242,3
Lmcd1,7,4,231,242,3
Arhgap8,7,4,231,242,3
Myzap,13,10,219,242,3
Itgav,7,4,231,242,3
Itm2a,6,3,233,242,3
Atp6v0a4,3,0,239,242,3
Serinc2,5,2,235,242,3
Jak2,8,5,229,242,3
Senp2,7,4,231,242,3
Sema7a,11,8,223,242,3
Sema6b,4,1,237,242,3
Atp2b3,6,3,233,242,3
Kcna3,8,5,229,242,3
Kcna5,6,3,233,242,3
Kcnc3,5,2,235,242,3
Kcnh2,3,0,239,242,3
Kcnj8,6,3,233,242,3
Kcnk16,3,0,239,242,3
Kcnk5,9,6,227,242,3
Sec14l4,4,1,237,242,3
Kdm2a,6,3,233,242,3
Kdm5c,5,2,235,242,3
Atg10,6,3,233,242,3
Kif12,4,1,237,242,3
Kif1a,3,0,239,242,3
Serpina1e,7,4,231,242,3
Itgam,9,6,227,242,3
Lipa,10,7,225,242,3
Itgal,3,0,239,242,3
Il17ra,6,3,233,242,3
Il17rc,15,12,215,242,3
Vmn1r62,3,0,239,242,3
B3gnt3,6,3,233,242,3
Il4,22,19,201,242,3
Inpp5b,6,3,233,242,3
Insc,14,11,217,242,3
Ip6k3,5,2,235,242,3
Ipcef1,7,4,231,242,3
Serpinb6c,13,10,219,242,3
Iqck,5,2,235,242,3
Avpr2,6,3,233,242,3
Serpinb1b,7,4,231,242,3
Vmn1r84,15,12,215,242,3
Irgm2,8,5,229,242,3
Irx1,12,9,221,242,3
Ism1,5,2,235,242,3
Serpina3k,6,3,233,242,3
Isyna1,8,5,229,242,3
Itga6,8,5,229,242,3
Itgad,26,23,193,242,3
Scube2,5,2,235,242,3
Scnn1g,4,1,237,242,3
Klf15,9,6,227,242,3
Scn7a,4,1,237,242,3
Scart1,4,1,237,242,3
L3mbtl1,11,8,223,242,3
Lamc1,9,6,227,242,3
Sc5d,5,2,235,242,3
Sbpl,3,0,239,242,3
Armc12,6,3,233,242,3
Lao1,7,4,231,242,3
Arl8a,8,5,229,242,3
Arl5a,8,5,229,242,3
Lars2,16,13,213,242,3
Lbh,12,9,221,242,3
Vpreb3,11,8,223,242,3
Lce1e,3,0,239,242,3
Arid5b,7,4,231,242,3
Saraf,6,3,233,242,3
Ldc1,4,1,237,242,3
Lgals3,15,12,215,242,3
Lim2,3,0,239,242,3
Saa3,17,14,211,242,3
Lin52,8,5,229,242,3
Arhgdig,8,5,229,242,3
Krtap5-4,3,0,239,242,3
Krtap5-3,3,0,239,242,3
Krtap4-2,3,0,239,242,3
Klrg2,6,3,233,242,3
Scml2,6,3,233,242,3
Klk11,8,5,229,242,3
Klk1b26,8,5,229,242,3
Asic2,7,4,231,242,3
Klk1b3,4,1,237,242,3
Klk1b5,6,3,233,242,3
Klk1b9,3,0,239,242,3
Klrb1a,17,14,211,242,3
Klrg1,5,2,235,242,3
Vmn2r62,4,1,237,242,3
Krtap3-3,3,0,239,242,3
Krt24,3,0,239,242,3
Asah1,11,8,223,242,3
Vmn2r72,4,1,237,242,3
Krt7,6,3,233,242,3
Scfd2,4,1,237,242,3
Krt84,3,0,239,242,3
Krt86,4,1,237,242,3
Arrdc2,7,4,231,242,3
Krtap10-10,3,0,239,242,3
Myom3,4,1,237,242,3
Aebp1,7,4,231,242,3
Il12b,3,0,239,242,3
Olfr921,3,0,239,242,3
Olfr959,4,1,237,242,3
Olfr979,8,5,229,242,3
Olig1,4,1,237,242,3
Prkaa2,3,0,239,242,3
Orm3,10,7,225,242,3
Osbp2,8,5,229,242,3
Otc,3,0,239,242,3
Otos,15,12,215,242,3
Otud6a,6,3,233,242,3
Prcd,11,8,223,242,3
Zfp800,7,4,231,242,3
P2ry2,9,6,227,242,3
P4htm,7,4,231,242,3
Pramel43,7,4,231,242,3
Pramel38,3,0,239,242,3
Pabpn1,6,3,233,242,3
Padi4,9,6,227,242,3
Pramel34,7,4,231,242,3
Pah,7,4,231,242,3
Pramel32,4,1,237,242,3
4930451I11Rik,17,14,211,242,3
Olfr943,6,3,233,242,3
Olfr919,3,0,239,242,3
Olfr488,3,0,239,242,3
Prkci,7,4,231,242,3
Zfp534,9,6,227,242,3
A2ml1,3,0,239,242,3
Olfr507,3,0,239,242,3
Olfr548-ps1,3,0,239,242,3
Olfr560,3,0,239,242,3
Olfr592,3,0,239,242,3
Olfr60,3,0,239,242,3
Olfr63,8,5,229,242,3
Prom1,5,2,235,242,3
Proc,8,5,229,242,3
9330159F19Rik,5,2,235,242,3
9230112D13Rik,8,5,229,242,3
Olfr690,5,2,235,242,3
Olfr743,3,0,239,242,3
Olfr749,3,0,239,242,3
Olfr753-ps1,4,1,237,242,3
Olfr796,4,1,237,242,3
6030468B19Rik,5,2,235,242,3
Prkg2,9,6,227,242,3
5430401F13Rik,7,4,231,242,3
Zfp641,7,4,231,242,3
4930447A16Rik,12,9,221,242,3
Pank3,7,4,231,242,3
Pramel20,3,0,239,242,3
Papln,5,2,235,242,3
Zkscan16,7,4,231,242,3
Pga5,5,2,235,242,3
Pgghg,9,6,227,242,3
Pgm5,4,1,237,242,3
Zmym1,7,4,231,242,3
Zmym6,6,3,233,242,3
Pnpo,8,5,229,242,3
Pnma2,3,0,239,242,3
Pilrb1,21,18,203,242,3
Pnck,4,1,237,242,3
Pip4p2,7,4,231,242,3
Zp3,5,2,235,242,3
Pitpnc1,6,3,233,242,3
Pmp22,8,5,229,242,3
Pmfbp1,3,0,239,242,3
Plxna3,6,3,233,242,3
Plagl1,8,5,229,242,3
Plaur,11,8,223,242,3
1520401A03Rik,8,5,229,242,3
Plekha2,5,2,235,242,3
Plekha6,12,9,221,242,3
Zic1,4,1,237,242,3
2010003K11Rik,9,6,227,242,3
Pde6a,11,8,223,242,3
Pcdhb11,5,2,235,242,3
Pramel18,3,0,239,242,3
Ppy,11,8,223,242,3
Parp3,7,4,231,242,3
Pate8,7,4,231,242,3
Pax5,9,6,227,242,3
3110082J24Rik,15,12,215,242,3
Zfp968,20,17,205,242,3
Pcbp4,8,5,229,242,3
Pcdha4,8,5,229,242,3
Pcdhb16,4,1,237,242,3
Pde3b,7,4,231,242,3
Pcdhb6,5,2,235,242,3
Pcdhga10,8,5,229,242,3
Pcdhga3,4,1,237,242,3
2410004P03Rik,4,1,237,242,3
Pcdhgb4,7,4,231,242,3
Pcgf5,5,2,235,242,3
Pcp4l1,6,3,233,242,3
2300002M23Rik,5,2,235,242,3
Pde3a,3,0,239,242,3
Zfp53,6,3,233,242,3
Olfr467,3,0,239,242,3
N4bp2l2,9,6,227,242,3
Nfs1,5,2,235,242,3
Ngf,15,12,215,242,3
Nhlh1,6,3,233,242,3
Adamts14,3,0,239,242,3
Niban2,7,4,231,242,3
Adam9,6,3,233,242,3
Nipal2,6,3,233,242,3
Rab3a,6,3,233,242,3
Rab32,8,5,229,242,3
Nkx2-9,4,1,237,242,3
Nlrp12,3,0,239,242,3
Rab18,8,5,229,242,3
Nmrk1,8,5,229,242,3
Qtrt1,8,5,229,242,3
Nol10,6,3,233,242,3
Notch1,8,5,229,242,3
Noto,3,0,239,242,3
Nova1,5,2,235,242,3
Pygm,7,4,231,242,3
Nphs2,5,2,235,242,3
Nppb,17,14,211,242,3
Nppc,9,6,227,242,3
Zbtb38,6,3,233,242,3
Nfe2l2,5,2,235,242,3
Olfr370,9,6,227,242,3
Nfat5,7,4,231,242,3
Naf1,4,1,237,242,3
Rb1,5,2,235,242,3
Adra1a,4,1,237,242,3
Rassf8,7,4,231,242,3
Ywhah,7,4,231,242,3
Ado,5,2,235,242,3
Adipoq,19,16,207,242,3
Adhfe1,11,8,223,242,3
Adgrg4,12,9,221,242,3
Rapgef3,11,8,223,242,3
Ndn,3,0,239,242,3
Adgrd1,6,3,233,242,3
Zbp1,13,10,219,242,3
Adgrb2,3,0,239,242,3
Ndrg1,8,5,229,242,3
Ranbp9,6,3,233,242,3
Ndufb11b,10,7,225,242,3
Neil1,9,6,227,242,3
Rad51c,6,3,233,242,3
Neu3,8,5,229,242,3
Neurl3,10,7,225,242,3
Zdhhc22,7,4,231,242,3
Pwwp3b,9,6,227,242,3
Npw,10,7,225,242,3
Nr0b1,3,0,239,242,3
Olfr1352,6,3,233,242,3
Olfr1373,5,2,235,242,3
Abcc8,5,2,235,242,3
Olfr1385,6,3,233,242,3
Olfr143,6,3,233,242,3
Abca8b,5,2,235,242,3
Zfp385b,4,1,237,242,3
Olfr1507,7,4,231,242,3
Olfr160,7,4,231,242,3
Prss23,6,3,233,242,3
Olfr178,3,0,239,242,3
Prrxl1,5,2,235,242,3
Olfr222,3,0,239,242,3
Olfr239,3,0,239,242,3
Olfr291,3,0,239,242,3
Aadac,5,2,235,242,3
Olfr322,7,4,231,242,3
AA792892,6,3,233,242,3
Olfr328,7,4,231,242,3
Olfr335-ps,4,1,237,242,3
Olfr353,4,1,237,242,3
Olfr1316,4,1,237,242,3
Olfr1313,4,1,237,242,3
Psat1,8,5,229,242,3
Ptger2,6,3,233,242,3
Actl6b,4,1,237,242,3
Nr2f1,6,3,233,242,3
Purb,6,3,233,242,3
Acsl4,6,3,233,242,3
Nrtn,6,3,233,242,3
Nrxn2,4,1,237,242,3
Acp7,5,2,235,242,3
Ntn4,10,7,225,242,3
Numb,11,8,223,242,3
Nupl1,7,4,231,242,3
Olfr1211,5,2,235,242,3
Nxph3,6,3,233,242,3
Oas1e,4,1,237,242,3
Ociad2,11,8,223,242,3
Acan,3,0,239,242,3
Odf3l2,5,2,235,242,3
Olfml2a,4,1,237,242,3
Olfr1014,3,0,239,242,3
Abtb2,6,3,233,242,3
Olfr1085,3,0,239,242,3
Il17c,21,18,203,242,3
Rph3al,9,6,227,242,3
Hyi,8,5,229,242,3
Ccdc149,4,1,237,242,3
Gm6619,6,3,233,242,3
Ighv1-4,5,2,235,242,3
Bex2,15,12,215,242,3
Hes1,9,6,227,242,3
Ccdc158,6,3,233,242,3
Grhpr,9,6,227,242,3
Heyl,4,1,237,242,3
Gm6871,13,10,219,242,3
Bhlha15,7,4,231,242,3
Ighm,9,6,227,242,3
Grhl1,8,5,229,242,3
Smndc1,6,3,233,242,3
Ccdc162,4,1,237,242,3
Hfe,7,4,231,242,3
Gm7579,3,0,239,242,3
Btnl2,3,0,239,242,3
Igbp1,8,5,229,242,3
Vmn1r206,5,2,235,242,3
Gm7982,5,2,235,242,3
Btnl10,5,2,235,242,3
Greb1,4,1,237,242,3
Shb,7,4,231,242,3
Cycs,7,4,231,242,3
Btla,8,5,229,242,3
Bend7,4,1,237,242,3
Heph,5,2,235,242,3
Slc38a11,8,5,229,242,3
Slc40a1,13,10,219,242,3
Gm52993,4,1,237,242,3
Unc79,5,2,235,242,3
Ccdc188,9,6,227,242,3
Hbb-y,7,4,231,242,3
Ighv3-4,5,2,235,242,3
Ighv3-1,6,3,233,242,3
Hccs,7,4,231,242,3
Hcfc1r1,5,2,235,242,3
Slc22a8,4,1,237,242,3
Grm4,4,1,237,242,3
Ighv2-2,8,5,229,242,3
Ighv14-1,6,3,233,242,3
Grifin,9,6,227,242,3
Ighv1-85,8,5,229,242,3
Hdac4,6,3,233,242,3
Grin2b,3,0,239,242,3
Ighv1-82,11,8,223,242,3
Gm5771,4,1,237,242,3
Sh2d5,8,5,229,242,3
Sh3bgr,20,17,205,242,3
Ighv1-67,5,2,235,242,3
Ighv1-63,7,4,231,242,3
Snai3,11,8,223,242,3
Slc22a20,4,1,237,242,3
Car2,4,1,237,242,3
Ifna5,5,2,235,242,3
Slit3,4,1,237,242,3
Slc4a4,7,4,231,242,3
Gpc4,8,5,229,242,3
Shtn1,8,5,229,242,3
Hoxa4,8,5,229,242,3
Gprasp2,5,2,235,242,3
Gprasp1,7,4,231,242,3
Gphb5,5,2,235,242,3
Htr3a,7,4,231,242,3
Hoxb5,7,4,231,242,3
Utf1,4,1,237,242,3
Hoxc10,8,5,229,242,3
Vmn1r179,4,1,237,242,3
Bpifb9b,3,0,239,242,3
Blvrb,8,5,229,242,3
Hspb2,15,12,215,242,3
Usp50,7,4,231,242,3
Casp12,9,6,227,242,3
Gpr137c,9,6,227,242,3
Gpr146,8,5,229,242,3
Skint1,3,0,239,242,3
Sit1,7,4,231,242,3
Gpr55,5,2,235,242,3
Gpr171,6,3,233,242,3
Hsd3b1,4,1,237,242,3
Slc5a11,11,8,223,242,3
Gpc1,6,3,233,242,3
Slc6a5,3,0,239,242,3
Shroom2,5,2,235,242,3
Boll,19,16,207,242,3
Ifna4,7,4,231,242,3
Usp17ld,3,0,239,242,3
Hif3a,6,3,233,242,3
Higd2a,7,4,231,242,3
Ifna11,3,0,239,242,3
Car5a,15,12,215,242,3
Hikeshi,9,6,227,242,3
Slc16a11,11,8,223,242,3
Shd,11,8,223,242,3
Slc15a5,10,7,225,242,3
Gnl3l,5,2,235,242,3
Ifi35,5,2,235,242,3
Bmx,4,1,237,242,3
Cbr3,11,8,223,242,3
Car6,6,3,233,242,3
Gpx4,5,2,235,242,3
Gpx3,9,6,227,242,3
Hmx3,7,4,231,242,3
Idnk,6,3,233,242,3
Hnf4g,4,1,237,242,3
Gpx1,8,5,229,242,3
Slc49a4,7,4,231,242,3
Gprin1,5,2,235,242,3
Vma21,7,4,231,242,3
Slc1a7,13,10,219,242,3
Ighv5-9,6,3,233,242,3
Hao2,5,2,235,242,3
Ikzf3,3,0,239,242,3
Barx1,4,1,237,242,3
Vgll1,6,3,233,242,3
Gm49601,16,13,213,242,3
H2-K1,7,4,231,242,3
Iglc1,17,14,211,242,3
Snx31,5,2,235,242,3
Igkv10-95,5,2,235,242,3
H2-Q1,4,1,237,242,3
Sox10,5,2,235,242,3
Bcat1,11,8,223,242,3
Sox13,5,2,235,242,3
Gm50139,36,33,173,242,3
Cap2,10,7,225,242,3
H2-M3,11,8,223,242,3
Calhm6,9,6,227,242,3
Cadm1,7,4,231,242,3
BC048562,7,4,231,242,3
Gm49393,18,15,209,242,3
Slc35g1,8,5,229,242,3
Sgk3,7,4,231,242,3
Gulo,4,1,237,242,3
Bbs4,6,3,233,242,3
Cacybp,10,7,225,242,3
Gm48552,26,23,193,242,3
Gm49027,26,23,193,242,3
Igkv4-78,10,7,225,242,3
H2ac7,31,28,183,242,3
Sowaha,4,1,237,242,3
BC005537,6,3,233,242,3
Slc35b2,7,4,231,242,3
Slc35e1,6,3,233,242,3
Igkv3-12,7,4,231,242,3
Igkv8-30,11,8,223,242,3
Gm45871,8,5,229,242,3
Ighv8-5,5,2,235,242,3
Vamp9,17,14,211,242,3
Ccdc85c,10,7,225,242,3
Gm50387,7,4,231,242,3
Ikbip,6,3,233,242,3
Ighv6-3,12,9,221,242,3
Gstk1,10,7,225,242,3
Haus2,6,3,233,242,3
Ighv8-2,4,1,237,242,3
Ighv8-4,3,0,239,242,3
Iigp1,8,5,229,242,3
Snx20,5,2,235,242,3
Gm4559,3,0,239,242,3
Sox21,3,0,239,242,3
Snrpf,8,5,229,242,3
Calhm1,6,3,233,242,3
Baiap2l1,7,4,231,242,3
Dpf3,7,5,230,242,2
Olfr283,2,0,240,242,2
H2-D1,6,4,232,242,2
Srrm3,5,3,234,242,2
Olfr1382,2,0,240,242,2
Doxl2,3,1,238,242,2
Nme8,2,0,240,242,2
Dpm1,8,6,228,242,2
Efnb3,6,4,232,242,2
Ssbp3,5,3,234,242,2
Olfr282,2,0,240,242,2
Olfr1370,2,0,240,242,2
Olfr288,2,0,240,242,2
Olfr287,3,1,238,242,2
Olfr136,2,0,240,242,2
Dpysl2,7,5,230,242,2
Nnmt,6,4,232,242,2
Nmur1,8,6,228,242,2
Olfr1315-ps1,2,0,240,242,2
Dnajb14,5,3,234,242,2
Gpr52,4,2,236,242,2
Nhej1,3,1,238,242,2
Prss50,5,3,234,242,2
Slc28a2,3,1,238,242,2
Prr30,3,1,238,242,2
Nhlrc2,3,1,238,242,2
Dppa4,2,0,240,242,2
Olfr1340,2,0,240,242,2
Olfr1349,2,0,240,242,2
Dok6,2,0,240,242,2
Tmco4,7,5,230,242,2
Prrt3,6,4,232,242,2
Olfr1389,2,0,240,242,2
Tmem82,5,3,234,242,2
Olfr150,2,0,240,242,2
Doc2a,9,7,226,242,2
Nkx3-2,4,2,236,242,2
Spsb2,6,4,232,242,2
H2-M10.5,2,0,240,242,2
Olfr1537,3,1,238,242,2
Dnajc5g,8,6,228,242,2
Gm28363,4,2,236,242,2
Tmem59,5,3,234,242,2
Rab25,10,8,224,242,2
Gpr88,4,2,236,242,2
Nkx1-2,2,0,240,242,2
Olfr221,3,1,238,242,2
Olfr206,2,0,240,242,2
Olfr201,2,0,240,242,2
Nobox,7,5,230,242,2
Egln1,6,4,232,242,2
Olfr1484,6,4,232,242,2
Olfr1449,2,0,240,242,2
Olfr139,2,0,240,242,2
Srsf2,5,3,234,242,2
Gprc5d,3,1,238,242,2
Tmem51,3,1,238,242,2
Prr5,5,3,234,242,2
Olfr267,4,2,236,242,2
H2-Ea,11,9,222,242,2
Olfr1461,2,0,240,242,2
Tmem71,11,9,222,242,2
Gprc5b,6,4,232,242,2
Dock8,2,0,240,242,2
Dock10,5,3,234,242,2
Slc28a3,2,0,240,242,2
Olfr1451,2,0,240,242,2
Olfr1442,2,0,240,242,2
Nos1,2,0,240,242,2
Olfr1309,2,0,240,242,2
Odam,2,0,240,242,2
Psmg3,6,4,232,242,2
Nrg2,9,7,226,242,2
Dydc2,2,0,240,242,2
Psmf1,5,3,234,242,2
Sqstm1,5,3,234,242,2
Dusp9,7,5,230,242,2
Ocstamp,5,3,234,242,2
Gm21969,6,4,232,242,2
Gstm2,13,11,218,242,2
Nrk,2,0,240,242,2
Grin1,4,2,236,242,2
Odf1,7,5,230,242,2
Nr2e3,6,4,232,242,2
Ecm1,7,5,230,242,2
Gstm4,4,2,236,242,2
Gpr27,3,1,238,242,2
Psmd14,6,4,232,242,2
Olfm4,3,1,238,242,2
Ptpru,2,0,240,242,2
Oas1b,8,6,228,242,2
Gria2,4,2,236,242,2
Pth,2,0,240,242,2
Gsta4,9,7,226,242,2
Ntn5,5,3,234,242,2
Ntng2,6,4,232,242,2
Nudt11,5,3,234,242,2
Ptprcap,26,24,192,242,2
Pth2r,16,14,212,242,2
Nsmce2,7,5,230,242,2
Pth2,10,8,224,242,2
Nudt19,7,5,230,242,2
Gm21973,7,5,230,242,2
Ptgfr,4,2,236,242,2
Gsg1,8,6,228,242,2
Nup210,3,1,238,242,2
Ptprf,4,2,236,242,2
E2f6,3,1,238,242,2
Gsta5,13,11,218,242,2
Ptf1a,2,0,240,242,2
Slc3a2,5,3,234,242,2
Dusp2,12,10,220,242,2
Olfr1000,2,0,240,242,2
Olfr130,2,0,240,242,2
Slc35e4,7,5,230,242,2
Gm21818,5,3,234,242,2
Olfr115,3,1,238,242,2
Olfr1202,7,5,230,242,2
Pygo1,2,0,240,242,2
Psg22,4,2,236,242,2
Dsc3,2,0,240,242,2
Npcd,15,13,214,242,2
Olfr1230,2,0,240,242,2
Olfr1246,3,1,238,242,2
Olfr1138,3,1,238,242,2
Tmem238,19,17,206,242,2
Nsrp1,8,6,228,242,2
Nolc1,5,3,234,242,2
Tmem238l,5,3,234,242,2
Olfr1274,5,3,234,242,2
Psap,8,6,228,242,2
Drd1,2,0,240,242,2
Prtg,4,2,236,242,2
Pygb,6,4,232,242,2
Olfr1131,2,0,240,242,2
Srgap1,2,0,240,242,2
Tmem131,5,3,234,242,2
Tmem132d,2,0,240,242,2
Olfr1013,2,0,240,242,2
Slc36a2,7,5,230,242,2
Eddm3b,4,2,236,242,2
Duoxa1,11,9,222,242,2
Olfr1016,3,1,238,242,2
Olfr1019,3,1,238,242,2
Npr2,9,7,226,242,2
Gm21863,27,25,190,242,2
Olfr1118,3,1,238,242,2
Gsx1,2,0,240,242,2
Olfr1043,2,0,240,242,2
Edn3,4,2,236,242,2
Olfr1079,2,0,240,242,2
Pycr1,5,3,234,242,2
Eed,6,4,232,242,2
Npl,9,7,226,242,2
Olfr1104,2,0,240,242,2
Dnajb11,5,3,234,242,2
Il10rb,10,8,224,242,2
Gm28897,5,3,234,242,2
Gpr174,2,0,240,242,2
Gm5485,9,7,226,242,2
Ppp1r36,3,1,238,242,2
Gm53012,12,10,220,242,2
Pcdhga5,3,1,238,242,2
Pcdhga7,4,2,236,242,2
Pcdhgb7,2,0,240,242,2
Pcdhgc5,14,12,216,242,2
Pcf11,4,2,236,242,2
Dbndd2,9,7,226,242,2
Sntg2,6,4,232,242,2
Pcsk1n,2,0,240,242,2
Pcsk5,2,0,240,242,2
Gm428,7,5,230,242,2
Gm5096,6,4,232,242,2
Pdgfra,6,4,232,242,2
Pdia3,6,4,232,242,2
Pdlim2,11,9,222,242,2
Gm4303,7,5,230,242,2
Pdpn,3,1,238,242,2
Ppef2,4,2,236,242,2
Spaar,5,3,234,242,2
Peg3,3,1,238,242,2
Dach1,2,0,240,242,2
Peli3,8,6,228,242,2
D630045J12Rik,2,0,240,242,2
Pcdhb3,3,1,238,242,2
Dcc,2,0,240,242,2
Dcdc2a,3,1,238,242,2
Pcdh17,2,0,240,242,2
Gm38303,20,18,204,242,2
Pate1,5,3,234,242,2
Pate4,3,1,238,242,2
Pate9,6,4,232,242,2
Ddx24,4,2,236,242,2
Pax4,7,5,230,242,2
Gm3854,6,4,232,242,2
Gm6040,2,0,240,242,2
Pbx1,3,1,238,242,2
Ppp2r3a,7,5,230,242,2
Snap29,5,3,234,242,2
Ddah1,6,4,232,242,2
Dchs1,5,3,234,242,2
Dcx,4,2,236,242,2
Pcdha1,2,0,240,242,2
Gm39115,3,1,238,242,2
Pcdhb1,3,1,238,242,2
Pcdhb10,4,2,236,242,2
Gm5617,9,7,226,242,2
Tpm4,6,4,232,242,2
Pcdhb14,3,1,238,242,2
Snrnp48,7,5,230,242,2
Pcdhb19,2,0,240,242,2
Pcdhb20,3,1,238,242,2
Perp,6,4,232,242,2
D17H6S53E,10,8,224,242,2
Traj18,2,0,240,242,2
Plcl2,5,3,234,242,2
Piwil2,7,5,230,242,2
Pkig,6,4,232,242,2
Pknox1,7,5,230,242,2
Pkp2,2,0,240,242,2
Plxnb1,5,3,234,242,2
Pla2g2f,3,1,238,242,2
Cyp2d10,7,5,230,242,2
Gm45808,12,10,220,242,2
Cyp2c65,6,4,232,242,2
Plau,13,11,218,242,2
Plcd3,6,4,232,242,2
Cyp2c39,2,0,240,242,2
Gm47985,10,8,224,242,2
Plpp7,6,4,232,242,2
Plcxd2,6,4,232,242,2
Plcz1,2,0,240,242,2
Plpp3,6,4,232,242,2
Cyp2a4,2,0,240,242,2
Plpbp,5,3,234,242,2
Plod1,3,1,238,242,2
Cyp1b1,6,4,232,242,2
Cyp11b2,2,0,240,242,2
Plekhh3,7,5,230,242,2
Plin5,4,2,236,242,2
Sp3,5,3,234,242,2
Pirb,11,9,222,242,2
Cytl1,9,7,226,242,2
Phactr2,5,3,234,242,2
Por,3,1,238,242,2
Popdc2,8,6,228,242,2
Pop5,4,2,236,242,2
Traj28,3,1,238,242,2
Cyp4x1,7,5,230,242,2
Gm49425,2,0,240,242,2
Cyp4f15,3,1,238,242,2
Cyp4f14,6,4,232,242,2
Cyp4b1,5,3,234,242,2
Cyp4a31,7,5,230,242,2
Cyp4a30b,2,0,240,242,2
Cyp4a10,4,2,236,242,2
Gm4846,4,2,236,242,2
Phf11b,15,13,214,242,2
Phka1,4,2,236,242,2
Traj35,3,1,238,242,2
Sp7,3,1,238,242,2
Phox2b,2,0,240,242,2
Phyh,6,4,232,242,2
Pi4k2b,4,2,236,242,2
Gm49361,16,14,212,242,2
Pnpla7,7,5,230,242,2
Sohlh1,2,0,240,242,2
Cyp2j7,2,0,240,242,2
Smyd1,5,3,234,242,2
Prag1,5,3,234,242,2
Papss2,5,3,234,242,2
Procr,9,7,226,242,2
Olfr58,2,0,240,242,2
Gpd1l,6,4,232,242,2
Dipk2b,3,1,238,242,2
Tnfrsf19,3,1,238,242,2
Tnfrsf1a,7,5,230,242,2
Olfr620,4,2,236,242,2
H2-T22,10,8,224,242,2
Olfr629,2,0,240,242,2
Gpc5,3,1,238,242,2
Prol1,6,4,232,242,2
Olfr642,2,0,240,242,2
Olfr679,2,0,240,242,2
Tnfaip8l3,2,0,240,242,2
Dhx38,4,2,236,242,2
Slc7a14,4,2,236,242,2
Tnfsf14,3,1,238,242,2
Gm3043,2,0,240,242,2
Prm3,15,13,214,242,2
Prlr,8,6,228,242,2
Olfr739,2,0,240,242,2
Got2,5,3,234,242,2
Golm2,5,3,234,242,2
Slc7a9,7,5,230,242,2
Olfr78,3,1,238,242,2
Slc6a19,7,5,230,242,2
Olfr558,4,2,236,242,2
Olfr785,2,0,240,242,2
Dmrtc2,2,0,240,242,2
Olfr340,2,0,240,242,2
Slc5a7,2,0,240,242,2
Olfr378,2,0,240,242,2
Olfr394,4,2,236,242,2
Olfr414,5,3,234,242,2
Olfr446,5,3,234,242,2
Olfr457,6,4,232,242,2
Prpf39,7,5,230,242,2
Prpf38a,8,6,228,242,2
Tmprss4,5,3,234,242,2
Olfr478,4,2,236,242,2
Dmrtc1c2,13,11,218,242,2
Olfr554,4,2,236,242,2
Olfr503,2,0,240,242,2
Gpr12,3,1,238,242,2
Dmbx1,3,1,238,242,2
Tmtc1,3,1,238,242,2
Gm29289,12,10,220,242,2
Dll4,5,3,234,242,2
Gpm6b,6,4,232,242,2
Olfr544,3,1,238,242,2
Gpm6a,5,3,234,242,2
Olfr550,2,0,240,242,2
Dlg4,8,6,228,242,2
Olfr782,2,0,240,242,2
Tnip3,6,4,232,242,2
Gm6377,10,8,224,242,2
Spc24,8,6,228,242,2
Ott,11,9,222,242,2
Gm9507,3,1,238,242,2
Prdm13,2,0,240,242,2
Gm8947,8,6,228,242,2
Pramel6,2,0,240,242,2
P2ry1,3,1,238,242,2
Gm867,17,15,210,242,2
Pramel47,2,0,240,242,2
Spem2,2,0,240,242,2
Smco3,14,12,216,242,2
Pramel4,9,7,226,242,2
Pacsin2,5,3,234,242,2
Otogl,2,0,240,242,2
Padi2,9,7,226,242,2
Gm7075,25,23,194,242,2
Pramel31,3,1,238,242,2
Pramel30,3,1,238,242,2
Pramel29,4,2,236,242,2
Gm6760,2,0,240,242,2
Pramel28,2,0,240,242,2
Pam,6,4,232,242,2
Pramel24,4,2,236,242,2
Smr2,3,1,238,242,2
Pramel19,2,0,240,242,2
Slitrk4,2,0,240,242,2
Gm9732,6,4,232,242,2
Slc8a3,4,2,236,242,2
Gng8,15,13,214,242,2
Spocd1,5,3,234,242,2
Tnmd,9,7,226,242,2
Prkrip1,7,5,230,242,2
Dgki,3,1,238,242,2
Olfr834,4,2,236,242,2
Gnrh1,26,24,192,242,2
Tnnc2,17,15,210,242,2
Olfr862,2,0,240,242,2
Olfr889,12,10,220,242,2
Gnmt,8,6,228,242,2
Spint2,8,6,228,242,2
Dennd1b,4,2,236,242,2
Ormdl3,6,4,232,242,2
Defb9,3,1,238,242,2
Slco1a1,3,1,238,242,2
Defb6,2,0,240,242,2
Slco1a4,4,2,236,242,2
Olfr970,3,1,238,242,2
Defb45,10,8,224,242,2
Spink5,4,2,236,242,2
Olfr993,2,0,240,242,2
Olfr995,2,0,240,242,2
Slco2a1,7,5,230,242,2
Slco4c1,8,6,228,242,2
Eif1ad2,12,10,220,242,2
Tk2,6,4,232,242,2
Ngb,6,4,232,242,2
Ksr1,6,4,232,242,2
Ighv1-26,12,10,220,242,2
Lama2,2,0,240,242,2
Gm11037,4,2,236,242,2
Sh3gl2,8,6,228,242,2
Ighg3,5,3,234,242,2
Laptm4a,4,2,236,242,2
Igf2r,4,2,236,242,2
Gm11437,4,2,236,242,2
Gm11444,20,18,204,242,2
Fnd3c2,2,0,240,242,2
Lats2,7,5,230,242,2
Igf1r,6,4,232,242,2
Sash3,4,2,236,242,2
Sh3rf1,6,4,232,242,2
Lcn3,5,3,234,242,2
Lcn9,3,1,238,242,2
Lcp2,7,5,230,242,2
Lct,4,2,236,242,2
Fmnl1,13,11,218,242,2
Gm11568,2,0,240,242,2
Flnb,3,1,238,242,2
Lhx3,5,3,234,242,2
Sall1,3,1,238,242,2
Ifng,6,4,232,242,2
Ifnb1,5,3,234,242,2
Kyat1,4,2,236,242,2
Foxc1,5,3,234,242,2
Fbxl21,9,7,226,242,2
Ighv1-36,6,4,232,242,2
Klrh1,2,0,240,242,2
Kmt2e,4,2,236,242,2
Tanc2,5,3,234,242,2
Kng2,14,12,216,242,2
Scgb1b29,2,0,240,242,2
Krt10,7,5,230,242,2
Ighv1-81,10,8,224,242,2
Krt31,2,0,240,242,2
Sumf2,6,4,232,242,2
Krt6b,2,0,240,242,2
Krt80,9,7,226,242,2
Krt81,3,1,238,242,2
Ighv1-62-2,5,3,234,242,2
Krt87,2,0,240,242,2
Krt88,14,12,216,242,2
Ighv1-62-1,8,6,228,242,2
Tas2r105,2,0,240,242,2
Ighv1-49,4,2,236,242,2
Foxn3,8,6,228,242,2
Krtap28-10,2,0,240,242,2
Foxj1,12,10,220,242,2
Sh3d19,7,5,230,242,2
Foxg1,4,2,236,242,2
Krtap4-6,2,0,240,242,2
Krtap5-5,2,0,240,242,2
Limk1,7,5,230,242,2
Fkbp14,7,5,230,242,2
Ifna2,2,0,240,242,2
Lipe,8,6,228,242,2
Rspo3,7,5,230,242,2
Lrrc72,13,11,218,242,2
Lrrc8d,9,7,226,242,2
Lrrd1,10,8,224,242,2
Lrrk1,6,4,232,242,2
Lrrtm2,6,4,232,242,2
Lrrtm3,3,1,238,242,2
Shisal2b,8,6,228,242,2
Fbxw9,6,4,232,242,2
Rrm2b,7,5,230,242,2
Lsmem2,9,7,226,242,2
Shpk,4,2,236,242,2
Rragc,5,3,234,242,2
Ltbp4,4,2,236,242,2
Ltf,20,18,204,242,2
Rps7,7,5,230,242,2
Ly6c1,15,13,214,242,2
Ly96,17,15,210,242,2
I830077J02Rik,19,17,206,242,2
Tceal9,7,5,230,242,2
Tcf20,5,3,234,242,2
Fbxo11,5,3,234,242,2
Htra1,7,5,230,242,2
Rprd1a,5,3,234,242,2
Lzts2,7,5,230,242,2
Fcna,11,9,222,242,2
Lrrc32,13,11,218,242,2
Rtl3,2,0,240,242,2
Lonp1,5,3,234,242,2
Gm11937,3,1,238,242,2
Tbc1d21,3,1,238,242,2
Ifna14,2,0,240,242,2
S100a14,19,17,206,242,2
Fgfr3,10,8,224,242,2
Fgfbp3,6,4,232,242,2
Ifna1,2,0,240,242,2
Tbc1d31,7,5,230,242,2
Ryr2,5,3,234,242,2
Ifitm2,8,6,228,242,2
Lnx1,6,4,232,242,2
Shfl,10,8,224,242,2
Ido1,4,2,236,242,2
Ifit1bl2,6,4,232,242,2
Shh,4,2,236,242,2
Lrfn1,7,5,230,242,2
Ier5,4,2,236,242,2
Ier3,12,10,220,242,2
Fermt1,3,1,238,242,2
Lrp3,3,1,238,242,2
Rtl8b,5,3,234,242,2
Fcsk,3,1,238,242,2
Lrrc15,3,1,238,242,2
Lrrc17,7,5,230,242,2
Klrb1f,8,6,228,242,2
Ighv14-2,8,6,228,242,2
Ighv2-5,6,4,232,242,2
Jsrp1,18,16,208,242,2
Isg20,10,8,224,242,2
Islr,7,5,230,242,2
Glra4,3,1,238,242,2
Gdap2,9,7,226,242,2
Igkv5-37,5,3,234,242,2
Gltpd2,10,8,224,242,2
Serpina3c,4,2,236,242,2
Serpina3b,2,0,240,242,2
Gclc,3,1,238,242,2
Igkv4-70,13,11,218,242,2
Sgms1,4,2,236,242,2
Itgax,11,9,222,242,2
Itih1,3,1,238,242,2
Itk,5,3,234,242,2
Itm2b,4,2,236,242,2
Itpkb,4,2,236,242,2
Itprid1,4,2,236,242,2
Gbx1,9,7,226,242,2
Itprid2,6,4,232,242,2
Igkv2-112,6,4,232,242,2
Ivl,5,3,234,242,2
Svep1,5,3,234,242,2
Jade1,5,3,234,242,2
Jag1,4,2,236,242,2
Sgpp1,7,5,230,242,2
Irx3,6,4,232,242,2
Igkv6-17,9,7,226,242,2
Irs1,7,5,230,242,2
Igsf11,4,2,236,242,2
Sft2d2,5,3,234,242,2
Syf2,5,3,234,242,2
Ikzf2,8,6,228,242,2
Il17rb,7,5,230,242,2
Syn2,4,2,236,242,2
Syde2,3,1,238,242,2
Sfrp1,4,2,236,242,2
Il2rb,6,4,232,242,2
Sync,5,3,234,242,2
Gimd1,6,4,232,242,2
Il6ra,4,2,236,242,2
Inpp5f,6,4,232,242,2
Irf9,6,4,232,242,2
Ghdc,8,6,228,242,2
Sgca,15,13,214,242,2
Insm1,3,1,238,242,2
Syce1,7,5,230,242,2
Syap1,6,4,232,242,2
Serpinb6e,6,4,232,242,2
Serpinb3c,2,0,240,242,2
Swi5,7,5,230,242,2
Sgcg,4,2,236,242,2
Irak2,5,3,234,242,2
Igkv8-34,5,3,234,242,2
Sva,3,1,238,242,2
Gm10139,17,15,210,242,2
Fuom,10,8,224,242,2
Gata1,9,7,226,242,2
Gabrb2,4,2,236,242,2
Sdhaf2,3,1,238,242,2
Kera,2,0,240,242,2
Gabra4,4,2,236,242,2
Khdrbs2,6,4,232,242,2
Kif17,4,2,236,242,2
Sdc4,8,6,228,242,2
Ighv5-4,9,7,226,242,2
Kif27,3,1,238,242,2
Ighv5-16,7,5,230,242,2
Kifc3,6,4,232,242,2
Ighv5-15,6,4,232,242,2
Klc4,2,0,240,242,2
Gm10378,3,1,238,242,2
Fyn,7,5,230,242,2
Fxyd6,4,2,236,242,2
Scn1b,9,7,226,242,2
Klhl13,3,1,238,242,2
Klhl14,5,3,234,242,2
Gm10406,16,14,212,242,2
Klhl31,5,3,234,242,2
Klk1b21,4,2,236,242,2
Gm10491,23,21,198,242,2
Ighv2-9-1,6,4,232,242,2
Ighv2-7,5,3,234,242,2
Kdr,4,2,236,242,2
Kdm6b,6,4,232,242,2
Kdm5d,9,7,226,242,2
Selenbp1,10,8,224,242,2
Sema5b,2,0,240,242,2
T2,15,13,214,242,2
Sema5a,6,4,232,242,2
Gas6,4,2,236,242,2
Taar4,2,0,240,242,2
Gapvd1,3,1,238,242,2
Kash5,8,6,228,242,2
Igkv11-125,6,4,232,242,2
Sema3g,6,4,232,242,2
Selp,5,3,234,242,2
Gm10226,25,23,194,242,2
Kcnd3,5,3,234,242,2
Gad2,3,1,238,242,2
Sel1l3,2,0,240,242,2
Kcng4,3,1,238,242,2
Kcnh4,2,0,240,242,2
Gm10256,12,10,220,242,2
Galk2,5,3,234,242,2
Tacstd2,6,4,232,242,2
Gm10277,6,4,232,242,2
Kctd8,3,1,238,242,2
Gm10318,3,1,238,242,2
Sdhaf3,5,3,234,242,2
Ighv7-3,11,9,222,242,2
Gm13305,9,7,226,242,2
Htr3b,2,0,240,242,2
Slc28a1,6,4,232,242,2
Mthfd1l,6,4,232,242,2
Erg,4,2,236,242,2
Erfe,12,10,220,242,2
Thrb,11,9,222,242,2
Mtpn,7,5,230,242,2
Ticrr,9,7,226,242,2
Mup16,6,4,232,242,2
Mustn1,12,10,220,242,2
Mxd1,7,5,230,242,2
Hc,7,5,230,242,2
Gm20532,17,15,210,242,2
Mycl,10,8,224,242,2
Gm20594,23,21,198,242,2
Myh13,5,3,234,242,2
Epha3,5,3,234,242,2
Timm17b,7,5,230,242,2
Rbm45,13,11,218,242,2
Myl1,11,9,222,242,2
Myl12a,4,2,236,242,2
Mylk,4,2,236,242,2
Epc1,5,3,234,242,2
Epb42,4,2,236,242,2
Mylpf,17,15,210,242,2
Epb41l1,5,3,234,242,2
Gm20671,15,13,214,242,2
Myo1e,3,1,238,242,2
Themis3,6,4,232,242,2
Rdh9,15,13,214,242,2
Mageb16,5,3,234,242,2
Hdac8,6,4,232,242,2
Mrpl51,6,4,232,242,2
Rgs11,9,7,226,242,2
Rgn,9,7,226,242,2
Hhip,3,1,238,242,2
Mrps22,4,2,236,242,2
Steap3,4,2,236,242,2
Etnppl,6,4,232,242,2
Mrps6,6,4,232,242,2
Ms4a5,2,0,240,242,2
Tgm5,3,1,238,242,2
Ms4a6d,13,11,218,242,2
Esrp1,2,0,240,242,2
Espnl,2,0,240,242,2
Msc,8,6,228,242,2
Stc1,8,6,228,242,2
Mslnl,3,1,238,242,2
Esd,7,5,230,242,2
Slc22a19,4,2,236,242,2
Ermn,2,0,240,242,2
Mst1r,2,0,240,242,2
Slc22a26,2,0,240,242,2
Rell1,7,5,230,242,2
Ermap,6,4,232,242,2
Relb,5,3,234,242,2
Slc22a4,8,6,228,242,2
Rbm3,7,5,230,242,2
Myo7b,2,0,240,242,2
Slc25a23,8,6,228,242,2
Myom2,5,3,234,242,2
Rap2a,5,3,234,242,2
Ndufa6,6,4,232,242,2
Slc26a4,3,1,238,242,2
Raet1d,7,5,230,242,2
Tlnrd1,7,5,230,242,2
Necap1,7,5,230,242,2
Nedd9,4,2,236,242,2
Negr1,4,2,236,242,2
Ssr3,8,6,228,242,2
Nek5,4,2,236,242,2
Nek7,7,5,230,242,2
Rac2,14,12,216,242,2
Gm20931,2,0,240,242,2
Slc26a9,7,5,230,242,2
Neurod1,2,0,240,242,2
Sspo,4,2,236,242,2
Eif4a3l2,5,3,234,242,2
Tlx1,2,0,240,242,2
Tlx2,9,7,226,242,2
Slc27a2,9,7,226,242,2
Tm4sf4,9,7,226,242,2
Nfib,5,3,234,242,2
Nfkbib,5,3,234,242,2
Eif2ak3,5,3,234,242,2
Tm9sf5,4,2,236,242,2
Eln,5,3,234,242,2
Slc26a11,6,4,232,242,2
Gm20877,3,1,238,242,2
H6pd,8,6,228,242,2
Enpp5,7,5,230,242,2
Stam,6,4,232,242,2
Stag1,3,1,238,242,2
Slc25a25,8,6,228,242,2
Rbm12b2,6,4,232,242,2
Naa50,6,4,232,242,2
Naa60,6,4,232,242,2
Rbfox3,3,1,238,242,2
Gm20812,4,2,236,242,2
Hal,6,4,232,242,2
Slc25a37,5,3,234,242,2
Rasl2-9,15,13,214,242,2
H2ap,6,4,232,242,2
Emsy,9,7,226,242,2
H3c11,25,23,194,242,2
Nav1,6,4,232,242,2
St3gal5,8,6,228,242,2
H3c1,23,21,198,242,2
Ncf4,3,1,238,242,2
St3gal2,6,4,232,242,2
Rars,5,3,234,242,2
Rarb,5,3,234,242,2
St18,4,2,236,242,2
H2bc1,19,17,206,242,2
Rgs6,6,4,232,242,2
Rgs7bp,3,1,238,242,2
Exoc3l,8,6,228,242,2
Mfsd13a,6,4,232,242,2
Sipa1l2,4,2,236,242,2
Mc2r,6,4,232,242,2
Rnf39,10,8,224,242,2
Hsd17b3,5,3,234,242,2
Gm14419,26,24,192,242,2
Rnf225,9,7,226,242,2
Mdp1,7,5,230,242,2
Stra8,7,5,230,242,2
Fam43b,5,3,234,242,2
Rnf208,10,8,224,242,2
Tec,10,8,224,242,2
Rnf186,5,3,234,242,2
Fam25c,23,21,198,242,2
Megf10,5,3,234,242,2
Megf11,7,5,230,242,2
Hs3st3a1,3,1,238,242,2
Mertk,6,4,232,242,2
Teddm1a,4,2,236,242,2
Mettl24,5,3,234,242,2
Hoxc9,5,3,234,242,2
Mettl7a2,3,1,238,242,2
Mfap1b,5,3,234,242,2
Rnaset2b,8,6,228,242,2
Mff,4,2,236,242,2
Mfge8,8,6,228,242,2
Gm14327,18,16,208,242,2
Ror1,6,4,232,242,2
Rorb,6,4,232,242,2
Map2,10,8,224,242,2
Mageb18,6,4,232,242,2
Mageb2,3,1,238,242,2
Gm13695,8,6,228,242,2
Gm13871,2,0,240,242,2
Fate1,3,1,238,242,2
Htatsf1,7,5,230,242,2
Man2b1,9,7,226,242,2
Rpl31,6,4,232,242,2
Fank1,5,3,234,242,2
Sik3,4,2,236,242,2
Map1lc3b,5,3,234,242,2
Map2k4,6,4,232,242,2
Hsh2d,8,6,228,242,2
Map3k2,3,1,238,242,2
Rpl13,5,3,234,242,2
Map4k4,6,4,232,242,2
Rpl10l,3,1,238,242,2
Tdpoz2,2,0,240,242,2
Map7d2,3,1,238,242,2
Hspa5,5,3,234,242,2
Sim2,2,0,240,242,2
Mapk8ip1,3,1,238,242,2
Mapkapk2,6,4,232,242,2
Tdpoz9,2,0,240,242,2
Mfrp,12,10,220,242,2
Fam189b,8,6,228,242,2
Exoc4,5,3,234,242,2
Fam189a2,3,1,238,242,2
Rilp,9,7,226,242,2
Mmp14,5,3,234,242,2
Fabp5,9,7,226,242,2
Mmp17,3,1,238,242,2
Fabp3,9,7,226,242,2
Mmp1a,2,0,240,242,2
Gm16430,3,1,238,242,2
Stk32b,5,3,234,242,2
Mmrn1,5,3,234,242,2
Gm17190,14,12,216,242,2
Mn1,5,3,234,242,2
Hlf,8,6,228,242,2
Gm17266,2,0,240,242,2
Gm17332,2,0,240,242,2
Rhox4a2,11,9,222,242,2
Rhox4a,6,4,232,242,2
Morf4l2,7,5,230,242,2
Rhox2h,17,15,210,242,2
Rhox13,3,1,238,242,2
Mpp1,9,7,226,242,2
Mreg,9,7,226,242,2
Mrgpra4,2,0,240,242,2
Mrgprd,2,0,240,242,2
Mrm1,6,4,232,242,2
Rhbdf1,5,3,234,242,2
Stmn2,5,3,234,242,2
Fam102a,10,8,224,242,2
Mllt6,6,4,232,242,2
Minpp1,7,5,230,242,2
Rnase4,8,6,228,242,2
Tesk1,4,2,236,242,2
Rnase2a,13,11,218,242,2
Hoxb6,9,7,226,242,2
Fam174b,4,2,236,242,2
Mgat4b,8,6,228,242,2
Hoxb13,2,0,240,242,2
Micu1,6,4,232,242,2
Hoxa5,7,5,230,242,2
Mid1ip1,5,3,234,242,2
Mindy4b-ps,3,1,238,242,2
Miox,8,6,228,242,2
Mlana,11,9,222,242,2
Tex13c3,5,3,234,242,2
Hoxa10,5,3,234,242,2
Fam13b,5,3,234,242,2
Mis18a,6,4,232,242,2
Tex15,7,5,230,242,2
Misp3,15,13,214,242,2
Fam120c,4,2,236,242,2
Hnrnpab,4,2,236,242,2
Mknk2,5,3,234,242,2
Fam110c,2,0,240,242,2
Hnmt,6,4,232,242,2
Cygb,4,2,236,242,2
Mctp2,7,5,230,242,2
Uaca,4,2,236,242,2
Trav7d-4,4,2,236,242,2
Ubtd1,4,2,236,242,2
C1qtnf1,21,19,202,242,2
Washc1,3,1,238,242,2
BC051665,2,0,240,242,2
Chil1,7,5,230,242,2
C1qtnf7,7,5,230,242,2
6330403K07Rik,5,3,234,242,2
Aloxe3,3,1,238,242,2
Col7a1,4,2,236,242,2
Cdh19,7,5,230,242,2
Ap5z1,4,2,236,242,2
Tspan17,11,9,222,242,2
Chga,4,2,236,242,2
Adpgk,7,5,230,242,2
Apela,8,6,228,242,2
Ywhaz,7,5,230,242,2
Cct5,5,3,234,242,2
Cd19,4,2,236,242,2
2310046K23Rik,2,0,240,242,2
Wnt8b,2,0,240,242,2
Bzw2,5,3,234,242,2
Btnl9,6,4,232,242,2
Cd209g,4,2,236,242,2
Cdcp1,4,2,236,242,2
Zfpm1,3,1,238,242,2
Cd209a,6,4,232,242,2
Ctif,4,2,236,242,2
Ap1s2,5,3,234,242,2
C130050O18Rik,8,6,228,242,2
AF067061,3,1,238,242,2
Clec2g,10,8,224,242,2
Afap1l2,9,7,226,242,2
Alkbh5,4,2,236,242,2
Zfy1,2,0,240,242,2
Alkbh8,5,3,234,242,2
Ctnna1,6,4,232,242,2
Alox12e,5,3,234,242,2
Apex1,6,4,232,242,2
C4bp,4,2,236,242,2
Cited4,10,8,224,242,2
Try10,2,0,240,242,2
Cadps,4,2,236,242,2
Cadps2,3,1,238,242,2
Calb1,5,3,234,242,2
Calb2,4,2,236,242,2
Zic3,5,3,234,242,2
1810009J06Rik,2,0,240,242,2
Cald1,7,5,230,242,2
Col9a2,3,1,238,242,2
Cidea,11,9,222,242,2
Cracr2a,4,2,236,242,2
Vwa2,7,5,230,242,2
Amdhd2,11,9,222,242,2
Cdkn2b,4,2,236,242,2
Calml3,4,2,236,242,2
Vmn2r-ps158,4,2,236,242,2
Calu,5,3,234,242,2
Zkscan5,3,1,238,242,2
Cadm4,9,7,226,242,2
Trav8-1,3,1,238,242,2
6030498E09Rik,5,3,234,242,2
Ctsb,6,4,232,242,2
BC016579,6,4,232,242,2
Wnt7b,3,1,238,242,2
Abcg1,13,11,218,242,2
Asic5,2,0,240,242,2
Cabp2,7,5,230,242,2
Cts8,11,9,222,242,2
Cachd1,4,2,236,242,2
Adh6b,4,2,236,242,2
Amacr,5,3,234,242,2
Adgrg3,7,5,230,242,2
Tspan33,3,1,238,242,2
Vdr,9,7,226,242,2
Chd6,3,1,238,242,2
Trib1,5,3,234,242,2
Zglp1,22,20,200,242,2
2010106E10Rik,3,1,238,242,2
Zfp703,8,6,228,242,2
Trgj4,2,0,240,242,2
Colgalt1,6,4,232,242,2
Bpifc,4,2,236,242,2
Bgn,7,5,230,242,2
Ct55,4,2,236,242,2
Xpo6,7,5,230,242,2
AI854703,9,7,226,242,2
Bnip5,6,4,232,242,2
Atp6v0c,5,3,234,242,2
Xbp1,7,5,230,242,2
Bex3,8,6,228,242,2
Chmp5,4,2,236,242,2
4931429L15Rik,6,4,232,242,2
Cd70,4,2,236,242,2
Chmp4c,4,2,236,242,2
AI661453,4,2,236,242,2
Clcn7,4,2,236,242,2
9130409I23Rik,3,1,238,242,2
4930432M17Rik,5,3,234,242,2
Txndc16,6,4,232,242,2
Xiap,6,4,232,242,2
Trmt9b,7,5,230,242,2
Atp6v0b,6,4,232,242,2
Cstdc1,6,4,232,242,2
Trbv17,6,4,232,242,2
Vmn2r12,2,0,240,242,2
Atp6ap1,9,7,226,242,2
Bin1,7,5,230,242,2
Vmn2r15,3,1,238,242,2
Akr1cl,7,5,230,242,2
Abca13,2,0,240,242,2
Ube2w,6,4,232,242,2
Bmyc,6,4,232,242,2
Akain1,2,0,240,242,2
Cebpe,5,3,234,242,2
Cebpg,7,5,230,242,2
Cdc26,5,3,234,242,2
Ube2k,5,3,234,242,2
Atp4b,5,3,234,242,2
Trav7-1,5,3,234,242,2
Atp1b4,2,0,240,242,2
Zfp945,7,5,230,242,2
Btd,5,3,234,242,2
Treml2,3,1,238,242,2
Agr2,7,5,230,242,2
Col11a2,4,2,236,242,2
Col11a1,3,1,238,242,2
Agpat4,6,4,232,242,2
Bcl2l14,5,3,234,242,2
Vmn2r31,4,2,236,242,2
Yars,6,4,232,242,2
Trav6d-4,3,1,238,242,2
Vmn1r235,2,0,240,242,2
Wrnip1,5,3,234,242,2
Crhbp,8,6,228,242,2
Atg14,5,3,234,242,2
2810459M11Rik,6,4,232,242,2
Vmn1r237,2,0,240,242,2
Btbd9,4,2,236,242,2
Trav7-6,3,1,238,242,2
Csn1s2b,8,6,228,242,2
Ube2d3,5,3,234,242,2
Agt,3,1,238,242,2
Cldn3,4,2,236,242,2
Atp13a4,4,2,236,242,2
Atp1b2,10,8,224,242,2
Chrm3,2,0,240,242,2
Cldn1,5,3,234,242,2
Ahsa1,7,5,230,242,2
Atp1b1,7,5,230,242,2
Anxa13,7,5,230,242,2
Vmn2r115,2,0,240,242,2
Atp13a2,4,2,236,242,2
Vmn2r111,4,2,236,242,2
Ctbs,7,5,230,242,2
Ahr,4,2,236,242,2
Txn2,6,4,232,242,2
Wwtr1,3,1,238,242,2
Zfp287,8,6,228,242,2
Ckb,9,7,226,242,2
Zfp709,9,7,226,242,2
Cox7a2,5,3,234,242,2
1810009A15Rik,8,6,228,242,2
Cdc14a,4,2,236,242,2
Ank,5,3,234,242,2
Ccdc85a,2,0,240,242,2
Urah,16,14,212,242,2
Casr,5,3,234,242,2
Adam33,6,4,232,242,2
Ugt3a2,2,0,240,242,2
Cps1,3,1,238,242,2
Zbtb8b,4,2,236,242,2
Arhgap31,7,5,230,242,2
Zc3h12a,3,1,238,242,2
Ccdc7a,9,7,226,242,2
Unc93a2,3,1,238,242,2
1700019D03Rik,7,5,230,242,2
Zpld1,3,1,238,242,2
Wfdc8,3,1,238,242,2
Arhgef5,5,3,234,242,2
Clic5,4,2,236,242,2
Casq2,5,3,234,242,2
Ccdc187,3,1,238,242,2
Ces1d,4,2,236,242,2
Vps13b,6,4,232,242,2
Cplane2,9,7,226,242,2
Zfp553,7,5,230,242,2
A530016L24Rik,9,7,226,242,2
Zfp36l3,7,5,230,242,2
Ugt2b37,2,0,240,242,2
Cflar,4,2,236,242,2
B3gnt5,5,3,234,242,2
Ccdc186,6,4,232,242,2
Arpc1b,7,5,230,242,2
Ugt2b38,2,0,240,242,2
1110065P20Rik,5,3,234,242,2
Trpv5,2,0,240,242,2
Ccdc141,7,5,230,242,2
Cphx1,3,1,238,242,2
Catsperd,8,6,228,242,2
Unc5a,7,5,230,242,2
Cdk13,6,4,232,242,2
Zcchc13,4,2,236,242,2
1700013F07Rik,16,14,212,242,2
Acot1,9,7,226,242,2
Trim29,3,1,238,242,2
Arhgef38,3,1,238,242,2
Cbx6,5,3,234,242,2
Arl6ip5,6,4,232,242,2
Cmtm2b,12,10,220,242,2
Cpne9,6,4,232,242,2
Trim35,7,5,230,242,2
Acnat2,6,4,232,242,2
Cpne7,6,4,232,242,2
Cdk17,9,7,226,242,2
Vmn1r71,2,0,240,242,2
Unc45a,5,3,234,242,2
Cetn2,9,7,226,242,2
Ccdc28b,8,6,228,242,2
Cryzl2,9,7,226,242,2
Ccdc27,4,2,236,242,2
Arhgap39,11,9,222,242,2
Arhgap4,14,12,216,242,2
Actg2,10,8,224,242,2
Vpreb2,7,5,230,242,2
Cxcl12,6,4,232,242,2
Ulk3,7,5,230,242,2
Cavin3,4,2,236,242,2
Ttf1,7,5,230,242,2
Traj6,2,0,240,242,2
Awat2,5,3,234,242,2
Cxcl17,14,12,216,242,2
1700014D04Rik,18,16,208,242,2
Abcb9,5,3,234,242,2
Zfp622,5,3,234,242,2
Ciao1,4,2,236,242,2
Acot5,7,5,230,242,2
Cgn,11,9,222,242,2
Cask,8,6,228,242,2
Wls,8,6,228,242,2
Clmn,5,3,234,242,2
Ccng1,9,7,226,242,2
Crxos,12,10,220,242,2
Cry1,17,15,210,242,2
Zfp229,9,7,226,242,2
Cln5,9,7,226,242,2
Abcc5,5,3,234,242,2
Trpm3,3,1,238,242,2
Abcb4,2,0,240,242,2
Cnrip1,5,3,234,242,2
Adap2,7,5,230,242,2
Arx,2,0,240,242,2
Zbtb33,7,5,230,242,2
Cers1,7,5,230,242,2
Upk3a,7,5,230,242,2
Cdh5,10,8,224,242,2
Tspo2,7,5,230,242,2
Vmn1r95,2,0,240,242,2
Zfp663,3,1,238,242,2
Appl2,7,5,230,242,2
Vsx2,3,1,238,242,2
Tspear,4,2,236,242,2
Amigo2,4,2,236,242,2
Trappc6b,5,3,234,242,2
Wnk3,5,3,234,242,2
Ccdc172,3,1,238,242,2
Zfand5,5,3,234,242,2
Camk2n1,4,2,236,242,2
Trim30b,4,2,236,242,2
Trpc6,2,0,240,242,2
Zbtb18,12,10,220,242,2
Zbtb2,5,3,234,242,2
Vmn1r48,2,0,240,242,2
1700064H15Rik,33,31,178,242,2
Acad12,11,9,222,242,2
Acads,6,4,232,242,2
Ccl1,12,10,220,242,2
Cfap69,8,6,228,242,2
Trim17,10,8,224,242,2
Trbv29,10,8,224,242,2
Tspyl1,3,1,238,242,2
Trbv30,3,1,238,242,2
Trav16d-dv11,5,3,234,242,2
Trav9d-3,7,5,230,242,2
Ankrd34a,4,2,236,242,2
Zfp2,6,4,232,242,2
Cnksr2,2,0,240,242,2
Cnksr3,6,4,232,242,2
B4galt6,7,5,230,242,2
Clstn2,2,0,240,242,2
Cpa4,5,3,234,242,2
Trav3d-3,5,3,234,242,2
Ccl12,23,21,198,242,2
5730507C01Rik,6,4,232,242,2
Adamts9,4,2,236,242,2
Cers2,7,5,230,242,2
Ccl7,20,18,204,242,2
Ccl3,16,14,212,242,2
Ugt1a5,4,2,236,242,2
Vmn2r8,2,0,240,242,2
A130010J15Rik,7,5,230,242,2
Trbv23,2,0,240,242,2
Adamts8,2,0,240,242,2
Ccl20,12,10,220,242,2
Vmn1r5,4,2,236,242,2
Acsbg2,2,0,240,242,2
Car10,3,1,238,242,2
Ank3,4,2,236,242,2
Mettl7a3,16,15,211,242,1
Chrm2,1,0,241,242,1
Chrdl2,3,2,237,242,1
Anks1b,4,3,235,242,1
Rnf17,7,6,229,242,1
Mettl21e,12,11,219,242,1
Fmo3,1,0,241,242,1
Chst15,4,3,235,242,1
Rnf207,5,4,233,242,1
Med13l,3,2,237,242,1
Ankrd33,1,0,241,242,1
Med17,4,3,235,242,1
Tas2r138,1,0,241,242,1
Chrnd,6,5,231,242,1
Try4,2,1,239,242,1
Mdh1b,6,5,231,242,1
Meiob,3,2,237,242,1
Flvcr1,4,3,235,242,1
Rnf168,3,2,237,242,1
Med7,6,5,231,242,1
Mef2b,7,6,229,242,1
Mboat2,9,8,225,242,1
Medag,5,4,233,242,1
Rnf150,3,2,237,242,1
Mdh1,7,6,229,242,1
Fosl1,13,12,217,242,1
Tas2r118,1,0,241,242,1
Mettl21c,8,7,227,242,1
Rnf135,8,7,227,242,1
Anks1,4,3,235,242,1
Mc3r,1,0,241,242,1
Rnf44,5,4,233,242,1
Metrnl,8,7,227,242,1
Mcm4,5,4,233,242,1
Mest,7,6,229,242,1
Wdr5b,4,3,235,242,1
Chst2,1,0,241,242,1
Mcmbp,4,3,235,242,1
Mcpt1,2,1,239,242,1
Mcpt9,1,0,241,242,1
Ankrd54,5,4,233,242,1
Flg2,1,0,241,242,1
Rnf149,3,2,237,242,1
Mcpt2,1,0,241,242,1
Aldh18a1,4,3,235,242,1
Tshz1,4,3,235,242,1
Aqp3,9,8,225,242,1
Lrfn5,1,0,241,242,1
Gabra6,2,1,239,242,1
Rtp4,10,9,223,242,1
Lrp2,4,3,235,242,1
Lrrc1,4,3,235,242,1
Rtl9,2,1,239,242,1
Rtl5,2,1,239,242,1
Gaa,4,3,235,242,1
G6pdx,8,7,227,242,1
Arap2,6,5,231,242,1
Chadl,10,9,223,242,1
Lrrc38,1,0,241,242,1
Taf7l,5,4,233,242,1
Lrrc40,5,4,233,242,1
Aqp12,1,0,241,242,1
Rnh1,5,4,233,242,1
Aqp11,6,5,231,242,1
Lrrc74a,1,0,241,242,1
Vsx1,1,0,241,242,1
Vtcn1,5,4,233,242,1
Lrrn4cl,8,7,227,242,1
Vti1b,5,4,233,242,1
Tspan9,5,4,233,242,1
Rrnad1,3,2,237,242,1
Apol7c,10,9,223,242,1
Lsr,8,7,227,242,1
Ltb,10,9,223,242,1
Tspan5,4,3,235,242,1
Taldo1,5,4,233,242,1
Vwa7,6,5,231,242,1
Lrch1,6,5,231,242,1
Gabrg2,2,1,239,242,1
Lpo,2,1,239,242,1
Arhgap15,3,2,237,242,1
Gas2l2,1,0,241,242,1
Lemd1,5,4,233,242,1
Lenep,9,8,225,242,1
Samhd1,5,4,233,242,1
Samd12,5,4,233,242,1
Lgals9,8,7,227,242,1
Vps26b,6,5,231,242,1
Lifr,7,6,229,242,1
Vps37b,6,5,231,242,1
Tstd1,19,18,205,242,1
Arhgef17,4,3,235,242,1
Tssk3,7,6,229,242,1
S1pr1,6,5,231,242,1
Lipc,10,9,223,242,1
Cfb,14,13,215,242,1
Tacc1,7,6,229,242,1
Arhgap45,4,3,235,242,1
Tacr3,2,1,239,242,1
Llcfc1,2,1,239,242,1
Galns,6,5,231,242,1
Llph,5,4,233,242,1
Tsr2,6,5,231,242,1
Lmo1,4,3,235,242,1
Gal3st2b,6,5,231,242,1
Lmod1,4,3,235,242,1
Cfp,8,7,227,242,1
Arhgap20,3,2,237,242,1
Arhgap18,8,7,227,242,1
Lpar4,6,5,231,242,1
Luc7l3,5,4,233,242,1
Vwc2l,1,0,241,242,1
Ly6e,7,6,229,242,1
Frem3,5,4,233,242,1
Aox3,4,3,235,242,1
Man2a2,5,4,233,242,1
Mansc4,14,13,215,242,1
Fpr3,1,0,241,242,1
Aoc1,6,5,231,242,1
Fpr1,11,10,221,242,1
Map10,2,1,239,242,1
Map1b,5,4,233,242,1
Anxa9,8,7,227,242,1
Wdcp,7,6,229,242,1
Foxs1,11,10,221,242,1
Map3k15,6,5,231,242,1
Map3k21,6,5,231,242,1
Foxo6,6,5,231,242,1
Foxo3,6,5,231,242,1
Mapk1,7,6,229,242,1
Mapkbp1,2,1,239,242,1
Mapt,5,4,233,242,1
Marchf9,3,2,237,242,1
Marco,7,6,229,242,1
Matn2,6,5,231,242,1
Tas2r108,9,8,225,242,1
Matr3,2,1,239,242,1
Mavs,6,5,231,242,1
Max,12,11,219,242,1
Mb,14,13,215,242,1
Ro60,4,3,235,242,1
Mbd5,5,4,233,242,1
Rnmt,5,4,233,242,1
Rpl35,10,9,223,242,1
Frg2f1,7,6,229,242,1
Ly6g5b,9,8,225,242,1
Rpl36-ps4,16,15,211,242,1
Ly6l,4,3,235,242,1
Ftsj1,5,4,233,242,1
Lyn,5,4,233,242,1
Lypd8l,7,6,229,242,1
Ftdc1,2,1,239,242,1
Macf1,5,4,233,242,1
Ap4e1,5,4,233,242,1
Taok3,5,4,233,242,1
Fsip2l,3,2,237,242,1
Chil4,2,1,239,242,1
Mafg,6,5,231,242,1
Magea1,1,0,241,242,1
Magea13,5,4,233,242,1
Chil6,3,2,237,242,1
Ap2a1,6,5,231,242,1
Tapbpl,7,6,229,242,1
Mfap3l,5,4,233,242,1
Wasl,5,4,233,242,1
Mageb4,1,0,241,242,1
Magec2,3,2,237,242,1
Maged1,5,4,233,242,1
Frmpd4,1,0,241,242,1
Frmpd3,1,0,241,242,1
Magee1,5,4,233,242,1
Magel2,1,0,241,242,1
Frmd8,4,3,235,242,1
Mal2,5,4,233,242,1
Malrd1,3,2,237,242,1
Malsu1,2,1,239,242,1
Chka,6,5,231,242,1
Mpv17,6,5,231,242,1
Ankrd13b,4,3,235,242,1
Zbtb10,3,2,237,242,1
Ndufb11,6,5,231,242,1
Ndufaf7,3,2,237,242,1
Ndufaf2,6,5,231,242,1
Fam151b,9,8,225,242,1
Fam160a1,2,1,239,242,1
Ndufa7,9,8,225,242,1
Rap1b,6,5,231,242,1
Nfatc3,4,3,235,242,1
Fam161a,7,6,229,242,1
Rap2b,4,3,235,242,1
Adgra2,6,5,231,242,1
Trim67,1,0,241,242,1
Ndst1,6,5,231,242,1
Tex11,2,1,239,242,1
Adcy9,5,4,233,242,1
Raly,3,2,237,242,1
Ndufc1,3,2,237,242,1
Trim60,1,0,241,242,1
Rag1,7,6,229,242,1
Ndufs8,5,4,233,242,1
Fam126a,6,5,231,242,1
Fam122c,1,0,241,242,1
Fam120a,5,4,233,242,1
Neil2,6,5,231,242,1
Fam117b,4,3,235,242,1
Zbtb20,5,4,233,242,1
Cln3,8,7,227,242,1
Fam102b,3,2,237,242,1
Rac1,5,4,233,242,1
Neto2,3,2,237,242,1
Neu4,1,0,241,242,1
Ndrg4,4,3,235,242,1
Rapgef5,2,1,239,242,1
Rarres1,12,11,219,242,1
Triml2,1,0,241,242,1
Tecta,1,0,241,242,1
Aff3,3,2,237,242,1
Afap1l1,4,3,235,242,1
Rbm24,1,0,241,242,1
Rbm20,5,4,233,242,1
Tenm1,1,0,241,242,1
Tent4b,5,4,233,242,1
Naa16,4,3,235,242,1
Rbl2,4,3,235,242,1
Rbis,6,5,231,242,1
Rbfox1,4,3,235,242,1
Clec3b,9,8,225,242,1
Adrb1,4,3,235,242,1
Ywhae,3,2,237,242,1
Nampt,5,4,233,242,1
Ncoa2,5,4,233,242,1
Nap1l3,4,3,235,242,1
Adprs,4,3,235,242,1
Napa,4,3,235,242,1
Naprt,8,7,227,242,1
Trim9,1,0,241,242,1
Fam187b,10,9,223,242,1
Trim80,6,5,231,242,1
Adora1,6,5,231,242,1
Zadh2,5,4,233,242,1
Fam183b,12,11,219,242,1
Zap70,8,7,227,242,1
Nbn,4,3,235,242,1
Nbr1,8,7,227,242,1
Ncan,3,2,237,242,1
Fads3,3,2,237,242,1
Clock,6,5,231,242,1
Mfhas1,6,5,231,242,1
Adad2,1,0,241,242,1
Pycard,10,9,223,242,1
Actrt2,1,0,241,242,1
Acvr1,5,4,233,242,1
Cmtm4,5,4,233,242,1
Npas2,5,4,233,242,1
Noxa1,1,0,241,242,1
Qk,5,4,233,242,1
Fabp6,16,15,211,242,1
Evi2,6,5,231,242,1
Cmklr1,8,7,227,242,1
Nol6,5,4,233,242,1
Nol12,7,6,229,242,1
Noc2l,2,1,239,242,1
Zc3hav1,6,5,231,242,1
Npy,16,15,211,242,1
Npy2r,1,0,241,242,1
Pwwp2b,5,4,233,242,1
Tha1,8,7,227,242,1
Trim34a,7,6,229,242,1
Nr2f6,3,2,237,242,1
Esp5,4,3,235,242,1
Nr4a2,6,5,231,242,1
Ptx4,2,1,239,242,1
Ptx3,5,4,233,242,1
Nrg1,7,6,229,242,1
Nrgn,6,5,231,242,1
Cnbp,5,4,233,242,1
Acsm1,2,1,239,242,1
Nrn1,8,7,227,242,1
Acp5,6,5,231,242,1
Thbs2,1,0,241,242,1
Tgfbi,6,5,231,242,1
Nme1,6,5,231,242,1
Tgfb1,7,6,229,242,1
F11r,6,5,231,242,1
Clpb,3,2,237,242,1
Nfe2l3,6,5,231,242,1
Clpsl2,10,9,223,242,1
Nfkbia,7,6,229,242,1
Rab6a,4,3,235,242,1
Nfyb,5,4,233,242,1
F830016B08Rik,6,5,231,242,1
Rab5a,8,7,227,242,1
Adamts18,1,0,241,242,1
Nhlh2,5,4,233,242,1
Adamts16,2,1,239,242,1
Nhsl2,3,2,237,242,1
Nifk,3,2,237,242,1
Nipal1,3,2,237,242,1
Adam8,5,4,233,242,1
Tgfa,4,3,235,242,1
Adam7,2,1,239,242,1
Clstn3,5,4,233,242,1
Rab34,7,6,229,242,1
Eya3,5,4,233,242,1
Nkain3,2,1,239,242,1
Rab31,5,4,233,242,1
Tfdp2,5,4,233,242,1
Rab27b,6,5,231,242,1
Nkx1-1,4,3,235,242,1
Zbtb7a,6,5,231,242,1
Nkx6-3,2,1,239,242,1
Zc2hc1b,7,6,229,242,1
Rab15,5,4,233,242,1
Nlrp4c,1,0,241,242,1
Yjefn3,9,8,225,242,1
Myl6,3,2,237,242,1
Agfg2,8,7,227,242,1
Rhox3h,1,0,241,242,1
Alkal2,4,3,235,242,1
Rhox3a,4,3,235,242,1
Cisd2,4,3,235,242,1
Rhox3a2,1,0,241,242,1
Trpc4,1,0,241,242,1
Fcrl5,2,1,239,242,1
Fdx2,5,4,233,242,1
Fam32a,4,3,235,242,1
Rhox4e,6,5,231,242,1
Mocos,5,4,233,242,1
Mob4,5,4,233,242,1
Cilp,3,2,237,242,1
Fer1l4,6,5,231,242,1
Wnt8a,4,3,235,242,1
Tbx22,2,1,239,242,1
Mpdz,5,4,233,242,1
Wsb1,3,2,237,242,1
Trp53inp2,6,5,231,242,1
Mpl,1,0,241,242,1
Aldob,5,4,233,242,1
Ttc12,2,1,239,242,1
Mpzl3,8,7,227,242,1
Aldh4a1,5,4,233,242,1
Tc2n,6,5,231,242,1
Aldh1l1,5,4,233,242,1
Mroh1,5,4,233,242,1
Rgs9,5,4,233,242,1
Xcr1,7,6,229,242,1
Akt1s1,8,7,227,242,1
Rgs21,1,0,241,242,1
Rgs18,6,5,231,242,1
Fermt2,5,4,233,242,1
Mmp9,10,9,223,242,1
Mmp28,6,5,231,242,1
Fgl2,7,6,229,242,1
Mfn1,4,3,235,242,1
Rnase2b,3,2,237,242,1
Ankdd1a,1,0,241,242,1
Filip1l,8,7,227,242,1
Mfsd4b1,5,4,233,242,1
Mfsd6,2,1,239,242,1
Tbc1d12,5,4,233,242,1
Mga,6,5,231,242,1
Fibin,4,3,235,242,1
Wfdc6a,8,7,227,242,1
Rln3,18,17,207,242,1
Wfikkn2,3,2,237,242,1
Fhit,9,8,225,242,1
Fhad1,4,3,235,242,1
Mif,7,6,229,242,1
Mmp2,8,7,227,242,1
Tbc1d24,4,3,235,242,1
Mill2,6,5,231,242,1
Fgfbp1,9,8,225,242,1
Trpm7,5,4,233,242,1
Anapc2,4,3,235,242,1
Fgf4,1,0,241,242,1
Ripk2,7,6,229,242,1
Mitf,6,5,231,242,1
Trpc7,3,2,237,242,1
Mlip,4,3,235,242,1
Wnk2,2,1,239,242,1
Mmd2,3,2,237,242,1
Ffar3,2,1,239,242,1
Mmp1b,3,2,237,242,1
Tceal7,11,10,221,242,1
Tceal8,6,5,231,242,1
Fbxo33,4,3,235,242,1
Tdpoz8,3,2,237,242,1
Tcp11l2,4,3,235,242,1
Muc1,8,7,227,242,1
Muc3a,5,4,233,242,1
Mug1,2,1,239,242,1
Mup11,4,3,235,242,1
Rbpms,7,6,229,242,1
Mup8,2,1,239,242,1
Rbp7,21,20,201,242,1
Musk,4,3,235,242,1
Cldn23,9,8,225,242,1
Agrp,13,12,217,242,1
Fam83c,3,2,237,242,1
Cldn34b1,1,0,241,242,1
Fam78b,6,5,231,242,1
Yap1,4,3,235,242,1
Mtx1,4,3,235,242,1
Myd88,3,2,237,242,1
Trmt1,5,4,233,242,1
Myf5,3,2,237,242,1
Rbm48,5,4,233,242,1
Myg1,5,4,233,242,1
Ago4,1,0,241,242,1
Agmat,12,11,219,242,1
Tdrd9,2,1,239,242,1
Myh6,8,7,227,242,1
Myh7,4,3,235,242,1
Rbm44,6,5,231,242,1
Aggf1,3,2,237,242,1
Clec12a,15,14,213,242,1
Clec12b,5,4,233,242,1
Cldn13,5,4,233,242,1
Mtus2,5,4,233,242,1
Akr1c20,1,0,241,242,1
Rep15,8,7,227,242,1
Rgr,5,4,233,242,1
Mrps12,4,3,235,242,1
Rfng,5,4,233,242,1
Tcf12,4,3,235,242,1
Ms4a18,2,1,239,242,1
Ms4a2,4,3,235,242,1
Akap4,1,0,241,242,1
Akap17b,4,3,235,242,1
Xlr4b,14,13,215,242,1
Msh5,5,4,233,242,1
Ak4,6,5,231,242,1
Clcf1,7,6,229,242,1
Rerg,7,6,229,242,1
Msx1,12,11,219,242,1
Aig1,4,3,235,242,1
Rcc2,3,2,237,242,1
Tcfl5,5,4,233,242,1
Mta2,3,2,237,242,1
Clcn5,5,4,233,242,1
Fbll1,9,8,225,242,1
Reep3,6,5,231,242,1
Recql,6,5,231,242,1
Mtfmt,5,4,233,242,1
Tcirg1,5,4,233,242,1
Tcl1,2,1,239,242,1
Rdh8,4,3,235,242,1
Fat2,3,2,237,242,1
Tcl1b5,3,2,237,242,1
Clcnkb,13,12,217,242,1
Tcof1,5,4,233,242,1
Sap18,14,13,215,242,1
Scgb1b24,1,0,241,242,1
Taar2,1,0,241,242,1
Cd55b,8,7,227,242,1
Spz1,3,2,237,242,1
Sla,7,6,229,242,1
Gm27235,5,4,233,242,1
Vmn1r127,1,0,241,242,1
Cd300e,5,4,233,242,1
Hmgn1,5,4,233,242,1
Slc12a3,3,2,237,242,1
Vmn1r124,1,0,241,242,1
Hlcs,3,2,237,242,1
Gm28308,8,7,227,242,1
Vmn1r121,1,0,241,242,1
Slc16a10,2,1,239,242,1
Spsb3,4,3,235,242,1
Btg1,4,3,235,242,1
Slc17a2,2,1,239,242,1
Skor1,1,0,241,242,1
Hoga1,8,7,227,242,1
Hook1,4,3,235,242,1
Vmn1r158,1,0,241,242,1
Hs3st3b1,2,1,239,242,1
Hs3st1,8,7,227,242,1
Six6,1,0,241,242,1
Hr,2,1,239,242,1
Cd48,6,5,231,242,1
Skil,4,3,235,242,1
Vmn1r157,1,0,241,242,1
Hopx,5,4,233,242,1
Skint10,2,1,239,242,1
Srd5a2,4,3,235,242,1
Gm21996,2,1,239,242,1
Ubl4b,1,0,241,242,1
Vmn1r135,1,0,241,242,1
Ubn1,4,3,235,242,1
Hhex,10,9,223,242,1
Btnl1,3,2,237,242,1
Hgfac,12,11,219,242,1
Cct8l1,6,5,231,242,1
Ubtfl1,12,11,219,242,1
Spire1,3,2,237,242,1
Spint5,3,2,237,242,1
C1rl,5,4,233,242,1
Cd14,12,11,219,242,1
Ubxn4,4,3,235,242,1
Gm3233,1,0,241,242,1
Spock2,1,0,241,242,1
C1s1,9,8,225,242,1
C1s2,5,4,233,242,1
Hbb-bh2,1,0,241,242,1
Hax1,2,1,239,242,1
Slc25a14,6,5,231,242,1
Haus6,5,4,233,242,1
Spock1,1,0,241,242,1
Slc22a6,3,2,237,242,1
Cd226,7,6,229,242,1
Heg1,4,3,235,242,1
Hexb,8,7,227,242,1
Hes7,9,8,225,242,1
Hes2,2,1,239,242,1
Vmn1r112,1,0,241,242,1
Bzw1,3,2,237,242,1
Sprr2a1,2,1,239,242,1
C1galt1,5,4,233,242,1
C1ql3,5,4,233,242,1
Vmn1r107,1,0,241,242,1
Cd2,7,6,229,242,1
Heatr5b,2,1,239,242,1
C1qbp,3,2,237,242,1
Slc22a28,2,1,239,242,1
Slc22a29,2,1,239,242,1
Vmn1r168,4,3,235,242,1
Vmn1r171,1,0,241,242,1
Hat1,9,8,225,242,1
Gm21866,2,1,239,242,1
Sh3gl1,3,2,237,242,1
Bhlhe22,3,2,237,242,1
St3gal6,9,8,225,242,1
Igfbp4,7,6,229,242,1
Bid,5,4,233,242,1
Igfbp1,5,4,233,242,1
Gm20894,3,2,237,242,1
Sh3rf3,3,2,237,242,1
Vmn1r204,1,0,241,242,1
Sstr4,2,1,239,242,1
Ifngr2,9,8,225,242,1
Ifna9,1,0,241,242,1
Ifna7,1,0,241,242,1
Bmerb1,7,6,229,242,1
Ifna15,5,4,233,242,1
Bfsp2,3,2,237,242,1
Bex4,8,7,227,242,1
Cdc42bpb,4,3,235,242,1
Bcl6b,8,7,227,242,1
Ighv5-2,5,4,233,242,1
Bcl2a1b,13,12,217,242,1
Ighv3-8,8,7,227,242,1
Bcl2l11,8,7,227,242,1
Ighv2-6-8,3,2,237,242,1
Ighv2-4,5,4,233,242,1
Gm20605,9,8,225,242,1
Vmn1r219,1,0,241,242,1
Ighv11-1,4,3,235,242,1
Cdc42ep4,3,2,237,242,1
Vmn1r225,1,0,241,242,1
Gm20708,21,20,201,242,1
Ighv1-59,7,6,229,242,1
Ighv1-53,8,7,227,242,1
Bmp10,1,0,241,242,1
Ifitm3,11,10,221,242,1
She,3,2,237,242,1
Gm21767,2,1,239,242,1
Vmn1r183,4,3,235,242,1
Siah2,3,2,237,242,1
Bpifa6,5,4,233,242,1
Htr6,5,4,233,242,1
Htr4,1,0,241,242,1
Bpifb5,2,1,239,242,1
Srp54c,12,11,219,242,1
Cd80,7,6,229,242,1
Brca1,7,6,229,242,1
Brd1,3,2,237,242,1
Srp54a,9,8,225,242,1
Brd2,3,2,237,242,1
Vmn1r174,1,0,241,242,1
Hsf4,12,11,219,242,1
Srrm4,6,5,231,242,1
Hypk,8,7,227,242,1
Vmn1r195,1,0,241,242,1
Vmn1r194,1,0,241,242,1
Gm21244,5,4,233,242,1
Ifi44,8,7,227,242,1
Gm21258,3,2,237,242,1
Bmpr1a,5,4,233,242,1
Bmpr2,6,5,231,242,1
Ifi209,8,7,227,242,1
Shisa7,2,1,239,242,1
Bphl,4,3,235,242,1
Vmn1r192,1,0,241,242,1
Shisa9,2,1,239,242,1
Idua,5,4,233,242,1
Ids,6,5,231,242,1
Ido2,4,3,235,242,1
Iars2,3,2,237,242,1
Slc25a16,6,5,231,242,1
Vip,1,0,241,242,1
Ighv6-4,2,1,239,242,1
Carmil2,5,4,233,242,1
Slc66a2,6,5,231,242,1
Soga1,6,5,231,242,1
Gm49340,5,4,233,242,1
Gm49342,14,13,215,242,1
Gm49345,22,21,199,242,1
Socs7,2,1,239,242,1
Gpihbp1,9,8,225,242,1
Ccdc73,13,12,217,242,1
Cavin1,5,4,233,242,1
Socs2,6,5,231,242,1
Gm49385,2,1,239,242,1
Sobp,1,0,241,242,1
Slc7a12,4,3,235,242,1
Usp31,4,3,235,242,1
Gns,5,4,233,242,1
Gpr141,6,5,231,242,1
Gpr151,8,7,227,242,1
Ugt8a,4,3,235,242,1
Gpr4,6,5,231,242,1
Slc4a2,3,2,237,242,1
Ugt2a2,3,2,237,242,1
Sowahc,5,4,233,242,1
Usp9y,1,0,241,242,1
Ugt2b34,3,2,237,242,1
Ccdc88c,6,5,231,242,1
Usp7,4,3,235,242,1
Gpr17,2,1,239,242,1
Sorl1,2,1,239,242,1
Sord,5,4,233,242,1
Gm4792,2,1,239,242,1
Slc5a1,4,3,235,242,1
Gpr179,2,1,239,242,1
Ccdc85b,2,1,239,242,1
Gm4951,12,11,219,242,1
Gnb5,6,5,231,242,1
Gnas,5,4,233,242,1
Gm5737,5,4,233,242,1
Smoc1,1,0,241,242,1
Gm7168,7,6,229,242,1
Uqcrc1,3,2,237,242,1
Snrnp200,3,2,237,242,1
Gm7030,6,5,231,242,1
Smok3b,1,0,241,242,1
Gm6763,8,7,227,242,1
Gm7735,1,0,241,242,1
Smr2l,1,0,241,242,1
Upk3bl,13,12,217,242,1
Sncb,5,4,233,242,1
Ccdc170,4,3,235,242,1
Upk2,5,4,233,242,1
Snap47,6,5,231,242,1
Snrpd1,4,3,235,242,1
Gm8011,9,8,225,242,1
Usp17lc,5,4,233,242,1
Slk,5,4,233,242,1
Slfn3,6,5,231,242,1
Gm9955,23,22,197,242,1
Slit1,2,1,239,242,1
Gm9639,3,2,237,242,1
Snx21,6,5,231,242,1
Slitrk5,4,3,235,242,1
Gm9040,7,6,229,242,1
Smim23,3,2,237,242,1
Usf2,5,4,233,242,1
Smad3,7,6,229,242,1
Smagp,6,5,231,242,1
Snu13,5,4,233,242,1
Smg6,2,1,239,242,1
Smim1,13,12,217,242,1
Ust,4,3,235,242,1
Gm45826,1,0,241,242,1
Vgll3,6,5,231,242,1
Gpt,5,4,233,242,1
Spata3,5,4,233,242,1
Slc2a10,3,2,237,242,1
Spata20,4,3,235,242,1
Caly,9,8,225,242,1
Slc2a7,2,1,239,242,1
Slc2a8,5,4,233,242,1
Gm37797,1,0,241,242,1
Gzmk,2,1,239,242,1
Spata18,2,1,239,242,1
Gzmd,4,3,235,242,1
Gm38392,16,15,211,242,1
Gys1,5,4,233,242,1
Ccnt1,5,4,233,242,1
Slc30a6,6,5,231,242,1
Slc30a8,1,0,241,242,1
Spata31d1a,10,9,223,242,1
H2-M10.6,1,0,241,242,1
H2-M5,17,16,209,242,1
Gm34653,10,9,223,242,1
Cabin1,4,3,235,242,1
H60c,4,3,235,242,1
Spindoc,6,5,231,242,1
H4c17,29,28,185,242,1
H4c11,10,9,223,242,1
H2bl1,3,2,237,242,1
H2bc14,25,24,193,242,1
H2-M9,5,4,233,242,1
Cacng1,5,4,233,242,1
Vdac1,7,6,229,242,1
H2al1a,5,4,233,242,1
Spatc1,2,1,239,242,1
Calhm4,1,0,241,242,1
Gm36255,1,0,241,242,1
Slc30a9,4,3,235,242,1
Gucy2c,2,1,239,242,1
Ccnjl,1,0,241,242,1
Gm45140,17,16,209,242,1
Slc38a4,5,4,233,242,1
Grsf1,4,3,235,242,1
Grm7,2,1,239,242,1
Slc39a5,9,8,225,242,1
Grm2,4,3,235,242,1
Grin2c,4,3,235,242,1
Car12,4,3,235,242,1
Ccm2l,5,4,233,242,1
Slc44a4,8,7,227,242,1
Car8,3,2,237,242,1
Grap2,4,3,235,242,1
Gm4567,1,0,241,242,1
Slc47a1,8,7,227,242,1
Gpx5,1,0,241,242,1
V1rg10,1,0,241,242,1
Ugp2,4,3,235,242,1
Gm40193,17,16,209,242,1
Gstm6,13,12,217,242,1
Camp,20,19,203,242,1
Ccnh,4,3,235,242,1
Camsap2,4,3,235,242,1
Gsx2,3,2,237,242,1
Slc37a3,7,6,229,242,1
Gm42957,6,5,231,242,1
Capn12,5,4,233,242,1
Gm4356,19,18,205,242,1
Gm43064,20,19,203,242,1
Slc38a10,3,2,237,242,1
Ugcg,5,4,233,242,1
Gm4340,3,2,237,242,1
Capn3,7,6,229,242,1
Slc38a2,7,6,229,242,1
Bcl2,6,5,231,242,1
Bche,5,4,233,242,1
Leap2,30,29,183,242,1
Klri2,1,0,241,242,1
Klhl26,5,4,233,242,1
Glipr1,14,13,215,242,1
Scn3a,9,8,225,242,1
Glis3,5,4,233,242,1
Cep162,4,3,235,242,1
Scn4a,1,0,241,242,1
Svs4,3,2,237,242,1
Glra1,2,1,239,242,1
Vmn2r43,1,0,241,242,1
Aste1,6,5,231,242,1
Scn8a,6,5,231,242,1
Klf10,10,9,223,242,1
Vmn2r42,1,0,241,242,1
Svs3a,1,0,241,242,1
Svs2,1,0,241,242,1
Klhl28,5,4,233,242,1
Gldn,1,0,241,242,1
Klhl33,3,2,237,242,1
Asgr2,5,4,233,242,1
Gjb1,3,2,237,242,1
Klra6,3,2,237,242,1
Ttpal,4,3,235,242,1
Klk7,6,5,231,242,1
Tuba3a,8,7,227,242,1
Klk6,9,8,225,242,1
Syk,8,7,227,242,1
Sclt1,4,3,235,242,1
Tuba4a,5,4,233,242,1
Vmn2r52,3,2,237,242,1
Klk12,5,4,233,242,1
Gla,8,7,227,242,1
Klhl41,6,5,231,242,1
Klhl36,7,6,229,242,1
Scnn1b,6,5,231,242,1
Svs1,1,0,241,242,1
Kirrel2,6,5,231,242,1
Kcnip1,4,3,235,242,1
Kcnn3,3,2,237,242,1
Kcnmb1,2,1,239,242,1
Kcnk9,1,0,241,242,1
Gm10302,1,0,241,242,1
Atoh7,6,5,231,242,1
Sec31b,3,2,237,242,1
Txn1,7,6,229,242,1
Atg9b,3,2,237,242,1
Celsr3,3,2,237,242,1
Kcnh5,2,1,239,242,1
Atp1a1,8,7,227,242,1
Atp1a2,3,2,237,242,1
Kcnc4,1,0,241,242,1
Selenoh,4,3,235,242,1
Kcp,5,4,233,242,1
Atg3,4,3,235,242,1
Kir3dl1,2,1,239,242,1
Atf4,7,6,229,242,1
Kif5b,5,4,233,242,1
Kif5a,6,5,231,242,1
Scrt2,1,0,241,242,1
Vmn2r37,1,0,241,242,1
Sdc2,4,3,235,242,1
Gm10061,4,3,235,242,1
Gm10100,2,1,239,242,1
Kdm4b,3,2,237,242,1
Sval1,3,2,237,242,1
Sdcbp2,7,6,229,242,1
Vmn2r35,1,0,241,242,1
Khdc1c,2,1,239,242,1
Kdm6a,6,5,231,242,1
Kdm4c,4,3,235,242,1
Scgb2b17,1,0,241,242,1
Gja3,15,14,213,242,1
Gm10542,1,0,241,242,1
Kng1,7,6,229,242,1
Vmn2r96,1,0,241,242,1
Lalba,12,11,219,242,1
Scamp3,4,3,235,242,1
Armh1,4,3,235,242,1
Ces3b,1,0,241,242,1
Scarb1,5,4,233,242,1
Ces2h,3,2,237,242,1
Armh4,3,2,237,242,1
Scarf1,7,6,229,242,1
Krtcap2,5,4,233,242,1
Krtap8-1,1,0,241,242,1
Krtap6-2,1,0,241,242,1
Arntl,6,5,231,242,1
Krtap5-2,2,1,239,242,1
Krtap4-9,2,1,239,242,1
Armc9,8,7,227,242,1
Lama5,3,2,237,242,1
Vmn2r97,2,1,239,242,1
Sat2,10,9,223,242,1
Ldb2,3,2,237,242,1
Lcn8,5,4,233,242,1
Gatad2a,4,3,235,242,1
Lcn11,3,2,237,242,1
Lce1j,1,0,241,242,1
Lce1i,1,0,241,242,1
Satb1,2,1,239,242,1
Lamp2,5,4,233,242,1
Ttc3,5,4,233,242,1
Lax1,6,5,231,242,1
Arl4d,11,10,221,242,1
Sbp,1,0,241,242,1
Cfap161,9,8,225,242,1
Sbspon,4,3,235,242,1
Krtap31-1,1,0,241,242,1
Gdpd3,16,15,211,242,1
Vmn2r87,1,0,241,242,1
Gimap9,8,7,227,242,1
Krt25,1,0,241,242,1
Asb10,4,3,235,242,1
Krt16,5,4,233,242,1
Krt15,6,5,231,242,1
Gimap5,4,3,235,242,1
Scgb1b15,3,2,237,242,1
Syngr1,12,11,219,242,1
Ttll4,6,5,231,242,1
Krcc1,6,5,231,242,1
Syne4,10,9,223,242,1
Syne2,5,4,233,242,1
Kprp,2,1,239,242,1
Scgb1b20,1,0,241,242,1
Cnga1,3,2,237,242,1
Ghrhr,1,0,241,242,1
Vmn2r70,1,0,241,242,1
Syt2,5,4,233,242,1
Krtap1-3,5,4,233,242,1
Syt15,3,2,237,242,1
Krtap2-4,7,6,229,242,1
Krtap19-3,1,0,241,242,1
Get3,3,2,237,242,1
Gfap,7,6,229,242,1
Scel,7,6,229,242,1
Krt90,1,0,241,242,1
Krt34,1,0,241,242,1
Cers5,7,6,229,242,1
Gfpt2,2,1,239,242,1
Syp,3,2,237,242,1
Vmn2r77,1,0,241,242,1
Ggct,8,7,227,242,1
Krt40,3,2,237,242,1
Vmn2r19,1,0,241,242,1
Atp2b1,5,4,233,242,1
Stat5a,4,3,235,242,1
Azin1,7,6,229,242,1
Il1rapl2,2,1,239,242,1
Il1rapl1,1,0,241,242,1
Il1f8,1,0,241,242,1
Il1f5,2,1,239,242,1
Stom,3,2,237,242,1
Sfpq,3,2,237,242,1
Il17re,5,4,233,242,1
Gm15294,28,27,187,242,1
Bace2,9,8,225,242,1
Gm1553,4,3,235,242,1
Ikzf4,5,4,233,242,1
Vmn1r45,1,0,241,242,1
Sftpb,4,3,235,242,1
Cdh7,4,3,235,242,1
Sftpc,14,13,215,242,1
B4galt1,5,4,233,242,1
Sf3b6,8,7,227,242,1
Gm14862,6,5,231,242,1
Inf2,6,5,231,242,1
Gm14288,23,22,197,242,1
Vmn1r75,2,1,239,242,1
Gm14305,20,19,203,242,1
Inpp4a,9,8,225,242,1
B2m,8,7,227,242,1
Vmn1r70,1,0,241,242,1
Setd6,5,4,233,242,1
Stra6l,2,1,239,242,1
Strc,1,0,241,242,1
Sf1,4,3,235,242,1
Sf3a3,3,2,237,242,1
B3galt2,3,2,237,242,1
Gm14440,21,20,201,242,1
Vmn1r69,1,0,241,242,1
Baiap2l2,3,2,237,242,1
Igsf3,5,4,233,242,1
Igll1,5,4,233,242,1
Gm19402,1,0,241,242,1
Sgo2b,2,1,239,242,1
Vmn1r257,1,0,241,242,1
Gm17631,2,1,239,242,1
BC048507,12,11,219,242,1
BC048671,1,0,241,242,1
Vmn1r244,1,0,241,242,1
Stfa2,9,8,225,242,1
Gm17542,1,0,241,242,1
Gm19668,3,2,237,242,1
Igkv1-133,9,8,225,242,1
Sgsh,4,3,235,242,1
Igkj1,2,1,239,242,1
Ighv9-3,12,11,219,242,1
Stbd1,5,4,233,242,1
Gm17545,5,4,233,242,1
BC024139,4,3,235,242,1
Iglj1,2,1,239,242,1
Vmn1r33,3,2,237,242,1
Bank1,3,2,237,242,1
Barx2,4,3,235,242,1
Gm17087,32,31,179,242,1
Vmn1r34,3,2,237,242,1
Igkv8-24,8,7,227,242,1
Baz2b,3,2,237,242,1
Vmn1r32,3,2,237,242,1
Igkv4-57,4,3,235,242,1
Igkv5-43,7,6,229,242,1
Vmn1r3,3,2,237,242,1
Gm17364,1,0,241,242,1
Igkv4-80,5,4,233,242,1
Igkv4-59,5,4,233,242,1
Igkv4-57-1,6,5,231,242,1
Gm14226,9,8,225,242,1
Serpinb9e,3,2,237,242,1
Gm10670,1,0,241,242,1
Serpinb9d,6,5,231,242,1
Atp6ap2,7,6,229,242,1
Iyd,4,3,235,242,1
Serpina11,1,0,241,242,1
Atp6v0e2,3,2,237,242,1
Serpina1a,7,6,229,242,1
Gm11237,8,7,227,242,1
Atp6v1h,4,3,235,242,1
Ceacam1,8,7,227,242,1
Itgbl1,1,0,241,242,1
Vmn2r110,1,0,241,242,1
Atp8a1,6,5,231,242,1
Itgb5,6,5,231,242,1
Itgb3,4,3,235,242,1
Gm11555,1,0,241,242,1
Gm11559,1,0,241,242,1
Gm11099,1,0,241,242,1
Jag2,2,1,239,242,1
Vmn2r127,1,0,241,242,1
Kank2,7,6,229,242,1
Cela3a,2,1,239,242,1
Cela2a,7,6,229,242,1
Cecr2,4,3,235,242,1
Sema4f,1,0,241,242,1
Cebpz,3,2,237,242,1
Kantr,4,3,235,242,1
Sumo2,6,5,231,242,1
Sult2a6,1,0,241,242,1
Atp5b,4,3,235,242,1
Atp5e,2,1,239,242,1
Gm10961,12,11,219,242,1
Jph1,4,3,235,242,1
Jmjd6,4,3,235,242,1
Senp6,4,3,235,242,1
Itgb2l,1,0,241,242,1
Cdx2,1,0,241,242,1
Cdt1,7,6,229,242,1
Iqcf6,5,4,233,242,1
Iqsec3,1,0,241,242,1
Iqsec2,2,1,239,242,1
Vmn1r8,1,0,241,242,1
Iqgap2,3,2,237,242,1
Vmn1r79,1,0,241,242,1
Iqcm,1,0,241,242,1
AW551984,3,2,237,242,1
Gm12886,1,0,241,242,1
Iqcf4,1,0,241,242,1
AW822073,10,9,223,242,1
Serpinb5,5,4,233,242,1
Ipo4,6,5,231,242,1
Vmn1r77,2,1,239,242,1
Stx6,5,4,233,242,1
Serpinb11,3,2,237,242,1
Irf7,7,6,229,242,1
Atp8b1,2,1,239,242,1
Isx,1,0,241,242,1
Atp8b3,3,2,237,242,1
Gm11595,1,0,241,242,1
Vmn2r106,1,0,241,242,1
Itga7,5,4,233,242,1
Itga5,8,7,227,242,1
Gm11758,1,0,241,242,1
Gm12169,2,1,239,242,1
Aurkaip1,4,3,235,242,1
Atxn7l1,7,6,229,242,1
Tyr,11,10,221,242,1
Irx4,2,1,239,242,1
Irx2,10,9,223,242,1
Serpinb10,4,3,235,242,1
Vmn1r85,4,3,235,242,1
Trim30d,11,10,221,242,1
Snap91,1,0,241,242,1
Ntn1,3,2,237,242,1
Ppp1r1c,10,9,223,242,1
Olfr133,4,3,235,242,1
Olfr483,1,0,241,242,1
Eif1a,5,4,233,242,1
Dcn,7,6,229,242,1
Trav12-3,5,4,233,242,1
Dcp2,9,8,225,242,1
2310057N15Rik,1,0,241,242,1
Col6a5,1,0,241,242,1
Olfr1339,1,0,241,242,1
Pcdhgb6,4,3,235,242,1
Tmco1,4,3,235,242,1
Tmco2,6,5,231,242,1
Olfr134,1,0,241,242,1
4933434E20Rik,4,3,235,242,1
Csf3,14,13,215,242,1
Pcdhgb1,4,3,235,242,1
Olfr1342,1,0,241,242,1
Olfr1329,1,0,241,242,1
Pcgf2,3,2,237,242,1
Csf3r,7,6,229,242,1
Olfr911-ps1,1,0,241,242,1
Olfr494,1,0,241,242,1
Zfyve26,4,3,235,242,1
Pcsk1,3,2,237,242,1
Olfr888,1,0,241,242,1
2310030G06Rik,8,7,227,242,1
Pcnx3,3,2,237,242,1
Olfr1301,1,0,241,242,1
Tmbim1,4,3,235,242,1
Olfr492,1,0,241,242,1
Olfr1302,1,0,241,242,1
Olfr1317,2,1,239,242,1
Olfr91,4,3,235,242,1
Eif1ad16,10,9,223,242,1
Pclo,4,3,235,242,1
2310039H08Rik,4,3,235,242,1
Csf2ra,3,2,237,242,1
Olfr1323,1,0,241,242,1
Pcdhga8,7,6,229,242,1
Olfr917,1,0,241,242,1
Pcsk9,3,2,237,242,1
Trav12d-2,14,13,215,242,1
Commd1b,17,16,209,242,1
Zfp362,4,3,235,242,1
Drap1,5,4,233,242,1
Pcbp1,4,3,235,242,1
Olfr453,1,0,241,242,1
Cpn2,2,1,239,242,1
Olfr1402,2,1,239,242,1
Ppp2r2c,2,1,239,242,1
Olfr444,1,0,241,242,1
Ddi2,3,2,237,242,1
Depdc7,7,6,229,242,1
Pbsn,1,0,241,242,1
Commd9,2,1,239,242,1
Olfr1414,1,0,241,242,1
Tmed7,5,4,233,242,1
Drosha,3,2,237,242,1
Tmed8,4,3,235,242,1
Ppp1r3b,3,2,237,242,1
Olfr462,1,0,241,242,1
Tnnt3,10,9,223,242,1
Olfr1386,1,0,241,242,1
Dct,2,1,239,242,1
Zfp654,4,3,235,242,1
Pcdhga6,3,2,237,242,1
Olfr1357,1,0,241,242,1
Ppp1r32,11,10,221,242,1
Dpyd,9,8,225,242,1
Olfr92,4,3,235,242,1
Egflam,4,3,235,242,1
Olfr1361,1,0,241,242,1
Dpysl4,5,4,233,242,1
Cth,11,10,221,242,1
Zfp988,6,5,231,242,1
2610301B20Rik,5,4,233,242,1
Pcdhb17,1,0,241,242,1
Zfp983,6,5,231,242,1
Dqx1,7,6,229,242,1
Olfr463,1,0,241,242,1
Dpp6,3,2,237,242,1
Dpp4,4,3,235,242,1
Abcc1,6,5,231,242,1
Zmat1,6,5,231,242,1
Trav9d-2,10,9,223,242,1
Olfr845,3,2,237,242,1
Olfr1206,1,0,241,242,1
Crygc,8,7,227,242,1
Eif5,3,2,237,242,1
Pex12,7,6,229,242,1
Pou3f2,1,0,241,242,1
Psg21,4,3,235,242,1
Olfr857,3,2,237,242,1
Pou3f4,1,0,241,242,1
Pou5f1,6,5,231,242,1
Zic4,6,5,231,242,1
Olfr1225,1,0,241,242,1
Olfr531,1,0,241,242,1
Dalrd3,7,6,229,242,1
Olfr867,1,0,241,242,1
Olfr868,1,0,241,242,1
Daam1,2,1,239,242,1
Olfr120,2,1,239,242,1
Olfr124,1,0,241,242,1
A1bg,1,0,241,242,1
Olfr1181,1,0,241,242,1
Pgk2,1,0,241,242,1
Olfr555,1,0,241,242,1
Olfr1184,1,0,241,242,1
Zmiz1,3,2,237,242,1
D430041D05Rik,1,0,241,242,1
Pgd,3,2,237,242,1
Olfr1186,3,2,237,242,1
Tnfsf11,2,1,239,242,1
Dhx36,4,3,235,242,1
Olfr837,2,1,239,242,1
D630039A03Rik,5,4,233,242,1
Trav9-2,7,6,229,242,1
Pgam1,6,5,231,242,1
Elapor2,2,1,239,242,1
Tlr13,9,8,225,242,1
Pomp,5,4,233,242,1
Pdzph1,5,4,233,242,1
Traf3,5,4,233,242,1
Ppp1cc,5,4,233,242,1
Pdgfb,12,11,219,242,1
Olfr506,4,3,235,242,1
2210010C04Rik,3,2,237,242,1
Olfr1263,1,0,241,242,1
Tpst2,7,6,229,242,1
2210016F16Rik,3,2,237,242,1
Ppm1h,5,4,233,242,1
Olfr884,1,0,241,242,1
Pdcl3,9,8,225,242,1
Ppm1m,4,3,235,242,1
Ppox,5,4,233,242,1
Pdcd1lg2,3,2,237,242,1
Dcaf13,5,4,233,242,1
Olfr885,1,0,241,242,1
Ppp1ca,5,4,233,242,1
Pdcd1,2,1,239,242,1
Tprkb,3,2,237,242,1
Dcaf6,4,3,235,242,1
Trbc1,14,13,215,242,1
Eif2s3y,6,5,231,242,1
Olfr869,1,0,241,242,1
Tra2a,6,5,231,242,1
Tnip1,5,4,233,242,1
Olfr870,1,0,241,242,1
Pdx1,1,0,241,242,1
Pdrg1,7,6,229,242,1
Olfr1243,1,0,241,242,1
Olfr1248,1,0,241,242,1
Olfr1249,1,0,241,242,1
Ppfia4,1,0,241,242,1
Olfr52,5,4,233,242,1
Olfr519,1,0,241,242,1
Olfr517,1,0,241,242,1
Dhodh,6,5,231,242,1
Olfr873,2,1,239,242,1
Olfr878,1,0,241,242,1
Olfr1254,2,1,239,242,1
Ctsc,5,4,233,242,1
Olfr513,1,0,241,242,1
Olfr961,2,1,239,242,1
Cped1,6,5,231,242,1
Pglyrp1,14,13,215,242,1
Defa28,1,0,241,242,1
Oosp3,2,1,239,242,1
Zfp462,5,4,233,242,1
Coq8b,3,2,237,242,1
Csta1,9,8,225,242,1
Ovch2,1,0,241,242,1
Zfp423,1,0,241,242,1
Olfr211,1,0,241,242,1
E130308A19Rik,4,3,235,242,1
Coro6,11,10,221,242,1
Dusp12,9,8,225,242,1
Olfr214,1,0,241,242,1
Prps2,7,6,229,242,1
4930595M18Rik,1,0,241,242,1
Aak1,4,3,235,242,1
Prrg3,3,2,237,242,1
Olfr225,1,0,241,242,1
Trav14-1,3,2,237,242,1
Oxct2a,3,2,237,242,1
E2f5,4,3,235,242,1
Defb37,9,8,225,242,1
Defb46,1,0,241,242,1
Ear1,9,8,225,242,1
Omt2b,1,0,241,242,1
Duoxa2,4,3,235,242,1
Top1,3,2,237,242,1
Zfp831,1,0,241,242,1
Defb50,4,3,235,242,1
Aatf,4,3,235,242,1
Olfr382,1,0,241,242,1
P3h4,10,9,223,242,1
Olfr38,1,0,241,242,1
Pramel46,6,5,231,242,1
Prrx2,7,6,229,242,1
Zfp804b,1,0,241,242,1
A830031A19Rik,1,0,241,242,1
Zfp791,6,5,231,242,1
Oog2,2,1,239,242,1
Prrt2,8,7,227,242,1
Defb38,2,1,239,242,1
Oprk1,1,0,241,242,1
Prss16,9,8,225,242,1
Trbj1-6,1,0,241,242,1
Dusp5,7,6,229,242,1
Prr23a2,2,1,239,242,1
Dync2h1,3,2,237,242,1
Olfr329,5,4,233,242,1
Trbj2-1,1,0,241,242,1
Tmem198,8,7,227,242,1
Dync1h1,3,2,237,242,1
Olfr311,1,0,241,242,1
Defb15,2,1,239,242,1
Prex1,3,2,237,242,1
Trav14n-3,3,2,237,242,1
Olfr314,2,1,239,242,1
Prg3,1,0,241,242,1
Zfp446,3,2,237,242,1
Os9,3,2,237,242,1
Dxo,6,5,231,242,1
Defb22,4,3,235,242,1
Osgep,4,3,235,242,1
Prelid1,3,2,237,242,1
Olfr355,1,0,241,242,1
Prg4,10,9,223,242,1
Aagab,8,7,227,242,1
Prrc2b,6,5,231,242,1
Olfr248,1,0,241,242,1
Prdm6,13,12,217,242,1
Cst11,4,3,235,242,1
Defb34,2,1,239,242,1
Olfr270,1,0,241,242,1
Aadacl4fm5,4,3,235,242,1
Osr1,6,5,231,242,1
Olfr345,1,0,241,242,1
Defb1,12,11,219,242,1
Defb10,1,0,241,242,1
Dusp27,1,0,241,242,1
4931414P19Rik,4,3,235,242,1
Olfr292,1,0,241,242,1
Aadacl2,1,0,241,242,1
Dusp28,4,3,235,242,1
Olfr170,1,0,241,242,1
Pramel37,5,4,233,242,1
Tns2,3,2,237,242,1
Prss32,8,7,227,242,1
Olfr1446,1,0,241,242,1
Eef1akmt1,5,4,233,242,1
Pate10,1,0,241,242,1
Ddx17,5,4,233,242,1
4933411K16Rik,5,4,233,242,1
Ednra,3,2,237,242,1
Olfr1457,5,4,233,242,1
Dsg4,1,0,241,242,1
Olfr412,2,1,239,242,1
Dsp,3,2,237,242,1
Dspp,1,0,241,242,1
Olfr146,1,0,241,242,1
Olfr411,1,0,241,242,1
Pramel11,1,0,241,242,1
Dstn,6,5,231,242,1
Olfr406,1,0,241,242,1
Olfr1465,1,0,241,242,1
Eef1akmt3,6,5,231,242,1
Tob2,4,3,235,242,1
Dennd1c,4,3,235,242,1
Olfr968,2,1,239,242,1
Olfr434,1,0,241,242,1
Olfr1427,1,0,241,242,1
Olfr965,1,0,241,242,1
Tmem114,5,4,233,242,1
Abcb6,4,3,235,242,1
Zfp503,6,5,231,242,1
Trav13-1,8,7,227,242,1
Dscaml1,1,0,241,242,1
Tmem234,4,3,235,242,1
Dennd5b,5,4,233,242,1
Olfr1434,1,0,241,242,1
Olfr1436,1,0,241,242,1
Csk,4,3,235,242,1
Ppp6c,4,3,235,242,1
Prss35,6,5,231,242,1
Pate14,11,10,221,242,1
Olfr430,1,0,241,242,1
Abca4,2,1,239,242,1
Trbv21,2,1,239,242,1
Olfr166,1,0,241,242,1
Pramel23,1,0,241,242,1
Cpa2,4,3,235,242,1
Pramel26,1,0,241,242,1
Coq10b,5,4,233,242,1
Olig2,2,1,239,242,1
Tmem138,5,4,233,242,1
Olfr1535,4,3,235,242,1
Topors,3,2,237,242,1
Ebp,9,8,225,242,1
Olfr385,1,0,241,242,1
Olfr156,1,0,241,242,1
Cp,7,6,229,242,1
Pakap,4,3,235,242,1
Olig3,3,2,237,242,1
Zfp683,1,0,241,242,1
Paip2,3,2,237,242,1
Abca1,5,4,233,242,1
Tmem145,3,2,237,242,1
Olfr390,1,0,241,242,1
Cpa5,1,0,241,242,1
Olfr985,3,2,237,242,1
Olfr1506,1,0,241,242,1
Trbj1-2,1,0,241,242,1
Pard6a,3,2,237,242,1
Olfr1477,1,0,241,242,1
Pard3b,3,2,237,242,1
Prss30,9,8,225,242,1
Tmem222,6,5,231,242,1
Paqr9,3,2,237,242,1
Olfr987,1,0,241,242,1
Pramel15,1,0,241,242,1
Pramel16,2,1,239,242,1
Olfr1495,1,0,241,242,1
Olfr1496,1,0,241,242,1
Pramel17,1,0,241,242,1
Ddx41,3,2,237,242,1
Olfr992,1,0,241,242,1
Olfr1504,1,0,241,242,1
Dtwd1,5,4,233,242,1
Traj17,1,0,241,242,1
Eif3j2,6,5,231,242,1
Zfp710,5,4,233,242,1
Pnkp,12,11,219,242,1
Cyp3a57,2,1,239,242,1
Cntnap1,4,3,235,242,1
Olfr1046,1,0,241,242,1
Olfr791,1,0,241,242,1
Enpp3,4,3,235,242,1
Cyp3a41b,6,5,231,242,1
Olfr1042,1,0,241,242,1
Plcb1,4,3,235,242,1
Dkk2,3,2,237,242,1
Olfr104-ps,4,3,235,242,1
Ache,18,17,207,242,1
Olfr603,1,0,241,242,1
Erbb3,3,2,237,242,1
Pip,4,3,235,242,1
Nxt2,8,7,227,242,1
Cyp2a12,1,0,241,242,1
Tril,5,4,233,242,1
Olfr1034,1,0,241,242,1
Cyp2a22,1,0,241,242,1
Olfr661,1,0,241,242,1
Dmgdh,3,2,237,242,1
Trim25,5,4,233,242,1
Cyp2a5,6,5,231,242,1
Prokr1,4,3,235,242,1
Olfr1026,1,0,241,242,1
Traj38,1,0,241,242,1
Nxph4,7,6,229,242,1
Plscr4,6,5,231,242,1
Cyp3a59,1,0,241,242,1
Pnn,6,5,231,242,1
Tmem52b,4,3,235,242,1
Pik3ap1,1,0,241,242,1
Cyp51,4,3,235,242,1
Cyp4v3,6,5,231,242,1
Traj42,1,0,241,242,1
Dipk2a,5,4,233,242,1
Traj29,4,3,235,242,1
Prl,13,12,217,242,1
Olfr583,1,0,241,242,1
Pld4,12,11,219,242,1
Ptger4,5,4,233,242,1
Endod1,6,5,231,242,1
1600012H06Rik,4,3,235,242,1
Tmem98,2,1,239,242,1
Thsd4,1,0,241,242,1
Zfp119a,8,7,227,242,1
Ackr4,6,5,231,242,1
Piezo1,5,4,233,242,1
Cyp26b1,11,10,221,242,1
Olfr59,1,0,241,242,1
Olfr714,4,3,235,242,1
Pnrc1,6,5,231,242,1
Olfr665,1,0,241,242,1
Ercc1,4,3,235,242,1
Pnpla8,6,5,231,242,1
Cyp4a29,2,1,239,242,1
Cul7,5,4,233,242,1
Olfr1061,1,0,241,242,1
Nutf2,8,7,227,242,1
Olfr65,1,0,241,242,1
Dmbt1,3,2,237,242,1
Olfr1099,1,0,241,242,1
Psors1c2,15,14,213,242,1
Acadl,7,6,229,242,1
Epop,6,5,231,242,1
Ogfod2,3,2,237,242,1
Prlh,8,7,227,242,1
Epo,4,3,235,242,1
Tmem69,4,3,235,242,1
Trav6d-7,10,9,223,242,1
9930021J03Rik,6,5,231,242,1
Odf4,4,3,235,242,1
Olfr632,1,0,241,242,1
Cnp,8,7,227,242,1
Creb3l3,12,11,219,242,1
Epn2,4,3,235,242,1
Timm17a,5,4,233,242,1
9530053A07Rik,2,1,239,242,1
Creb3,5,4,233,242,1
Tmem74b,2,1,239,242,1
Dnajc12,10,9,223,242,1
Ocln,6,5,231,242,1
Obp1b,1,0,241,242,1
Obox2,1,0,241,242,1
Tmem74bos,2,1,239,242,1
Ephb6,8,7,227,242,1
Pla2g2a,2,1,239,242,1
Olfr74,1,0,241,242,1
Tigit,15,14,213,242,1
Ephx2,6,5,231,242,1
Ephx4,8,7,227,242,1
Psmd12,5,4,233,242,1
Crebbp,6,5,231,242,1
Cyp2c68,4,3,235,242,1
Cyp2c69,2,1,239,242,1
Cyp2b9,1,0,241,242,1
Nyx,2,1,239,242,1
Tmem63b,5,4,233,242,1
Dmac2l,8,7,227,242,1
Crtac1,3,2,237,242,1
Pkd1l1,1,0,241,242,1
Olfr728,1,0,241,242,1
Cyp2j11,4,3,235,242,1
Prlhr,2,1,239,242,1
Ep300,4,3,235,242,1
Pkhd1,3,2,237,242,1
Oas1d,2,1,239,242,1
Ace,2,1,239,242,1
Tmem65,5,4,233,242,1
Olfr763,1,0,241,242,1
Oas1g,12,11,219,242,1
Olfr10,1,0,241,242,1
Trav6d-5,4,3,235,242,1
Dnajb6,6,5,231,242,1
Pkm,5,4,233,242,1
Acad11,3,2,237,242,1
Timm29,2,1,239,242,1
Traj7,1,0,241,242,1
Cyp2d34,1,0,241,242,1
Pkp3,6,5,231,242,1
Traj59,1,0,241,242,1
Zfp616,2,1,239,242,1
Olfr1098,1,0,241,242,1
Pten,3,2,237,242,1
Emp3,5,4,233,242,1
Ptk2b,4,3,235,242,1
Trgv3,3,2,237,242,1
Prnd,13,12,217,242,1
Elp2,2,1,239,242,1
Olfr564,1,0,241,242,1
Pgpep1l,12,11,219,242,1
Traj23,6,5,231,242,1
Olfr68,1,0,241,242,1
Nudt13,6,5,231,242,1
Acot3,4,3,235,242,1
Olfr1135,1,0,241,242,1
Olfr57,8,7,227,242,1
Cytip,5,4,233,242,1
Acot2,4,3,235,242,1
Acot13,8,7,227,242,1
Cryba2,11,10,221,242,1
Phax,7,6,229,242,1
Coa6,5,4,233,242,1
Tmem39a,7,6,229,242,1
Olfr1132,1,0,241,242,1
Dio2,2,1,239,242,1
Trav6-1,5,4,233,242,1
Cyth1,6,5,231,242,1
Nudt16l2,1,0,241,242,1
Plk4,6,5,231,242,1
Olfr1129,4,3,235,242,1
Ctxn2,8,7,227,242,1
Cracdl,2,1,239,242,1
Pgpep1,10,9,223,242,1
Olfr1148,1,0,241,242,1
Olfr814,3,2,237,242,1
Traj20,1,0,241,242,1
Dock4,2,1,239,242,1
Cybc1,6,5,231,242,1
Tlk2,5,4,233,242,1
Olfr830,1,0,241,242,1
Tle7,2,1,239,242,1
Dock3,15,14,213,242,1
Tmprss12,6,5,231,242,1
Trav7-3,4,3,235,242,1
Pgm2l1,1,0,241,242,1
Pgm3,6,5,231,242,1
Tnfrsf26,8,7,227,242,1
Prnp,5,4,233,242,1
Ntrk1,3,2,237,242,1
Olfr1160,6,5,231,242,1
D13Ertd608e,17,16,209,242,1
Olfr116,2,1,239,242,1
Cyct,14,13,215,242,1
A030003K21Rik,4,3,235,242,1
Crisp3,4,3,235,242,1
Traj45,1,0,241,242,1
Psma4,8,7,227,242,1
Olfr821,1,0,241,242,1
Olfr1154,1,0,241,242,1
Zzef1,2,1,239,242,1
Olfr680-ps1,1,0,241,242,1
1700069L16Rik,8,7,227,242,1
Nudc,5,4,233,242,1
Olfr695,1,0,241,242,1
Pla2g2d,7,6,229,242,1
Cubn,2,1,239,242,1
Cypt12,6,5,231,242,1
Dnm3,5,4,233,242,1
Olfr67,1,0,241,242,1
Phkg2,5,4,233,242,1
Phlpp1,5,4,233,242,1
Trav6-3,3,2,237,242,1
Phldb1,3,2,237,242,1
Nufip2,8,7,227,242,1
Traj49,1,0,241,242,1
Cyp7b1,2,1,239,242,1
Tmod1,7,6,229,242,1
Cuedc1,5,4,233,242,1
Cypt1,9,8,225,242,1
Coasy,4,3,235,242,1
Crhr2,1,0,241,242,1
Olfr1107,1,0,241,242,1
Dnmt1,2,1,239,242,1
Olfr1105,2,1,239,242,1
Prmt8,1,0,241,242,1
Cyp17a1,5,4,233,242,1
Coa8,5,4,233,242,1
Plekhb1,6,5,231,242,1
1110032F04Rik,4,3,235,242,1
Zxdb,5,4,233,242,1
Eml5,5,4,233,242,1
Dnmt3c,2,1,239,242,1
Polm,6,5,231,242,1
Olfr813,1,0,241,242,1
Emp1,8,7,227,242,1
Olfr11,3,2,237,242,1
Zfp60,5,4,233,242,1
Ergic1,4,3,235,242,1
Vmn1r248,0,0,242,242,0
Prmt3,5,5,232,242,0
Olfr738,0,0,242,242,0
Olfr730,1,1,240,242,0
Opn5,1,1,240,242,0
Bdkrb1,9,9,224,242,0
Vmn1r242,0,0,242,242,0
Olfr706,0,0,242,242,0
Vmn1r247,0,0,242,242,0
Bdnf,2,2,238,242,0
Vmn1r243,0,0,242,242,0
Kcna2,3,3,236,242,0
Oog3,0,0,242,242,0
Olfr705,1,1,240,242,0
Vmn1r246,0,0,242,242,0
Vmn1r221,0,0,242,242,0
Vmn1r245,0,0,242,242,0
Olfr732,0,0,242,242,0
Atp6ap1l,8,8,226,242,0
Kansl1,2,2,238,242,0
Prickle4,23,23,196,242,0
Olfr707,0,0,242,242,0
Kcna4,0,0,242,242,0
Oplah,4,4,234,242,0
4932438A13Rik,3,3,236,242,0
Ighv1-71,3,3,236,242,0
Vmn1r232,0,0,242,242,0
Prm2,11,11,220,242,0
Olfr69,0,0,242,242,0
Sh3bgrl3,7,7,228,242,0
Ighv1-50,4,4,234,242,0
Olfr711,0,0,242,242,0
Olfr988,1,1,240,242,0
Vmn2r16,0,0,242,242,0
Serinc1,5,5,232,242,0
Ighv5-12,4,4,234,242,0
Zfp600,13,13,216,242,0
Bdh1,3,3,236,242,0
Bcr,4,4,234,242,0
Vmn1r230,0,0,242,242,0
Olfr693,0,0,242,242,0
Olfr725,0,0,242,242,0
Vmn1r239-ps,0,0,242,242,0
Jmjd8,4,4,234,242,0
Ighv8-9,2,2,238,242,0
Olfr724,0,0,242,242,0
4933402J07Rik,1,1,240,242,0
Omp,7,7,228,242,0
Senp3,3,3,236,242,0
Bcas3,4,4,234,242,0
Olfr723,0,0,242,242,0
Atp5g1,3,3,236,242,0
Vmn1r23,0,0,242,242,0
Ighv8-13,3,3,236,242,0
Prh1,3,3,236,242,0
Ighv1-9,8,8,226,242,0
Olfr694,0,0,242,242,0
Ighv6-7,1,1,240,242,0
Prickle2,1,1,240,242,0
Sema4d,6,6,230,242,0
Atp5d,2,2,238,242,0
Sema6d,5,5,232,242,0
Kazald1,5,5,232,242,0
Septin1,11,11,220,242,0
Jaml,8,8,226,242,0
Bcar1,3,3,236,242,0
Zfp677,6,6,230,242,0
Vmn1r241,1,1,240,242,0
Orc4,6,6,230,242,0
Bcorl1,5,5,232,242,0
Olfr722,0,0,242,242,0
Olfr994,0,0,242,242,0
Serbp1,6,6,230,242,0
Kalrn,7,7,228,242,0
Olfr996,0,0,242,242,0
Vmn1r238,1,1,240,242,0
Igkv1-122,7,7,228,242,0
Olfr721-ps1,1,1,240,242,0
Atp5mpl,6,6,230,242,0
Selenow,3,3,236,242,0
Olfr998,0,0,242,242,0
Bcar3,7,7,228,242,0
Bckdk,3,3,236,242,0
Oprm1,3,3,236,242,0
Vmn2r128,0,0,242,242,0
Olfr726,0,0,242,242,0
Vmn1r240,0,0,242,242,0
Jakmip3,0,0,242,242,0
Atp2b2,1,1,240,242,0
Ip6k2,5,5,232,242,0
Iws1,4,4,234,242,0
Sf3b4,4,4,234,242,0
Olfr887,2,2,238,242,0
Prkx,7,7,228,242,0
Il24,6,6,230,242,0
B430305J03Rik,9,9,224,242,0
Vmn1r64,0,0,242,242,0
B3gnt7,7,7,228,242,0
Olfr883,0,0,242,242,0
B3gat3,5,5,232,242,0
Olfr811,0,0,242,242,0
Avl9,8,8,226,242,0
Olfr812,0,0,242,242,0
Vmn1r67,0,0,242,242,0
Vmn1r82,1,1,240,242,0
B3gat1,2,2,238,242,0
Vmn1r68,2,2,238,242,0
Olfr881,0,0,242,242,0
Sf3b1,3,3,236,242,0
Irf1,5,5,232,242,0
Il20,2,2,238,242,0
Irgq,5,5,232,242,0
Serpina9,6,6,230,242,0
Vmn1r91,0,0,242,242,0
Atrx,5,5,232,242,0
Olfr8,0,0,242,242,0
Il17b,13,13,216,242,0
Olfr910,0,0,242,242,0
Olfr800,0,0,242,242,0
Olfr801,0,0,242,242,0
Olfr803,9,9,224,242,0
Olfr805,0,0,242,242,0
Olfr807,0,0,242,242,0
Iscu,5,5,232,242,0
Zfp648,1,1,240,242,0
B4galt7,4,4,234,242,0
5430402E10Rik,4,4,234,242,0
Olfr902,0,0,242,242,0
Prkd2,2,2,238,242,0
Vmn1r94,0,0,242,242,0
Olfr895,0,0,242,242,0
Serpinb12,2,2,238,242,0
Zfp64,4,4,234,242,0
Vmn1r249,0,0,242,242,0
Ints3,3,3,236,242,0
Serpinb3b,0,0,242,242,0
Azi2,5,5,232,242,0
Olfr820,0,0,242,242,0
Azgp1,6,6,230,242,0
Insrr,3,3,236,242,0
Serpinc1,16,16,210,242,0
Olfr823,0,0,242,242,0
Serpinb9h,8,8,226,242,0
Olfr844,0,0,242,242,0
Olfr871,0,0,242,242,0
Vmn1r78,0,0,242,242,0
Ints6,5,5,232,242,0
Iqcb1,4,4,234,242,0
Olfr826,0,0,242,242,0
Olfr828,0,0,242,242,0
Axdnd1,14,14,214,242,0
Olfr835,0,0,242,242,0
Axin2,5,5,232,242,0
Olfr849,0,0,242,242,0
Olfr850,0,0,242,242,0
B020011L13Rik,0,0,242,242,0
Olfr851,1,1,240,242,0
Irak1,8,8,226,242,0
Irag1,3,3,236,242,0
Bend6,4,4,234,242,0
Ilk,3,3,236,242,0
Vmn1r7,0,0,242,242,0
Iqsec1,5,5,232,242,0
Set,4,4,234,242,0
Olfr815,0,0,242,242,0
Ing3,8,8,226,242,0
Sertm1,3,3,236,242,0
Olfr866,0,0,242,242,0
Iqgap1,2,2,238,242,0
Olfr818,0,0,242,242,0
Olfr819,0,0,242,242,0
Sertad4,4,4,234,242,0
Olfr855,0,0,242,242,0
Olfr854,0,0,242,242,0
Isoc2a,3,3,236,242,0
Olfr799,1,1,240,242,0
Bace1,7,7,228,242,0
Olfr958,0,0,242,242,0
Olfr963,0,0,242,242,0
Igkv4-86,8,8,226,242,0
Olfr764-ps1,0,0,242,242,0
Olfr766-ps1,0,0,242,242,0
Olfr960,0,0,242,242,0
Prl5a1,1,1,240,242,0
Prl4a1,2,2,238,242,0
Ints9,3,3,236,242,0
Sgip1,7,7,228,242,0
Olfr913,0,0,242,242,0
Itgb6,6,6,230,242,0
Olfr955,0,0,242,242,0
BB014433,2,2,238,242,0
Olfr952,0,0,242,242,0
Sgcz,1,1,240,242,0
Olfr951,0,0,242,242,0
Olfr948,1,1,240,242,0
Olfr770,0,0,242,242,0
Vmn1r27,2,2,238,242,0
Igkv4-61,8,8,226,242,0
Olfr76,1,1,240,242,0
Vmn2r113,0,0,242,242,0
Igkv17-127,10,10,222,242,0
Olfr741,0,0,242,242,0
Olfr746,0,0,242,242,0
BC031181,4,4,234,242,0
Igkv3-1,5,5,232,242,0
Igkv3-10,7,7,228,242,0
Serpina16,1,1,240,242,0
BC025920,5,5,232,242,0
Olfr978,1,1,240,242,0
Igkv3-7,4,4,234,242,0
Olfr974,0,0,242,242,0
Olfr971,0,0,242,242,0
Olfr969,0,0,242,242,0
Olfr747,0,0,242,242,0
Atp6v1e2,5,5,232,242,0
Vmn1r258,0,0,242,242,0
Itih5,4,4,234,242,0
Olfr771,0,0,242,242,0
Olfr772,0,0,242,242,0
Olfr944,0,0,242,242,0
Olfr924,0,0,242,242,0
Igsf5,5,5,232,242,0
Vmn2r105,0,0,242,242,0
Vmn2r104,0,0,242,242,0
Olfr923,0,0,242,242,0
Itga8,3,3,236,242,0
Baiap2,3,3,236,242,0
Bahd1,5,5,232,242,0
Vmn2r103,0,0,242,242,0
4933428G20Rik,3,3,236,242,0
Olfr792,1,1,240,242,0
Itga3,5,5,232,242,0
Vmn1r49,1,1,240,242,0
Vmn2r101,0,0,242,242,0
Itga1,2,2,238,242,0
Itfg2,5,5,232,242,0
Serpina3j,1,1,240,242,0
Bach1,6,6,230,242,0
Olfr786,2,2,238,242,0
Vmn1r41,3,3,236,242,0
Olfr773,1,1,240,242,0
Sfxn3,7,7,228,242,0
Olfr936,1,1,240,242,0
Vmn1r36,0,0,242,242,0
Zfp618,4,4,234,242,0
Olfr934,0,0,242,242,0
Olfr776,0,0,242,242,0
Iglc4,3,3,236,242,0
Olfr93,21,21,200,242,0
Iglj2,0,0,242,242,0
Iglj3,0,0,242,242,0
Iglj3p,0,0,242,242,0
Iglj4,0,0,242,242,0
Olfr777,0,0,242,242,0
Itgb1bp1,6,6,230,242,0
Itgb1,6,6,230,242,0
Olfr926,0,0,242,242,0
Olfr779,0,0,242,242,0
Olfr781,0,0,242,242,0
Bbs1,2,2,238,242,0
Six3,2,2,238,242,0
Prf1,7,7,228,242,0
Ighv1-31,4,4,234,242,0
Slc45a2,4,4,234,242,0
Phyhd1,6,6,230,242,0
1700031F05Rik,1,1,240,242,0
Car13,6,6,230,242,0
Grhl2,3,3,236,242,0
Grhl3,2,2,238,242,0
Gria1,2,2,238,242,0
Phldb2,6,6,230,242,0
Grik4,3,3,236,242,0
Zmynd11,4,4,234,242,0
Poli,3,3,236,242,0
Uts2r,3,3,236,242,0
Grxcr2,0,0,242,242,0
Gsc2,4,4,234,242,0
Gsdmc4,9,9,224,242,0
1700049E17Rik2,20,20,202,242,0
Phf24,11,11,220,242,0
Phf13,3,3,236,242,0
Phf11d,7,7,228,242,0
Gsk3b,4,4,234,242,0
Gspt1,3,3,236,242,0
Gspt2,3,3,236,242,0
Polr1h,5,5,232,242,0
Phactr1,11,11,220,242,0
Capn2,3,3,236,242,0
Slc45a3,8,8,226,242,0
Gpx6,6,6,230,242,0
Pold2,3,3,236,242,0
Slc4a9,2,2,238,242,0
1700020N01Rik,5,5,232,242,0
Pnlip,2,2,238,242,0
Znrf2,6,6,230,242,0
Pnliprp2,1,1,240,242,0
Pnma3,0,0,242,242,0
Slc5a10,6,6,230,242,0
Gpr22,2,2,238,242,0
Pnmal1,1,1,240,242,0
Pik3c2g,3,3,236,242,0
Pnpla5,0,0,242,242,0
Casp4,12,12,218,242,0
Slc4a7,3,3,236,242,0
Car9,10,10,222,242,0
Pigl,5,5,232,242,0
Gpr68,5,5,232,242,0
Pigc,6,6,230,242,0
Podn,5,5,232,242,0
Podxl,4,4,234,242,0
Podxl2,4,4,234,242,0
Pof1b,1,1,240,242,0
Slc4a11,6,6,230,242,0
Pola1,4,4,234,242,0
Card11,4,4,234,242,0
Card10,5,5,232,242,0
Pgs1,2,2,238,242,0
Pgr,2,2,238,242,0
Vamp4,4,4,234,242,0
Zkscan14,4,4,234,242,0
Slc2a9,8,8,226,242,0
Pfkfb3,3,3,236,242,0
Gzmn,1,1,240,242,0
Pon1,4,4,234,242,0
Pon3,6,6,230,242,0
H1f7,0,0,242,242,0
Postn,7,7,228,242,0
Calr,3,3,236,242,0
H2-DMb1,3,3,236,242,0
Pex3,4,4,234,242,0
H2-Eb2,1,1,240,242,0
Pou2af1,1,1,240,242,0
Pfpl,0,0,242,242,0
Slc2a1,5,5,232,242,0
Calm4,4,4,234,242,0
H2-M11,1,1,240,242,0
Vav1,3,3,236,242,0
Peg12,8,8,226,242,0
H2-Q7,6,6,230,242,0
Calcoco1,3,3,236,242,0
Pea15a,8,8,226,242,0
1810030O07Rik,4,4,234,242,0
1810037I17Rik,4,4,234,242,0
Pdzd11,8,8,226,242,0
Gzmg,1,1,240,242,0
Gzme,0,0,242,242,0
Capn11,11,11,220,242,0
Slc35c1,7,7,228,242,0
Capn10,3,3,236,242,0
Zmiz2,3,3,236,242,0
Gtf2a1,7,7,228,242,0
Gtf2a2,4,4,234,242,0
Slc35f4,5,5,232,242,0
Gtf2h1,3,3,236,242,0
Camsap3,7,7,228,242,0
Slc35e3,5,5,232,242,0
Gtf3a,4,4,234,242,0
Vars2,5,5,232,242,0
Slc35d2,12,12,218,242,0
Pglyrp3,6,6,230,242,0
Pomgnt2,9,9,224,242,0
Slc35b1,4,4,234,242,0
Slc35a2,6,6,230,242,0
Slc34a3,9,9,224,242,0
Caml,2,2,238,242,0
Gucy1a1,5,5,232,242,0
Gucy2d,2,2,238,242,0
Gucy2f,1,1,240,242,0
Pgap1,4,4,234,242,0
Pgam5,4,4,234,242,0
Gyg,9,9,224,242,0
Slc30a4,6,6,230,242,0
Gpr161,3,3,236,242,0
Slc5a4a,1,1,240,242,0
Castor1,5,5,232,242,0
Plppr5,0,0,242,242,0
Gm7903,0,0,242,242,0
Smim26,9,9,224,242,0
Plch1,2,2,238,242,0
Smim10l2a,4,4,234,242,0
Smim10l1,5,5,232,242,0
Plcg2,2,2,238,242,0
Plppr1,2,2,238,242,0
Smco1,6,6,230,242,0
Smc1b,8,8,226,242,0
Gm8257,8,8,226,242,0
Smarca1,6,6,230,242,0
Ccdc125,6,6,230,242,0
1300017J02Rik,23,23,196,242,0
Gm8797,14,14,214,242,0
1700001O22Rik,2,2,238,242,0
Gm8978,0,0,242,242,0
Slpi,20,20,202,242,0
1700001P01Rik,23,23,196,242,0
Gm9045,7,7,228,242,0
Gm9046,2,2,238,242,0
Ush1c,3,3,236,242,0
Gm9195,0,0,242,242,0
Gm9508,0,0,242,242,0
Plscr5,3,3,236,242,0
1500011B03Rik,10,10,222,242,0
Gm773,6,6,230,242,0
Plaat3,7,7,228,242,0
Smpx,3,3,236,242,0
Upk1b,3,3,236,242,0
Plin1,9,9,224,242,0
Snap23,3,3,236,242,0
0610010K14Rik,6,6,230,242,0
Plekhs1,5,5,232,242,0
Upk3b,4,4,234,242,0
Gm6205,0,0,242,242,0
Gm6367,0,0,242,242,0
Smtn,3,3,236,242,0
Ccdc163,6,6,230,242,0
0610040J01Rik,7,7,228,242,0
Smpd2,3,3,236,242,0
Zswim9,12,12,218,242,0
Ccdc157,2,2,238,242,0
1110002E22Rik,0,0,242,242,0
Plekhg3,5,5,232,242,0
Gm6993,0,0,242,242,0
Plod2,5,5,232,242,0
Gm7145,0,0,242,242,0
Gm7271,11,11,220,242,0
Gm7298,0,0,242,242,0
Gm7358,5,5,232,242,0
Uqcrq,4,4,234,242,0
Urad,1,1,240,242,0
Plaat5,3,3,236,242,0
Ush2a,12,12,218,242,0
Zp2,0,0,242,242,0
Gpld1,4,4,234,242,0
Gp2,4,4,234,242,0
Gp6,4,4,234,242,0
Pla1a,5,5,232,242,0
Gpatch8,4,4,234,242,0
Cav2,7,7,228,242,0
Gpc6,4,4,234,242,0
Slc6a3,1,1,240,242,0
Usp37,7,7,228,242,0
Usp38,2,2,238,242,0
Gpi1,3,3,236,242,0
Pkdcc,6,6,230,242,0
Pmepa1,5,5,232,242,0
Slc7a6os,3,3,236,242,0
Pja1,3,3,236,242,0
Pitx3,7,7,228,242,0
Gpr101,0,0,242,242,0
Gpr119,2,2,238,242,0
Cat,6,6,230,242,0
Pitx1,2,2,238,242,0
Pirt,2,2,238,242,0
Pira2,6,6,230,242,0
Casz1,3,3,236,242,0
Gpr149,1,1,240,242,0
Castor2,3,3,236,242,0
Slc7a4,6,6,230,242,0
Gorab,3,3,236,242,0
Plvap,6,6,230,242,0
1700012A03Rik,0,0,242,242,0
Zscan4f,5,5,232,242,0
Slfnl1,6,6,230,242,0
1700008P02Rik,0,0,242,242,0
Usp13,5,5,232,242,0
Gmeb1,3,3,236,242,0
Pla2g4f,3,3,236,242,0
Zscan4-ps3,2,2,238,242,0
Cby2,0,0,242,242,0
Slco4a1,10,10,222,242,0
Usp18,10,10,222,242,0
Plxna1,5,5,232,242,0
Gnb2,2,2,238,242,0
Golt1b,4,4,234,242,0
Cbx4,5,5,232,242,0
Slc9b2,2,2,238,242,0
Gng11,12,12,218,242,0
Cbx1,2,2,238,242,0
Gng5,4,4,234,242,0
Slc9a3r1,3,3,236,242,0
Cbs,8,8,226,242,0
Gnrhr,3,3,236,242,0
Plxna4,5,5,232,242,0
Golga4,4,4,234,242,0
Golph3,5,5,232,242,0
Cadm2,4,4,234,242,0
Slc26a7,6,6,230,242,0
Vcpkmt,4,4,234,242,0
Htr2b,8,8,226,242,0
Bri3,5,5,232,242,0
Vmn1r176,0,0,242,242,0
4930404H24Rik,19,19,204,242,0
Papola,5,5,232,242,0
Sik1,5,5,232,242,0
Hspbp1,5,5,232,242,0
Bpnt1,6,6,230,242,0
Pramel21,1,1,240,242,0
Bpifb9a,0,0,242,242,0
Htr1a,0,0,242,242,0
Pramel22,0,0,242,242,0
Bpifb4,3,3,236,242,0
Hsf3,1,1,240,242,0
Pan3,3,3,236,242,0
Htr5a,0,0,242,242,0
Pramel25,0,0,242,242,0
Bpifb1,2,2,238,242,0
Hyal1,4,4,234,242,0
Hyal3,4,4,234,242,0
Bpifa3,1,1,240,242,0
Pramel27,0,0,242,242,0
Hyou1,4,4,234,242,0
Zfp92,4,4,234,242,0
Pafah1b1,4,4,234,242,0
Sipa1l1,2,2,238,242,0
Vmn1r172,0,0,242,242,0
Ibsp,7,7,228,242,0
Hrh1,6,6,230,242,0
Hoxd11,7,7,228,242,0
Vmn1r15,10,10,222,242,0
Vmn1r151,0,0,242,242,0
Ppp6r1,3,3,236,242,0
Vmn1r152,0,0,242,242,0
Skint2,4,4,234,242,0
Pate11,2,2,238,242,0
Vmn1r159,0,0,242,242,0
Parvb,6,6,230,242,0
Ppt1,4,4,234,242,0
Zfp955b,5,5,232,242,0
Praf2,4,4,234,242,0
Vmn1r170,0,0,242,242,0
Vmn1r167,0,0,242,242,0
Olfr689,0,0,242,242,0
Brs3,0,0,242,242,0
Pramel1,0,0,242,242,0
Sis,0,0,242,242,0
Hs3st6,3,3,236,242,0
Brox,5,5,232,242,0
4921536K21Rik,0,0,242,242,0
Hsd17b12,5,5,232,242,0
Hsd17b13,4,4,234,242,0
Pramel14,2,2,238,242,0
Pramel35,0,0,242,242,0
Vmn1r188,0,0,242,242,0
Btbd19,4,4,234,242,0
Ighd3-1,0,0,242,242,0
Otof,0,0,242,242,0
Prdx1,8,8,226,242,0
Vmn1r205,0,0,242,242,0
Igf2bp2,5,5,232,242,0
Osmr,5,5,232,242,0
Ighd1-1,0,0,242,242,0
Ighd2-3,0,0,242,242,0
Ighd2-4,0,0,242,242,0
Ighd2-6,0,0,242,242,0
Ighd2-7,0,0,242,242,0
Ighd2-8,0,0,242,242,0
Ighd3-2,0,0,242,242,0
Otol1,0,0,242,242,0
Ighd4-1,0,0,242,242,0
Ighd5-5,0,0,242,242,0
Ighd5-6,0,0,242,242,0
Ighd5-7,0,0,242,242,0
Ighd5-8,0,0,242,242,0
Zfp729a,4,4,234,242,0
Ighj2,2,2,238,242,0
Ighj4,1,1,240,242,0
Vmn1r212,0,0,242,242,0
Osbpl6,2,2,238,242,0
Ighv1-24,0,0,242,242,0
Birc7,0,0,242,242,0
Vmn1r201,3,3,236,242,0
Vmn1r189,0,0,242,242,0
Shisa2,1,1,240,242,0
Id4,4,4,234,242,0
P4hb,4,4,234,242,0
P4ha3,7,7,228,242,0
4930544G11Rik,7,7,228,242,0
Pramel44,3,3,236,242,0
Zfp804a,0,0,242,242,0
Ifi213,5,5,232,242,0
Pramel48,0,0,242,242,0
Pramex1,0,0,242,242,0
Prap1,16,16,210,242,0
Prb1,0,0,242,242,0
Ifih1,5,5,232,242,0
Vmn1r200,0,0,242,242,0
Bmp6,4,4,234,242,0
Vmn1r196,0,0,242,242,0
Prcc,3,3,236,242,0
Ifna12,1,1,240,242,0
Ifna13,2,2,238,242,0
Zfp777,5,5,232,242,0
Ifna16,3,3,236,242,0
Otp,1,1,240,242,0
Otor,5,5,232,242,0
Ifnk,7,7,228,242,0
Ifnlr1,2,2,238,242,0
Vmn1r149,0,0,242,242,0
Vmn1r143,0,0,242,242,0
H2al1j,1,1,240,242,0
Ppp1r1a,5,5,232,242,0
C1ra,5,5,232,242,0
Hcn2,3,3,236,242,0
Vmn1r10,0,0,242,242,0
Hcrtr2,3,3,236,242,0
Slc22a7,4,4,234,242,0
Pcna,4,4,234,242,0
2310034C09Rik,2,2,238,242,0
Vmn1r101,0,0,242,242,0
Hdac9,2,2,238,242,0
Ppp1r16a,2,2,238,242,0
Hdc,5,5,232,242,0
2310050C09Rik,0,0,242,242,0
Pcyt2,6,6,230,242,0
C1ql1,5,5,232,242,0
Hdx,2,2,238,242,0
Vmn1r103,0,0,242,242,0
Vmn1r104,0,0,242,242,0
Hectd2,3,3,236,242,0
Hectd3,2,2,238,242,0
Helb,3,3,236,242,0
Vmn1r111,0,0,242,242,0
2310061N02Rik,0,0,242,242,0
Bves,0,0,242,242,0
Zfr,3,3,236,242,0
Pcx,4,4,234,242,0
Ppp1cb,5,5,232,242,0
Vmn1r113,0,0,242,242,0
Pdgfrb,5,5,232,242,0
Cacng3,0,0,242,242,0
Cacng2,0,0,242,242,0
2010315B03Rik,6,6,230,242,0
H2bc22,26,26,190,242,0
Pdk1,7,7,228,242,0
Ppil2,3,3,236,242,0
H2bc6,7,7,228,242,0
Cacna2d3,5,5,232,242,0
H2bc8,21,21,200,242,0
Cacna2d2,2,2,238,242,0
H3c4,14,14,214,242,0
Pdgfd,3,3,236,242,0
Slc24a4,0,0,242,242,0
Cabp4,6,6,230,242,0
H4c9,9,9,224,242,0
Cables1,6,6,230,242,0
Pdgfa,4,4,234,242,0
Vgll4,2,2,238,242,0
Hadh,8,8,226,242,0
Hars,4,4,234,242,0
Zfyve28,3,3,236,242,0
2300003K06Rik,0,0,242,242,0
2310003L06Rik,3,3,236,242,0
Hbegf,8,8,226,242,0
Herpud2,3,3,236,242,0
Slc19a2,4,4,234,242,0
Vmn1r142,0,0,242,242,0
Hnrnpul1,3,3,236,242,0
Vmn1r125,0,0,242,242,0
Btbd35f4,0,0,242,242,0
Vmn1r126,0,0,242,242,0
3110040M04Rik,7,7,228,242,0
Btbd35f26,0,0,242,242,0
Vmn1r128,0,0,242,242,0
Vmn1r129,0,0,242,242,0
Hnrnpa0,3,3,236,242,0
Zfp967,10,10,222,242,0
Skp1,5,5,232,242,0
Ppp3ca,2,2,238,242,0
Ppp3r1,4,4,234,242,0
Ppp2r2a,4,4,234,242,0
Ppp4r2,3,3,236,242,0
Homer3,5,5,232,242,0
Skiv2l,5,5,232,242,0
Ppp4r4,6,6,230,242,0
Pate5,0,0,242,242,0
Hormad1,3,3,236,242,0
Vmn1r130,1,1,240,242,0
Btbd35f19,0,0,242,242,0
Skint6,0,0,242,242,0
Hoxb1,0,0,242,242,0
Pate3,1,1,240,242,0
Slc12a2,4,4,234,242,0
Slc12a9,7,7,228,242,0
Ppp1r35,9,9,224,242,0
Slc16a14,5,5,232,242,0
Vmn1r114,0,0,242,242,0
Pcdhga11,3,3,236,242,0
Vmn1r116,0,0,242,242,0
Ppp1r37,3,3,236,242,0
Vmn1r117,0,0,242,242,0
Vmn1r118,0,0,242,242,0
Hif1a,5,5,232,242,0
Slc16a4,7,7,228,242,0
Vmn1r119,0,0,242,242,0
Higd1c,6,6,230,242,0
Zfp976,10,10,222,242,0
Pcdhac2,3,3,236,242,0
Hmcn1,1,1,240,242,0
Hipk3,3,3,236,242,0
Slc16a1,4,4,234,242,0
2810006K23Rik,5,5,232,242,0
Vmn1r120,0,0,242,242,0
Btbd7,2,2,238,242,0
Zfp972,9,9,224,242,0
Pcdh20,1,1,240,242,0
Ppp1r7,4,4,234,242,0
Vmn1r122,0,0,242,242,0
Vmn1r123,0,0,242,242,0
Slc13a1,3,3,236,242,0
Kcnb1,0,0,242,242,0
Olfr582,0,0,242,242,0
Olfr688,1,1,240,242,0
Olfr1261,1,1,240,242,0
Olfr1258,1,1,240,242,0
Psd3,4,4,234,242,0
Akr1b3,6,6,230,242,0
Olfr1256,2,2,238,242,0
Rfxap,2,2,238,242,0
Rfpl4,7,7,228,242,0
Olfr1255,0,0,242,242,0
Rfesd,4,4,234,242,0
Mrto4,4,4,234,242,0
Ms4a13,0,0,242,242,0
Ms4a14,1,1,240,242,0
Olfr1253,1,1,240,242,0
Olfr1252,0,0,242,242,0
Ms4a4d,3,3,236,242,0
Olfr125,0,0,242,242,0
Rev1,4,4,234,242,0
Retsat,6,6,230,242,0
Msantd4,5,5,232,242,0
Olfr1242,0,0,242,242,0
Olfr1241,0,0,242,242,0
Msi2,6,6,230,242,0
Msl2,3,3,236,242,0
Msln,8,8,226,242,0
Olfr1240,0,0,242,242,0
Reps1,5,5,232,242,0
Xpa,4,4,234,242,0
Olfr1234,0,0,242,242,0
Akr1c6,1,1,240,242,0
Olfr1262,1,1,240,242,0
Olfr1163,0,0,242,242,0
Rgs14,5,5,232,242,0
Mrgprb5,1,1,240,242,0
Mrgprg,3,3,236,242,0
Mrgprx1,0,0,242,242,0
Mrgprx2,0,0,242,242,0
Aldh2,6,6,230,242,0
Aldh1l2,6,6,230,242,0
Olfr1298,0,0,242,242,0
Rhob,6,6,230,242,0
Rhoa,3,3,236,242,0
Olfr1294,0,0,242,242,0
Mro,6,6,230,242,0
Olfr1291-ps1,1,1,240,242,0
Mroh7,4,4,234,242,0
Gm5938,0,0,242,242,0
Olfr1290,3,3,236,242,0
Rhbdd1,4,4,234,242,0
Olfr1282,0,0,242,242,0
Abhd17c,5,5,232,242,0
Olfr1272,0,0,242,242,0
Akt3,4,4,234,242,0
Olfr1271,5,5,232,242,0
Rgs3,4,4,234,242,0
Mrpl38,3,3,236,242,0
Olfr1270,0,0,242,242,0
Mrpl43,2,2,238,242,0
Xirp2,2,2,238,242,0
Psapl1,3,3,236,242,0
Olfr1232,0,0,242,242,0
Olfr1231,0,0,242,242,0
Olfr123,0,0,242,242,0
Aifm1,5,5,232,242,0
Mtx2,3,3,236,242,0
Olfr1196,3,3,236,242,0
Olfr1193,0,0,242,242,0
Olfr119,0,0,242,242,0
Muc21,1,1,240,242,0
Rcan1,9,9,224,242,0
Olfr1189,2,2,238,242,0
Mucl3,9,9,224,242,0
Mug2,0,0,242,242,0
Olfr1185-ps1,0,0,242,242,0
Mup12,0,0,242,242,0
Mup13,1,1,240,242,0
Mup2,3,3,236,242,0
Olfr1182,0,0,242,242,0
Olfr1180,0,0,242,242,0
Rbp3,0,0,242,242,0
Olfr1177-ps,0,0,242,242,0
Mxra7,3,3,236,242,0
Rbms2,5,5,232,242,0
Olfr1176,0,0,242,242,0
Olfr1174,0,0,242,242,0
Olfr1170,1,1,240,242,0
Yaf2,2,2,238,242,0
Olfr117,3,3,236,242,0
Olfr1168,0,0,242,242,0
Olfr1164,0,0,242,242,0
Mycbp2,2,2,238,242,0
Olfr1197,0,0,242,242,0
Mtss1,3,3,236,242,0
Rcc1l,3,3,236,242,0
Olfr1212,0,0,242,242,0
Xpo1,4,4,234,242,0
Olfr1229,0,0,242,242,0
Olfr1228,0,0,242,242,0
Mtcl1,3,3,236,242,0
Xpo7,4,4,234,242,0
Olfr1223,0,0,242,242,0
Olfr1222,0,0,242,242,0
Psg20,0,0,242,242,0
Olfr1218,0,0,242,242,0
Olfr1216,0,0,242,242,0
Olfr1215,2,2,238,242,0
Olfr1214,0,0,242,242,0
Olfr121,0,0,242,242,0
Olfr1199,4,4,234,242,0
Rdh7,1,1,240,242,0
Mthfr,4,4,234,242,0
Olfr1208,0,0,242,242,0
Rdh16f2,2,2,238,242,0
Rdh16,6,6,230,242,0
Olfr1204,5,5,232,242,0
Rdh10,5,5,232,242,0
AI413582,6,6,230,242,0
Olfr1200,0,0,242,242,0
AI182371,7,7,228,242,0
Mtnr1b,0,0,242,242,0
Ahsg,12,12,218,242,0
Mrgpra6,0,0,242,242,0
Olfr1299,0,0,242,242,0
Mrgpra2a,3,3,236,242,0
Wipf2,3,3,236,242,0
Olfr1412,0,0,242,242,0
Ang6,6,6,230,242,0
Olfr1411,0,0,242,242,0
Whamm,3,3,236,242,0
Mief1,3,3,236,242,0
Olfr1410,0,0,242,242,0
Anapc7,3,3,236,242,0
Ripply2,11,11,220,242,0
Olfr141,0,0,242,242,0
Ripor2,2,2,238,242,0
Ripor1,4,4,234,242,0
Olfr1408,0,0,242,242,0
Mill1,2,2,238,242,0
Olfr1404,0,0,242,242,0
Whrn,9,9,224,242,0
Olfr140,0,0,242,242,0
Minar1,0,0,242,242,0
Olfr1395,0,0,242,242,0
Olfr1394,0,0,242,242,0
Ripk4,2,2,238,242,0
Mindy2,3,3,236,242,0
Olfr1392,12,12,218,242,0
Anapc16,4,4,234,242,0
Anapc13,6,6,230,242,0
Olfr1390,0,0,242,242,0
Mis12,5,5,232,242,0
Mitd1,5,5,232,242,0
Angptl2,5,5,232,242,0
Mgll,5,5,232,242,0
Rmi1,2,2,238,242,0
Abcb5,1,1,240,242,0
Olfr1447,0,0,242,242,0
Ankrd31,1,1,240,242,0
Wdr83os,2,2,238,242,0
Prss34,2,2,238,242,0
Rnf122,8,8,226,242,0
Rnf113a2,4,4,234,242,0
Mettl5,5,5,232,242,0
Olfr1443,0,0,242,242,0
Abcb1b,7,7,228,242,0
Mettl7b,7,7,228,242,0
Rnf10,2,2,238,242,0
Wdtc1,2,2,238,242,0
Ankrd11,2,2,238,242,0
Olfr1415,1,1,240,242,0
Mfng,3,3,236,242,0
Ankmy2,6,6,230,242,0
Ankfy1,2,2,238,242,0
Rnase9,1,1,240,242,0
Olfr1431,0,0,242,242,0
Olfr1428,0,0,242,242,0
Abcb7,4,4,234,242,0
Olfr1420,4,4,234,242,0
Rmnd5a,3,3,236,242,0
Olfr142,1,1,240,242,0
Rmi2,8,8,226,242,0
Mgam2-ps,0,0,242,242,0
Olfr1387,0,0,242,242,0
Mkx,8,8,226,242,0
Olfr13,0,0,242,242,0
Mlec,3,3,236,242,0
Olfr1341,1,1,240,242,0
Mogat1,7,7,228,242,0
Olfr1335,0,0,242,242,0
Alox12b,2,2,238,242,0
Morc1,0,0,242,242,0
Olfr1333,0,0,242,242,0
Olfr1331,0,0,242,242,0
Rhox3f,0,0,242,242,0
Olfr1330,0,0,242,242,0
Rhox3c,1,1,240,242,0
Olfr1326-ps1,0,0,242,242,0
Olfr1324,0,0,242,242,0
Mov10,6,6,230,242,0
Mov10l1,0,0,242,242,0
Moxd1,2,2,238,242,0
Alkal1,4,4,234,242,0
Olfr1320,0,0,242,242,0
Olfr132,0,0,242,242,0
Wnt9b,1,1,240,242,0
Olfr1311,0,0,242,242,0
Olfr1308,0,0,242,242,0
Olfr1306,0,0,242,242,0
Wwc1,2,2,238,242,0
Olfr1305,0,0,242,242,0
Mpv17l2,7,7,228,242,0
Mpz,6,6,230,242,0
Mr1,6,6,230,242,0
Rhox4f,1,1,240,242,0
Alpk1,5,5,232,242,0
Alpk3,2,2,238,242,0
Amfr,4,4,234,242,0
Olfr1377,0,0,242,242,0
Rimbp2,3,3,236,242,0
Olfr1375,1,1,240,242,0
Olfr137,5,5,232,242,0
Olfr1367,0,0,242,242,0
Mlx,4,4,234,242,0
Amot,4,4,234,242,0
Mmd,7,7,228,242,0
Olfr1364,0,0,242,242,0
Mmgt1,7,7,228,242,0
Ric3,1,1,240,242,0
Olfr1362,0,0,242,242,0
Mmp15,2,2,238,242,0
Abcg2,10,10,222,242,0
Olfr1360,0,0,242,242,0
Mmp20,0,0,242,242,0
Amelx,1,1,240,242,0
Zfp335,2,2,238,242,0
Olfr1359,0,0,242,242,0
Olfr1355,0,0,242,242,0
Ambn,0,0,242,242,0
Olfr1354,0,0,242,242,0
Olfr1353,0,0,242,242,0
Alx4,0,0,242,242,0
Olfr1350,1,1,240,242,0
Olfr135,0,0,242,242,0
Rbm8a,6,6,230,242,0
Olfr1162,0,0,242,242,0
Olfr1450,1,1,240,242,0
Rab33b,4,4,234,242,0
Zfp160,8,8,226,242,0
Nkd1,3,3,236,242,0
Rab2a,4,4,234,242,0
Nkpd1,5,5,232,242,0
Zbtb6,3,3,236,242,0
Oas2,8,8,226,242,0
Oas1h,1,1,240,242,0
Zc2hc1a,5,5,232,242,0
Zfp148,3,3,236,242,0
Nlrc5,6,6,230,242,0
Oas1a,8,8,226,242,0
Rab17,5,5,232,242,0
Oacyl,5,5,232,242,0
Nlrp4b,0,0,242,242,0
Nyap2,0,0,242,242,0
Rab12,7,7,228,242,0
Zc3h12d,3,3,236,242,0
Nlrp9a,0,0,242,242,0
Ptafr,7,7,228,242,0
Rab11fip3,4,4,234,242,0
Nme2,5,5,232,242,0
Adam23,4,4,234,242,0
R3hdml,2,2,238,242,0
Nxph1,0,0,242,242,0
Nms,3,3,236,242,0
Adam1b,9,9,224,242,0
Nmur2,0,0,242,242,0
Nkain2,5,5,232,242,0
Obox7,1,1,240,242,0
Agpat1,7,7,228,242,0
Rab39b,3,3,236,242,0
Nexmif,1,1,240,242,0
Nexn,10,10,222,242,0
Nfasc,1,1,240,242,0
Nfatc1,2,2,238,242,0
Nfatc2,3,3,236,242,0
Olfml3,6,6,230,242,0
Olfml2b,6,6,230,242,0
Rab9,4,4,234,242,0
Olfm5,0,0,242,242,0
Rab8a,3,3,236,242,0
Oit3,2,2,238,242,0
Nfe2l1,3,3,236,242,0
Rab7b,8,8,226,242,0
Adamtsl1,2,2,238,242,0
Oga,3,3,236,242,0
Nfkbid,7,7,228,242,0
Nfkbil1,3,3,236,242,0
Acadvl,3,3,236,242,0
Odc1,2,2,238,242,0
Ngrn,4,4,234,242,0
Acap1,4,4,234,242,0
Ocrl,7,7,228,242,0
Nhlrc1,2,2,238,242,0
Obp1a,0,0,242,242,0
Ninj1,8,8,226,242,0
Rab3b,9,9,224,242,0
Zfp185,4,4,234,242,0
Acer2,2,2,238,242,0
Noc4l,3,3,236,242,0
Nxf2,2,2,238,242,0
Zcchc12,1,1,240,242,0
Nr1d1,6,6,230,242,0
Actl7a,3,3,236,242,0
Actl6a,4,4,234,242,0
Ptgfrn,3,3,236,242,0
Actl11,0,0,242,242,0
Nr2f2,5,5,232,242,0
Ptgir,4,4,234,242,0
Nr3c1,4,4,234,242,0
Nudt9,3,3,236,242,0
Acte1,1,1,240,242,0
Actbl2,0,0,242,242,0
Pus1,4,4,234,242,0
Ptrh1,3,3,236,242,0
Pthlh,7,7,228,242,0
Zdhhc8,3,3,236,242,0
Ptprr,3,3,236,242,0
Nrsn2,1,1,240,242,0
Acsl3,5,5,232,242,0
Ptpro,4,4,234,242,0
Ptn,4,4,234,242,0
Ntsr1,0,0,242,242,0
Acot8,5,5,232,242,0
Ptpn3,10,10,222,242,0
Zfc3h1,2,2,238,242,0
Nt5e,11,11,220,242,0
Nt5el,0,0,242,242,0
Acox1,3,3,236,242,0
Actn1,3,3,236,242,0
Nqo1,9,9,224,242,0
Npy6r,1,1,240,242,0
Npc2,4,4,234,242,0
Qprt,6,6,230,242,0
Nwd2,0,0,242,242,0
Qpctl,4,4,234,242,0
Adam11,1,1,240,242,0
Acer3,5,5,232,242,0
Nos1ap,4,4,234,242,0
Nos3,1,1,240,242,0
Nosip,6,6,230,242,0
Zcchc17,2,2,238,242,0
Ptdss2,6,6,230,242,0
Pygo2,3,3,236,242,0
Npbwr1,0,0,242,242,0
Zdbf2,2,2,238,242,0
Acod1,4,4,234,242,0
Ptger3,4,4,234,242,0
Actrt1,0,0,242,242,0
Zdhhc14,3,3,236,242,0
Pycr2,3,3,236,242,0
Zdhhc19,4,4,234,242,0
Pxmp4,3,3,236,242,0
Zdhhc23,3,3,236,242,0
Pxk,2,2,238,242,0
Zdhhc24,6,6,230,242,0
Aco2,4,4,234,242,0
Npy1r,4,4,234,242,0
Ptges3,4,4,234,242,0
Olfr1002,0,0,242,242,0
Olfr1006,0,0,242,242,0
Nes,8,8,226,242,0
Rasgrf2,0,0,242,242,0
Olfr1121,0,0,242,242,0
Myt1l,2,2,238,242,0
Psma7,5,5,232,242,0
Naa11,0,0,242,242,0
Zfp267,5,5,232,242,0
Olfr1113,0,0,242,242,0
Naa35,6,6,230,242,0
Olfr1112,1,1,240,242,0
Olfr1111,0,0,242,242,0
Adsl,6,6,230,242,0
Olfr1110,0,0,242,242,0
Rbfa,6,6,230,242,0
Nacad,11,11,220,242,0
Olfr1102,0,0,242,242,0
Olfr1101,0,0,242,242,0
Nanos2,2,2,238,242,0
Rax,4,4,234,242,0
Raver2,3,3,236,242,0
Olfr1100,0,0,242,242,0
Olfr110,1,1,240,242,0
Olfr1097,0,0,242,242,0
Natd1,4,4,234,242,0
Rasgrp3,8,8,226,242,0
Olfr1096,0,0,242,242,0
Nbea,2,2,238,242,0
Olfr1095,0,0,242,242,0
Olfr1093,0,0,242,242,0
Olfr1123,0,0,242,242,0
Olfr1126,0,0,242,242,0
Myot,1,1,240,242,0
Olfr1136,0,0,242,242,0
Rbm4b,5,5,232,242,0
Olfr1158,0,0,242,242,0
Olfr1155,0,0,242,242,0
Olfr1153,0,0,242,242,0
Olfr1151,1,1,240,242,0
Abi3bp,6,6,230,242,0
Myh2,1,1,240,242,0
Olfr1145,0,0,242,242,0
Olfr1143,0,0,242,242,0
Olfr1141,0,0,242,242,0
Myl12b,7,7,228,242,0
Olfr1140,0,0,242,242,0
Myl3,10,10,222,242,0
Olfr1128,0,0,242,242,0
Olfr1134,0,0,242,242,0
Olfr1133,0,0,242,242,0
Mymk,3,3,236,242,0
Rbm38,8,8,226,242,0
Agap3,4,4,234,242,0
Agap1,3,3,236,242,0
Aftph,3,3,236,242,0
Myo5c,5,5,232,242,0
Ypel1,8,8,226,242,0
Aff4,4,4,234,242,0
Zfp268,5,5,232,242,0
Myom1,6,6,230,242,0
Psmb10,5,5,232,242,0
Olfr1089,0,0,242,242,0
Olfr1008,0,0,242,242,0
Adh4,7,7,228,242,0
Olfr1038-ps,0,0,242,242,0
Ralb,6,6,230,242,0
Rai2,1,1,240,242,0
Rai1,4,4,234,242,0
Olfr1036,0,0,242,242,0
Ndufv1,3,3,236,242,0
Olfr1032,0,0,242,242,0
Olfr1030,0,0,242,242,0
Nebl,3,3,236,242,0
Radx,1,1,240,242,0
Zfp236,3,3,236,242,0
Nedd4l,5,5,232,242,0
Nefl,0,0,242,242,0
Olfr1025-ps1,0,0,242,242,0
Olfr1024,0,0,242,242,0
Nek1,2,2,238,242,0
Rad51ap2,3,3,236,242,0
Rad51,3,3,236,242,0
Olfr1022,0,0,242,242,0
Rad21l,0,0,242,242,0
Olfr1020,1,1,240,242,0
Nell2,2,2,238,242,0
Olfr1018,0,0,242,242,0
Adck2,4,4,234,242,0
Neo1,4,4,234,242,0
Olfr1015,0,0,242,242,0
Nepn,6,6,230,242,0
Ralgapa1,2,2,238,242,0
Olfr1040,0,0,242,242,0
Olfr1044,3,3,236,242,0
Zbed5,6,6,230,242,0
Adgrv1,3,3,236,242,0
Adgrl1,5,5,232,242,0
Nckap1,6,6,230,242,0
Rasa1,5,5,232,242,0
Olfr1086,0,0,242,242,0
Ncoa1,4,4,234,242,0
Olfr1084,0,0,242,242,0
Olfr1082,0,0,242,242,0
Ncor1,6,6,230,242,0
Ncor2,2,2,238,242,0
Olfr1080,0,0,242,242,0
Rapgef4,1,1,240,242,0
Ndor1,4,4,234,242,0
Olfr1045,0,0,242,242,0
Olfr108,0,0,242,242,0
Olfr1076,0,0,242,242,0
Olfr1066,0,0,242,242,0
Olfr106-ps,0,0,242,242,0
Olfr1058,0,0,242,242,0
Ndufa1,10,10,222,242,0
Olfr1057,0,0,242,242,0
Olfr1056,0,0,242,242,0
Olfr1054,0,0,242,242,0
Olfr1053,0,0,242,242,0
Olfr1049,0,0,242,242,0
Zbtb11,2,2,238,242,0
Olfr145,0,0,242,242,0
Olfr1453,0,0,242,242,0
Olfr685,0,0,242,242,0
Arsk,5,5,232,242,0
Vmn2r80,0,0,242,242,0
Olfr551,0,0,242,242,0
Vmn2r81,0,0,242,242,0
Krt9,0,0,242,242,0
A1cf,4,4,234,242,0
Olfr547,1,1,240,242,0
Olfr545,6,6,230,242,0
Krtap11-1,0,0,242,242,0
Krtap13-1,1,1,240,242,0
Scd2,6,6,230,242,0
A230072I06Rik,0,0,242,242,0
Krtap19-1,0,0,242,242,0
Olfr54,0,0,242,242,0
Krtap19-2,0,0,242,242,0
Olfr535,0,0,242,242,0
Krtap19-4,0,0,242,242,0
Krtap19-5,0,0,242,242,0
Krtap19-9b,0,0,242,242,0
Olfr533,3,3,236,242,0
Scart2,0,0,242,242,0
Krtap26-1,0,0,242,242,0
Vmn2r85,1,1,240,242,0
Olfr53,2,2,238,242,0
Olfr527,0,0,242,242,0
Olfr524,0,0,242,242,0
Olfr522,0,0,242,242,0
Krtap31-2,0,0,242,242,0
Krt82,0,0,242,242,0
Olfr553,0,0,242,242,0
Olfr455,2,2,238,242,0
Krt79,3,3,236,242,0
Olfr574,0,0,242,242,0
Scgb1b12,0,0,242,242,0
Scgb1b11,0,0,242,242,0
Olfr573-ps1,0,0,242,242,0
Krt12,1,1,240,242,0
Olfr572,0,0,242,242,0
Vmn2r69,2,2,238,242,0
Asb12,2,2,238,242,0
Krt2,0,0,242,242,0
Scgb1b10,0,0,242,242,0
Olfr569,0,0,242,242,0
Olfr561,0,0,242,242,0
Asap3,2,2,238,242,0
Krt27,0,0,242,242,0
Krt28,4,4,234,242,0
Krt32,0,0,242,242,0
Krt33b,2,2,238,242,0
A030005K14Rik,0,0,242,242,0
Krt35,0,0,242,242,0
Krt39,0,0,242,242,0
Olfr557,0,0,242,242,0
Vmn2r71,0,0,242,242,0
Krt72,0,0,242,242,0
Vmn2r74,0,0,242,242,0
Olfr556,2,2,238,242,0
Krt75,1,1,240,242,0
Krt78,6,6,230,242,0
Krtap4-7,0,0,242,242,0
Olfr521,0,0,242,242,0
Olfr520,0,0,242,242,0
Olfr516,0,0,242,242,0
Arl6ip4,5,5,232,242,0
Larp4b,3,3,236,242,0
Olfr480,0,0,242,242,0
Arl4c,4,4,234,242,0
Sbf2,7,7,228,242,0
A4gnt,2,2,238,242,0
Olfr476,0,0,242,242,0
Olfr473,0,0,242,242,0
Arl14epl,5,5,232,242,0
Lbx1,0,0,242,242,0
Sav1,3,3,236,242,0
Lce1c,3,3,236,242,0
Olfr470,0,0,242,242,0
Arl1,3,3,236,242,0
Olfr469,0,0,242,242,0
Lce3b,1,1,240,242,0
Zfp511,5,5,232,242,0
Arid5a,11,11,220,242,0
Lcn10,0,0,242,242,0
Sarm1,2,2,238,242,0
Vps13d,2,2,238,242,0
Olfr460,1,1,240,242,0
Sapcd2,12,12,218,242,0
Ldhb,7,7,228,242,0
Ldhd,7,7,228,242,0
Sap30bp,2,2,238,242,0
Ldlrap1,6,6,230,242,0
Arl8b,4,4,234,242,0
Olfr485,0,0,242,242,0
Olfr486,0,0,242,242,0
Olfr50,0,0,242,242,0
Scarf2,6,6,230,242,0
Olfr514,0,0,242,242,0
Krtap9-1,0,0,242,242,0
Krtap9-5,0,0,242,242,0
Olfr508,0,0,242,242,0
Vmn2r9,0,0,242,242,0
Vmn2r91,0,0,242,242,0
Olfr504,0,0,242,242,0
Ky,0,0,242,242,0
Scaper,2,2,238,242,0
Olfr502,0,0,242,242,0
L3hypdh,9,9,224,242,0
Armcx6,3,3,236,242,0
Armc1,4,4,234,242,0
L3mbtl4,6,6,230,242,0
Olfr498,0,0,242,242,0
Olfr497,0,0,242,242,0
Olfr495,0,0,242,242,0
Olfr493,0,0,242,242,0
Lamb1,4,4,234,242,0
Armc7,4,4,234,242,0
Vmn2r98,0,0,242,242,0
Lamp1,3,3,236,242,0
Olfr491,0,0,242,242,0
Olfr490,0,0,242,242,0
Vmo1,8,8,226,242,0
Kremen1,2,2,238,242,0
Olfr575,1,1,240,242,0
Olfr576,0,0,242,242,0
Klf11,6,6,230,242,0
Olfr659,0,0,242,242,0
9530002B09Rik,1,1,240,242,0
Vmn2r33,0,0,242,242,0
Vmn2r34,0,0,242,242,0
Olfr652,2,2,238,242,0
Sde2,2,2,238,242,0
Olfr651,0,0,242,242,0
Sdcbp,5,5,232,242,0
Olfr649,0,0,242,242,0
Prokr2,2,2,238,242,0
Olfr640,0,0,242,242,0
Vmn2r36,0,0,242,242,0
9530068E07Rik,5,5,232,242,0
Vmn2r38,0,0,242,242,0
Scube3,7,7,228,242,0
Vmn2r39,0,0,242,242,0
Vmn2r40,0,0,242,242,0
Atad2b,4,4,234,242,0
Olfr634-ps1,0,0,242,242,0
Scrn1,8,8,226,242,0
Vmn2r41,0,0,242,242,0
Olfr631,0,0,242,242,0
Kiss1r,4,4,234,242,0
Kit,4,4,234,242,0
Asxl3,1,1,240,242,0
Sco1,4,4,234,242,0
Scnn1a,8,8,226,242,0
Olfr663,0,0,242,242,0
Sdk1,0,0,242,242,0
Atg2b,2,2,238,242,0
Sec24a,4,4,234,242,0
Atp1a4,1,1,240,242,0
Olfr684,1,1,240,242,0
Olfr683,0,0,242,242,0
Olfr681,0,0,242,242,0
Vmn2r21,0,0,242,242,0
Kcnh6,1,1,240,242,0
Olfr677,1,1,240,242,0
Zfp597,4,4,234,242,0
Olfr672,0,0,242,242,0
Kcnj12,1,1,240,242,0
Olfr670,0,0,242,242,0
Sec24d,7,7,228,242,0
Kcnk18,0,0,242,242,0
Olfr664,0,0,242,242,0
Kcnk3,6,6,230,242,0
Kcnma1,1,1,240,242,0
Olfr669,0,0,242,242,0
9430069I07Rik,21,21,200,242,0
Kcnn4,3,3,236,242,0
Kcnq5,2,2,238,242,0
Kcnrg,6,6,230,242,0
Atic,4,4,234,242,0
Olfr666,0,0,242,242,0
Vmn2r3,0,0,242,242,0
Kctd3,9,9,224,242,0
Sdr16c5,1,1,240,242,0
Olfr630,0,0,242,242,0
Olfr625-ps1,0,0,242,242,0
Scgb1b18,0,0,242,242,0
Olfr623,0,0,242,242,0
Olfr599,0,0,242,242,0
Olfr598,0,0,242,242,0
Vmn2r54,0,0,242,242,0
Scgb3a1,22,22,198,242,0
Olfr594,0,0,242,242,0
Klk5,6,6,230,242,0
Olfr593,0,0,242,242,0
Zfp575,3,3,236,242,0
Olfr591,0,0,242,242,0
Scgb2b3,0,0,242,242,0
Olfr589,0,0,242,242,0
Klra7,6,6,230,242,0
Scgb2b18,0,0,242,242,0
Olfr587-ps1,1,1,240,242,0
Olfr585,0,0,242,242,0
Vmn2r60,0,0,242,242,0
Olfr584,0,0,242,242,0
Vmn2r61,0,0,242,242,0
Kmt5a,3,3,236,242,0
Kmt5b,3,3,236,242,0
Kndc1,0,0,242,242,0
Ntf5,5,5,232,242,0
Vmn2r65,0,0,242,242,0
Scgb1b7,0,0,242,242,0
Olfr578,0,0,242,242,0
Kptn,4,4,234,242,0
Olfr577,0,0,242,242,0
Klk1b16,1,1,240,242,0
Olfr601,0,0,242,242,0
Klhl7,2,2,238,242,0
Vmn2r48,0,0,242,242,0
Klf3,7,7,228,242,0
Olfr619,0,0,242,242,0
Scn4b,7,7,228,242,0
Klf7,6,6,230,242,0
Olfr618,0,0,242,242,0
Olfr617,0,0,242,242,0
Klf9,3,3,236,242,0
Vmn2r44,0,0,242,242,0
Klhdc2,4,4,234,242,0
Olfr616,0,0,242,242,0
Scn11a,0,0,242,242,0
Klhl1,0,0,242,242,0
Vmn2r49,0,0,242,242,0
Olfr605,0,0,242,242,0
Klhl2,5,5,232,242,0
Vmn2r50,0,0,242,242,0
Olfr615,0,0,242,242,0
Olfr612,0,0,242,242,0
Olfr611,0,0,242,242,0
Olfr610,0,0,242,242,0
Olfr609,0,0,242,242,0
Olfr608,0,0,242,242,0
Klhl38,4,4,234,242,0
Klhl4,4,4,234,242,0
Vmn2r51,0,0,242,242,0
Olfr606,0,0,242,242,0
A630001G21Rik,6,6,230,242,0
Sap18b,4,4,234,242,0
Olfr1454,0,0,242,242,0
Olfr220,0,0,242,242,0
Manba,4,4,234,242,0
Olfr213,0,0,242,242,0
Olfr205,0,0,242,242,0
Olfr203,0,0,242,242,0
Aoah,4,4,234,242,0
Map1s,3,3,236,242,0
Olfr202,0,0,242,242,0
Olfr20,9,9,224,242,0
Map2k6,7,7,228,242,0
Map3k1,6,6,230,242,0
Anxa6,9,9,224,242,0
Anxa3,3,3,236,242,0
Zfp42,2,2,238,242,0
Map4k5,4,4,234,242,0
Wdfy1,8,8,226,242,0
Olfr198,0,0,242,242,0
Olfr193,2,2,238,242,0
Olfr191,0,0,242,242,0
Olfr186,1,1,240,242,0
Anpep,5,5,232,242,0
Anp32e,7,7,228,242,0
Rpa2,5,5,232,242,0
Zfp408,4,4,234,242,0
Rp1l1,0,0,242,242,0
Olfr175,0,0,242,242,0
Olfr171,0,0,242,242,0
Wdr1,4,4,234,242,0
Man2a1,5,5,232,242,0
Zfp442,8,8,226,242,0
Olfr452,0,0,242,242,0
Mamdc4,2,2,238,242,0
Prr23a3,0,0,242,242,0
Rplp0,5,5,232,242,0
Olfr3,0,0,242,242,0
Olfr299,0,0,242,242,0
Olfr297,0,0,242,242,0
Washc2,4,4,234,242,0
Ap3m1,5,5,232,242,0
Aadacl3,0,0,242,242,0
Mafk,4,4,234,242,0
Aadacl4,0,0,242,242,0
Olfr284,0,0,242,242,0
Olfr279,5,5,232,242,0
Ap2m1,6,6,230,242,0
Aadacl4fm4,0,0,242,242,0
Prr7,3,3,236,242,0
Olfr263,1,1,240,242,0
Olfr259,4,4,234,242,0
Rpl7,7,7,228,242,0
Prr9,7,7,228,242,0
Olfr247,0,0,242,242,0
Olfr235,1,1,240,242,0
Olfr231,0,0,242,242,0
Magix,12,12,218,242,0
Rpl39,11,11,220,242,0
Magt1,5,5,232,242,0
Prrg2,4,4,234,242,0
Olfr223,0,0,242,242,0
Mark4,6,6,230,242,0
Rora,7,7,228,242,0
Mast4,2,2,238,242,0
Wdr26,4,4,234,242,0
Mdfic,8,8,226,242,0
Olfr1491,0,0,242,242,0
Rnf217,2,2,238,242,0
Mdm2,2,2,238,242,0
Wdr64,0,0,242,242,0
Rnf213,5,5,232,242,0
Wdr7,2,2,238,242,0
Olfr1490,0,0,242,242,0
Olfr1480,0,0,242,242,0
Olfr1475,0,0,242,242,0
Rnf2,5,5,232,242,0
Med28,4,4,234,242,0
Olfr1474,0,0,242,242,0
Rnf182,5,5,232,242,0
Olfr1472,0,0,242,242,0
Olfr1471,0,0,242,242,0
Wdr81,6,6,230,242,0
Olfr1463,6,6,230,242,0
Olfr1462,0,0,242,242,0
Mei1,0,0,242,242,0
Rnf166,2,2,238,242,0
Rnf165,0,0,242,242,0
Olfr1458,0,0,242,242,0
Meiosin,2,2,238,242,0
Ankrd34c,0,0,242,242,0
Meis3,4,4,234,242,0
Meox2,3,3,236,242,0
Olfr1499,0,0,242,242,0
Wdr53,5,5,232,242,0
0610010F05Rik,6,6,230,242,0
Mc5r,7,7,228,242,0
Robo3,0,0,242,242,0
Olfr167,0,0,242,242,0
Olfr164,0,0,242,242,0
Rnpep,4,4,234,242,0
Olfr157,6,6,230,242,0
Mbl2,4,4,234,242,0
Olfr1565,3,3,236,242,0
Abca12,0,0,242,242,0
Rnf8,4,4,234,242,0
Olfr154,0,0,242,242,0
Olfr1532-ps1,0,0,242,242,0
Prss28,1,1,240,242,0
Mcam,6,6,230,242,0
Mcrip1,4,4,234,242,0
Olfr1510,1,1,240,242,0
Wdr46,3,3,236,242,0
Mcfd2,5,5,232,242,0
Mcidas,1,1,240,242,0
Prss29,0,0,242,242,0
Mcm6,5,5,232,242,0
Mcm7,4,4,234,242,0
Zfp395,4,4,234,242,0
Ankrd65,8,8,226,242,0
Ankrd63,0,0,242,242,0
Olfr1502,1,1,240,242,0
Olfr1501,0,0,242,242,0
Olfr304,0,0,242,242,0
Mab21l4,4,4,234,242,0
Rpp25,9,9,224,242,0
Olfr384,0,0,242,242,0
Olfr417,0,0,242,242,0
Lix1l,5,5,232,242,0
Llgl2,4,4,234,242,0
Arhgap32,7,7,228,242,0
Arhgap30,6,6,230,242,0
Olfr401,0,0,242,242,0
Lmo7,4,4,234,242,0
Olfr399,0,0,242,242,0
Ryk,3,3,236,242,0
Lnpep,5,5,232,242,0
Rxfp4,3,3,236,242,0
Arhgap22,10,10,222,242,0
Prpmp5,0,0,242,242,0
Lonrf1,4,4,234,242,0
Olfr397,1,1,240,242,0
Loxl1,3,3,236,242,0
Zfp467,8,8,226,242,0
Runx1t1,4,4,234,242,0
Olfr392,3,3,236,242,0
Olfr391,0,0,242,242,0
Lratd2,3,3,236,242,0
Rufy3,2,2,238,242,0
Vps9d1,3,3,236,242,0
Olfr389,0,0,242,242,0
Lrfn2,0,0,242,242,0
Rubcn,4,4,234,242,0
Lrit2,1,1,240,242,0
Lipo1,0,0,242,242,0
Prpf8,4,4,234,242,0
Olfr424,0,0,242,242,0
Lhfp,5,5,232,242,0
Lemd3,2,2,238,242,0
Olfr450,0,0,242,242,0
Olfr448,0,0,242,242,0
Vps26a,6,6,230,242,0
Letm2,3,3,236,242,0
Samd5,5,5,232,242,0
Arhgef7,5,5,232,242,0
Olfr44,2,2,238,242,0
Olfr437,1,1,240,242,0
Arhgef4,7,7,228,242,0
Lgr4,6,6,230,242,0
Olfr435,0,0,242,242,0
Arhgef37,5,5,232,242,0
Olfr427,0,0,242,242,0
Sall3,0,0,242,242,0
Lhx8,4,4,234,242,0
Saa4,5,5,232,242,0
Arhgef16,4,4,234,242,0
Lin7a,2,2,238,242,0
S1pr4,5,5,232,242,0
Lingo1,1,1,240,242,0
Olfr43,0,0,242,242,0
Vps41,3,3,236,242,0
Vps45,3,3,236,242,0
Olfr429,0,0,242,242,0
Arhgap5,6,6,230,242,0
Arfgef3,0,0,242,242,0
Lrp1,10,10,222,242,0
Olfr307,1,1,240,242,0
Rtp2,1,1,240,242,0
Olfr339,0,0,242,242,0
Olfr332,0,0,242,242,0
Olfr331,0,0,242,242,0
Olfr330,0,0,242,242,0
A930018P22Rik,16,16,210,242,0
Apoa5,6,6,230,242,0
Rpusd3,8,8,226,242,0
Rptor,3,3,236,242,0
Prr14,3,3,236,242,0
Olfr320,0,0,242,242,0
Rptn,1,1,240,242,0
Lurap1l,6,6,230,242,0
Olfr319,0,0,242,242,0
Lvrn,3,3,236,242,0
Vwde,0,0,242,242,0
Ly6g,11,11,220,242,0
Aph1c,8,8,226,242,0
Ly6h,4,4,234,242,0
Olfr312,0,0,242,242,0
Ly75,5,5,232,242,0
Aph1a,7,7,228,242,0
Olfr310,0,0,242,242,0
Apeh,2,2,238,242,0
Olfr309,0,0,242,242,0
Olfr308,0,0,242,242,0
Wapl,4,4,234,242,0
Apba2,4,4,234,242,0
Lsm14a,3,3,236,242,0
Lsm12,9,9,224,242,0
Lsamp,5,5,232,242,0
Olfr364-ps1,5,5,232,242,0
Arfgef2,2,2,238,242,0
Lrp5,5,5,232,242,0
Lrpprc,3,3,236,242,0
Arf4,4,4,234,242,0
Vsig2,12,12,218,242,0
Lrrc23,18,18,206,242,0
Olfr373,8,8,226,242,0
Olfr372,0,0,242,242,0
Vsnl1,4,4,234,242,0
Olfr371,5,5,232,242,0
Rtl1,0,0,242,242,0
Lrrc30,3,3,236,242,0
Lrrc3c,2,2,238,242,0
Zfp46,6,6,230,242,0
Olfr360,0,0,242,242,0
Olfr358,1,1,240,242,0
Olfr356,0,0,242,242,0
Lrrc63,0,0,242,242,0
Lrrc7,1,1,240,242,0
Rsl1d1,4,4,234,242,0
Olfr350,0,0,242,242,0
Rsc1a1,21,21,200,242,0
Olfr348,1,1,240,242,0
Olfr346,0,0,242,242,0
Olfr342,0,0,242,242,0
Rrs1,4,4,234,242,0
Cyba,5,5,232,242,0
Gm3776,18,18,206,242,0
Gm36245,5,5,232,242,0
Tgtp2,9,9,224,242,0
Tmem25,6,6,230,242,0
Dr1,2,2,238,242,0
Fcho1,1,1,240,242,0
Fxyd1,14,14,214,242,0
Draxin,2,2,238,242,0
Srebf1,3,3,236,242,0
Drd2,0,0,242,242,0
Fxr1,4,4,234,242,0
Drd3,1,1,240,242,0
Fuz,5,5,232,242,0
Dsc1,1,1,240,242,0
Fcrl6,3,3,236,242,0
Fut9,5,5,232,242,0
Cpeb2,8,8,226,242,0
Tgs1,4,4,234,242,0
Gm38119,0,0,242,242,0
Fut8,3,3,236,242,0
Uck1,2,2,238,242,0
Tamalin,6,6,230,242,0
Gm3752,13,13,216,242,0
Dsn1,7,7,228,242,0
Chdh,2,2,238,242,0
Tmem229a,3,3,236,242,0
Trbd2,0,0,242,242,0
Tmem250-ps,7,7,228,242,0
Tmem251,4,4,234,242,0
Fzd9,3,3,236,242,0
Cptp,4,4,234,242,0
Dok4,6,6,230,242,0
Cdk20,5,5,232,242,0
Trav9d-4,10,10,222,242,0
Stx1b,3,3,236,242,0
Trav9n-4,4,4,234,242,0
Dop1b,5,5,232,242,0
Doxl1,0,0,242,242,0
Cpsf3,2,2,238,242,0
Tmem273,10,10,222,242,0
Dpep3,0,0,242,242,0
Tgm7,3,3,236,242,0
Trim38,3,3,236,242,0
Trbd1,0,0,242,242,0
Dpm2,6,6,230,242,0
Tagap1,6,6,230,242,0
Fcer1g,20,20,202,242,0
Cmtm7,8,8,226,242,0
Fxyd7,16,16,210,242,0
Gm20449,2,2,238,242,0
Ccnl1,4,4,234,242,0
Fxyd3,16,16,210,242,0
Fuca1,5,5,232,242,0
Fdps,4,4,234,242,0
Dock2,2,2,238,242,0
Gm37388,6,6,230,242,0
Dvl1,2,2,238,242,0
Ccr1l1,1,1,240,242,0
Dvl2,3,3,236,242,0
Esp3,0,0,242,242,0
Trbj2-2,0,0,242,242,0
Tmem199,3,3,236,242,0
Ftcd,4,4,234,242,0
Dync2li1,5,5,232,242,0
Dynll2,3,3,236,242,0
Ccr4,11,11,220,242,0
Trbj2-3,0,0,242,242,0
Gm3558,14,14,214,242,0
Fstl4,0,0,242,242,0
Trim33,5,5,232,242,0
Tmem185b,4,4,234,242,0
Tbl1xr1,6,6,230,242,0
Gm35339,11,11,220,242,0
Trbj2-4,0,0,242,242,0
Trbj2-5,0,0,242,242,0
Fez2,6,6,230,242,0
Tmem179b,5,5,232,242,0
Esp1,0,0,242,242,0
Fshb,4,4,234,242,0
Esp34,1,1,240,242,0
Strn3,2,2,238,242,0
Trbj1-7,0,0,242,242,0
Dusp14,5,5,232,242,0
Stub1,4,4,234,242,0
Tmem208,4,4,234,242,0
Cilp2,3,3,236,242,0
Fubp1,6,6,230,242,0
Cox8b,20,20,202,242,0
Gm37013,3,3,236,242,0
Tspan18,4,4,234,242,0
CN725425,1,1,240,242,0
Spata22,7,7,228,242,0
Cox7c,7,7,228,242,0
Dusp16,4,4,234,242,0
Esp36,0,0,242,242,0
Cdk16,5,5,232,242,0
Cnbd1,0,0,242,242,0
Fen1,4,4,234,242,0
Dusp22,8,8,226,242,0
Tbpl2,0,0,242,242,0
Dusp23,8,8,226,242,0
Trbj1-5,1,1,240,242,0
Spata33,11,11,220,242,0
Dusp6,9,9,224,242,0
Esp38,0,0,242,242,0
Dock9,4,4,234,242,0
Stard7,5,5,232,242,0
Src,3,3,236,242,0
Dnah11,0,0,242,242,0
Gm12888,1,1,240,242,0
Tnfaip3,8,8,226,242,0
Dlg1,2,2,238,242,0
Tfip11,3,3,236,242,0
Gm13040,0,0,242,242,0
Cma1,7,7,228,242,0
Chst7,4,4,234,242,0
Crnn,1,1,240,242,0
Tmsb15l,11,11,220,242,0
Dmc1,2,2,238,242,0
Dmd,6,6,230,242,0
Sox7,3,3,236,242,0
Fbxo8,6,6,230,242,0
Dmrt3,2,2,238,242,0
Dmrta1,5,5,232,242,0
Crlf1,15,15,212,242,0
Taf10,4,4,234,242,0
Gabrr3,0,0,242,242,0
Crisp4,3,3,236,242,0
Exoc1,4,4,234,242,0
Dmxl2,2,2,238,242,0
Tgfbr2,4,4,234,242,0
Tmprss11e,0,0,242,242,0
Tyrp1,4,4,234,242,0
Dkk3,4,4,234,242,0
Srm,4,4,234,242,0
Fbxo34,3,3,236,242,0
Taar9,0,0,242,242,0
Sox14,0,0,242,242,0
Tssc4,2,2,238,242,0
Trav18,4,4,234,242,0
Fbxo32,6,6,230,242,0
Dhrs7b,3,3,236,242,0
Gm45618,5,5,232,242,0
Dhrs7c,1,1,240,242,0
Dhrs9,3,3,236,242,0
Tnfsf8,3,3,236,242,0
Gm4553,2,2,238,242,0
Disp3,1,1,240,242,0
Gm45521,11,11,220,242,0
Gm45261,5,5,232,242,0
Gm12830,1,1,240,242,0
Dhx40,2,2,238,242,0
Tacr1,0,0,242,242,0
Trav4-2,2,2,238,242,0
Ccl2,18,18,206,242,0
Trav6-2,1,1,240,242,0
Dipk1c,2,2,238,242,0
Trav6-5,4,4,234,242,0
Tmprss11c,1,1,240,242,0
Fbxw16,0,0,242,242,0
Cpxcr1,0,0,242,242,0
Tmod3,5,5,232,242,0
Gabarapl1,4,4,234,242,0
Ube2d1,8,8,226,242,0
G6pd2,0,0,242,242,0
Gm21954,0,0,242,242,0
Dnase1l3,1,1,240,242,0
Cradd,4,4,234,242,0
Dner,2,2,238,242,0
Dnhd1,16,16,210,242,0
Tmem47,3,3,236,242,0
Gm42878,4,4,234,242,0
Tmem45b,14,14,214,242,0
Ucp3,3,3,236,242,0
Dnm1l,4,4,234,242,0
Dnmbp,3,3,236,242,0
Cdk5r2,2,2,238,242,0
Spaca7,6,6,230,242,0
Tmem45a2,2,2,238,242,0
Tmem43,3,3,236,242,0
Cd5,7,7,228,242,0
Trav9-1,7,7,228,242,0
Gm20517,13,13,216,242,0
Spag11b,3,3,236,242,0
Dock1,4,4,234,242,0
Trav7d-5,1,1,240,242,0
Fbxw25,0,0,242,242,0
Ccndbp1,3,3,236,242,0
Gabrb1,2,2,238,242,0
Gabrq,0,0,242,242,0
Fbxw18,3,3,236,242,0
Dnah9,0,0,242,242,0
Gm13289,1,1,240,242,0
Stxbp2,4,4,234,242,0
Gm21903,0,0,242,242,0
Gabrg1,1,1,240,242,0
Creld1,3,3,236,242,0
Cdk6,7,7,228,242,0
Gm21905,0,0,242,242,0
Gabra2,6,6,230,242,0
Fbxw24,0,0,242,242,0
Gm43638,0,0,242,242,0
U2af2,3,3,236,242,0
Tmem74,5,5,232,242,0
Taf4b,3,3,236,242,0
Tmem70,3,3,236,242,0
Dnajc17,6,6,230,242,0
Fbxw22,1,1,240,242,0
Ufsp1,4,4,234,242,0
Ube2d2a,4,4,234,242,0
Tmem62,6,6,230,242,0
Stc2,1,1,240,242,0
Dyrk1b,3,3,236,242,0
Galnt5,0,0,242,242,0
Elf1,7,7,228,242,0
Stk36,8,8,226,242,0
Spred1,4,4,234,242,0
Ephb1,3,3,236,242,0
Gm16513,2,2,238,242,0
Eif4a3l1,5,5,232,242,0
Fmr1nb,9,9,224,242,0
Trem2,7,7,228,242,0
Sptbn5,2,2,238,242,0
Eif4e2,4,4,234,242,0
Chrnb1,3,3,236,242,0
Fmo9,0,0,242,242,0
Fmo6,0,0,242,242,0
Ubr7,4,4,234,242,0
Tsc22d2,4,4,234,242,0
Gm16968,0,0,242,242,0
Eif6,2,2,238,242,0
Gm28168,0,0,242,242,0
Eipr1,6,6,230,242,0
Gm17490,0,0,242,242,0
Gm28230,4,4,234,242,0
Trex1,9,9,224,242,0
Cdh4,1,1,240,242,0
Col18a1,8,8,226,242,0
Stk38,3,3,236,242,0
Tas2r124,0,0,242,242,0
Fnbp1,5,5,232,242,0
Gm5934,3,3,236,242,0
Ubald2,4,4,234,242,0
Spns1,4,4,234,242,0
Tas2r116,0,0,242,242,0
Gm17581,0,0,242,242,0
Cd300c,6,6,230,242,0
Epm2aip1,4,4,234,242,0
Gm15737,0,0,242,242,0
Stk11,3,3,236,242,0
Tas2r117,0,0,242,242,0
Tigd4,2,2,238,242,0
Tas2r119,0,0,242,242,0
Tas2r122,0,0,242,242,0
Eif2s2,3,3,236,242,0
Cdh6,1,1,240,242,0
Stk40,6,6,230,242,0
Stk39,2,2,238,242,0
Gm30302,5,5,232,242,0
Eif3f,3,3,236,242,0
Tas2r120,0,0,242,242,0
Tm4sf19,11,11,220,242,0
Tas2r121,0,0,242,242,0
Timm10,7,7,228,242,0
Epha8,2,2,238,242,0
Trf,10,10,222,242,0
Fntb,3,3,236,242,0
Cd200r4,4,4,234,242,0
Gm28891,0,0,242,242,0
Trhr,3,3,236,242,0
Enah,4,4,234,242,0
Enam,0,0,242,242,0
Cnpy3,3,3,236,242,0
Cntnap5b,0,0,242,242,0
Fkbp9,5,5,232,242,0
Cntnap4,2,2,238,242,0
Epb41l5,4,4,234,242,0
Eno1,5,5,232,242,0
Epb41l4b,2,2,238,242,0
Timm8a1,5,5,232,242,0
Chst4,7,7,228,242,0
Cntnap3,0,0,242,242,0
Filip1,3,3,236,242,0
Enpp1,5,5,232,242,0
Cntn2,4,4,234,242,0
Enpp7,0,0,242,242,0
Ubqlnl,0,0,242,242,0
Gm28553,0,0,242,242,0
Cntfr,4,4,234,242,0
Fitm2,4,4,234,242,0
Entpd8,8,8,226,242,0
Gm17268,3,3,236,242,0
Emilin2,10,10,222,242,0
Flcn,5,5,232,242,0
Elovl1,10,10,222,242,0
Gm17482,0,0,242,242,0
Stk11ip,3,3,236,242,0
Stk32a,6,6,230,242,0
Col13a1,3,3,236,242,0
Elmo1,4,4,234,242,0
Tas2r129,0,0,242,242,0
Tle3,4,4,234,242,0
Elmod3,4,4,234,242,0
Stk31,1,1,240,242,0
Gm17093,1,1,240,242,0
Gm17428,0,0,242,242,0
Fli1,5,5,232,242,0
Trgj3,0,0,242,242,0
Tas2r130,0,0,242,242,0
Tas2r131,0,0,242,242,0
Tas2r134,0,0,242,242,0
Cdh2,4,4,234,242,0
Tas2r136,0,0,242,242,0
Fig4,3,3,236,242,0
Tas2r139,1,1,240,242,0
Cdh3,4,4,234,242,0
Tas2r144,0,0,242,242,0
Spn,7,7,228,242,0
Eprs,4,4,234,242,0
Srbd1,3,3,236,242,0
Fgf9,7,7,228,242,0
Fpr-rs7,0,0,242,242,0
Eci2,9,9,224,242,0
Cib3,11,11,220,242,0
Fpr-rs6,0,0,242,242,0
Fpr-rs4,0,0,242,242,0
Fpr-rs3,0,0,242,242,0
Spidr,5,5,232,242,0
Tas2r102,0,0,242,242,0
Tbcc,2,2,238,242,0
Gm17720,0,0,242,242,0
Eda,5,5,232,242,0
Thoc2,8,8,226,242,0
Gm34066,4,4,234,242,0
Eri1,6,6,230,242,0
Tspan1,8,8,226,242,0
Spin2d,4,4,234,242,0
Thoc2l,5,5,232,242,0
Cops3,4,4,234,242,0
Foxp4,4,4,234,242,0
Gm17662,0,0,242,242,0
Tas2r104,0,0,242,242,0
Cope,2,2,238,242,0
Foxp1,3,3,236,242,0
Coq10a,6,6,230,242,0
Cib4,12,12,218,242,0
Ece2,13,13,216,242,0
Gm19965,1,1,240,242,0
Dyrk2,3,3,236,242,0
Speer4c,19,19,204,242,0
Dzank1,1,1,240,242,0
Fezf2,2,2,238,242,0
Tmem176b,6,6,230,242,0
Tbl1x,5,5,232,242,0
Fscb,0,0,242,242,0
Esco1,6,6,230,242,0
Sra1,3,3,236,242,0
Corin,2,2,238,242,0
Fgd4,5,5,232,242,0
Coq4,8,8,226,242,0
Fgd5,2,2,238,242,0
Trim31,1,1,240,242,0
Chl1,3,3,236,242,0
Erp27,12,12,218,242,0
Frg1,4,4,234,242,0
Tbcd,3,3,236,242,0
Gm14569,2,2,238,242,0
Ears2,4,4,234,242,0
Coq5,3,3,236,242,0
Theg,4,4,234,242,0
Gm3371,6,6,230,242,0
Tmem11,3,3,236,242,0
Ubqln3,0,0,242,242,0
Gm27179,0,0,242,242,0
Gm17617,0,0,242,242,0
Spink12,1,1,240,242,0
Col8a1,1,1,240,242,0
Ehd4,6,6,230,242,0
Tmco3,3,3,236,242,0
Chodl,1,1,240,242,0
Cdhr2,2,2,238,242,0
Tas2r110,0,0,242,242,0
Tas2r113,0,0,242,242,0
Spty2d1,5,5,232,242,0
Eif1ad15,7,7,228,242,0
Cdhr1,6,6,230,242,0
Cnnm4,3,3,236,242,0
Tas2r114,0,0,242,242,0
Tmc2,3,3,236,242,0
Chpf,5,5,232,242,0
Foxd1,1,1,240,242,0
Eif1ad3,4,4,234,242,0
Tas2r115,0,0,242,242,0
Eif1ad7,4,4,234,242,0
Cct8,5,5,232,242,0
Eif1ad8,3,3,236,242,0
Spint4,1,1,240,242,0
Col8a2,7,7,228,242,0
Gm17622,0,0,242,242,0
Spink11,3,3,236,242,0
Efhd2,4,4,234,242,0
Fgfr1,4,4,234,242,0
Thpo,5,5,232,242,0
Trim3,4,4,234,242,0
Efcab15,8,8,226,242,0
Efcab2,2,2,238,242,0
Gm3317,10,10,222,242,0
Tbc1d23,5,5,232,242,0
Gm15107,11,11,220,242,0
Tas2r107,0,0,242,242,0
Efhd1,4,4,234,242,0
Trdd1,0,0,242,242,0
Efs,0,0,242,242,0
Cd300ld5,10,10,222,242,0
Tmed11,1,1,240,242,0
Trdd2,0,0,242,242,0
Stim2,4,4,234,242,0
Trpt1,4,4,234,242,0
Foxk2,3,3,236,242,0
Erbin,5,5,232,242,0
Gm17651,0,0,242,242,0
Cct4,6,6,230,242,0
Colq,6,6,230,242,0
Dhdh,5,5,232,242,0
Gm13043,0,0,242,242,0
Gm49661,9,9,224,242,0
Glra2,0,0,242,242,0
Tex12,8,8,226,242,0
Gm10945,0,0,242,242,0
Gm10959,0,0,242,242,0
Txndc8,4,4,234,242,0
Ces1c,2,2,238,242,0
Tex13a,0,0,242,242,0
Tph2,5,5,232,242,0
Snx5,5,5,232,242,0
Ube3a,4,4,234,242,0
Dctn4,3,3,236,242,0
Traj37,0,0,242,242,0
Sult6b2,1,1,240,242,0
Snrpd2,4,4,234,242,0
Dcun1d3,7,7,228,242,0
Traj39,0,0,242,242,0
St6galnac6,9,9,224,242,0
Ccdc54,0,0,242,242,0
Gdnf,9,9,224,242,0
Gm11007,5,5,232,242,0
Gm10944,0,0,242,242,0
Gm5414,0,0,242,242,0
Gm11116,0,0,242,242,0
Cyp3a11,1,1,240,242,0
Cyp3a44,0,0,242,242,0
Dcaf12l2,0,0,242,242,0
Dcaf17,5,5,232,242,0
Traj32,1,1,240,242,0
Gfi1,7,7,228,242,0
Sun2,5,5,232,242,0
Dcakd,3,3,236,242,0
Cyp3a16,0,0,242,242,0
Tex101,4,4,234,242,0
Ssc5d,1,1,240,242,0
Fam163b,2,2,238,242,0
Sumo3,4,4,234,242,0
Syt1,0,0,242,242,0
Tppp3,4,4,234,242,0
Cutal,6,6,230,242,0
Tubgcp4,4,4,234,242,0
Dck,3,3,236,242,0
Ctnna2,2,2,238,242,0
Ces1b,0,0,242,242,0
Gdi1,6,6,230,242,0
Dcun1d5,3,3,236,242,0
Sult5a1,4,4,234,242,0
Dcxr,6,6,230,242,0
Cyp2g1,1,1,240,242,0
Tex28,0,0,242,242,0
Cd99l2,7,7,228,242,0
Ddr2,4,4,234,242,0
Tpbpb,2,2,238,242,0
Fam210b,8,8,226,242,0
Svip,6,6,230,242,0
Cxcl3,11,11,220,242,0
Cyp2d11,0,0,242,242,0
Tox3,4,4,234,242,0
Traj58,0,0,242,242,0
Gm11096,0,0,242,242,0
Gm1110,1,1,240,242,0
Ccdc59,2,2,238,242,0
Sytl4,6,6,230,242,0
Gm11111,0,0,242,242,0
Gm11114,0,0,242,242,0
Ddx23,8,8,226,242,0
Gm11115,0,0,242,242,0
Gm11042,12,12,218,242,0
Gm49398,0,0,242,242,0
Gcnt1,7,7,228,242,0
Cenpx,6,6,230,242,0
Syt5,5,5,232,242,0
Gm5478,0,0,242,242,0
Gdf6,0,0,242,242,0
Ctdspl,6,6,230,242,0
Trim61,2,2,238,242,0
Gdf2,0,0,242,242,0
Tug1,5,5,232,242,0
Snrpb2,6,6,230,242,0
Srrd,6,6,230,242,0
Cyp2j12,2,2,238,242,0
Tex264,3,3,236,242,0
Syt9,4,4,234,242,0
Gm21731,7,7,228,242,0
Fam124a,5,5,232,242,0
Cyp2j5,2,2,238,242,0
Trav12n-3,2,2,238,242,0
Snx6,3,3,236,242,0
Tulp3,6,6,230,242,0
Gm49804,15,15,212,242,0
Gfra3,3,3,236,242,0
Gm52968,7,7,228,242,0
Dag1,5,5,232,242,0
Cyp4f17,15,15,212,242,0
Cttn,5,5,232,242,0
Traj13,2,2,238,242,0
Trim71,1,1,240,242,0
Gja10,0,0,242,242,0
Traj12,2,2,238,242,0
Cep295nl,11,11,220,242,0
Gm10486,0,0,242,242,0
Traj11,0,0,242,242,0
Tcl1b3,0,0,242,242,0
Snx16,7,7,228,242,0
Traj3,2,2,238,242,0
Txndc17,4,4,234,242,0
Cep89,3,3,236,242,0
Dach2,2,2,238,242,0
Cyp4a32,1,1,240,242,0
Ccdc33,0,0,242,242,0
Tcl1b2,3,3,236,242,0
Dact2,4,4,234,242,0
Fam205a3,11,11,220,242,0
Cyp4f18,12,12,218,242,0
Gm21312,1,1,240,242,0
Tcp10c,1,1,240,242,0
Gjb6,3,3,236,242,0
Cysltr2,4,4,234,242,0
Celf5,4,4,234,242,0
Unc5cl,4,4,234,242,0
Syn3,6,6,230,242,0
Terf2ip,3,3,236,242,0
Fance,3,3,236,242,0
Ss18l1,4,4,234,242,0
Gk,4,4,234,242,0
Traj15,3,3,236,242,0
Gk5,3,3,236,242,0
Traj22,4,4,234,242,0
Traj27,0,0,242,242,0
Trappc6a,5,5,232,242,0
D1Pas1,0,0,242,242,0
Trappc13,3,3,236,242,0
Traj16,0,0,242,242,0
Fam205a2,10,10,222,242,0
Tcl1b1,1,1,240,242,0
Fam171a1,5,5,232,242,0
Cebpzos,4,4,234,242,0
Cep97,6,6,230,242,0
Cldn17,0,0,242,242,0
Gm21293,9,9,224,242,0
Srsf11,4,4,234,242,0
Gm49918,0,0,242,242,0
Tra2b,6,6,230,242,0
Cuta,2,2,238,242,0
Cts7,0,0,242,242,0
Sun3,7,7,228,242,0
Dbt,8,8,226,242,0
Synrg,4,4,234,242,0
Cyp46a1,3,3,236,242,0
Dbx2,2,2,238,242,0
Fbl,4,4,234,242,0
Gm10719,27,27,188,242,0
Fblim1,5,5,232,242,0
Trav10,1,1,240,242,0
Gm49835,0,0,242,242,0
Gm4981,0,0,242,242,0
Sybu,5,5,232,242,0
Unc5d,0,0,242,242,0
Ggps1,4,4,234,242,0
Synm,2,2,238,242,0
Cd84,4,4,234,242,0
Cul4b,5,5,232,242,0
Ube2z,3,3,236,242,0
Cd86,2,2,238,242,0
Gm20838,0,0,242,242,0
Unc13d,7,7,228,242,0
Syngr2,8,8,226,242,0
Tet3,6,6,230,242,0
Ctsll3,0,0,242,242,0
Gimap1,9,9,224,242,0
Ttll2,4,4,234,242,0
Fam169b,6,6,230,242,0
Fau,4,4,234,242,0
Fam168a,5,5,232,242,0
Cerk,3,3,236,242,0
Ggta1,5,5,232,242,0
Gm10663,0,0,242,242,0
Unc13c,0,0,242,242,0
Fam205c,2,2,238,242,0
Ddx27,3,3,236,242,0
Cyp2c67,1,1,240,242,0
Gm10283,0,0,242,242,0
Taar5,0,0,242,242,0
Tomm22,3,3,236,242,0
F13b,2,2,238,242,0
Csnk1g3,5,5,232,242,0
F2r,6,6,230,242,0
Faap24,3,3,236,242,0
Tfap2c,1,1,240,242,0
Taar3,0,0,242,242,0
Csnk1d,3,3,236,242,0
Tfap2d,0,0,242,242,0
Ccdc86,2,2,238,242,0
Tdpoz9-ps1,1,1,240,242,0
Tdrd1,1,1,240,242,0
Des,3,3,236,242,0
Sv2c,0,0,242,242,0
Gm47969,3,3,236,242,0
Gm21834,11,11,220,242,0
Gm47959,2,2,238,242,0
Gm10153,3,3,236,242,0
Csnk2a1,8,8,226,242,0
Svil,4,4,234,242,0
Gm10147,4,4,234,242,0
Taar7e,0,0,242,242,0
Cst10,0,0,242,242,0
Defa43,1,1,240,242,0
Gm4894,1,1,240,242,0
Trav14d-1,13,13,216,242,0
Gm11569,0,0,242,242,0
Cdkn1b,5,5,232,242,0
Taar1,0,0,242,242,0
Traj47,0,0,242,242,0
Sorbs3,5,5,232,242,0
Csnka2ip,0,0,242,242,0
Gm11596,0,0,242,242,0
Sult1c1,1,1,240,242,0
Gm4847,0,0,242,242,0
Tstd2,5,5,232,242,0
Tfap2b,5,5,232,242,0
Garnl3,6,6,230,242,0
Txnrd1,3,3,236,242,0
Gm21094,2,2,238,242,0
Gm10181,14,14,214,242,0
Clec2f,11,11,220,242,0
Ugt2a3,0,0,242,242,0
Fbxo28,5,5,232,242,0
Taar7a,0,0,242,242,0
Taar7b,0,0,242,242,0
Tnxb,3,3,236,242,0
Sncg,10,10,222,242,0
Fbxo27,2,2,238,242,0
Cyp11a1,12,12,218,242,0
Sox1,1,1,240,242,0
Cyb5r3,4,4,234,242,0
Csgalnact1,3,3,236,242,0
Taar7d,0,0,242,242,0
Clrn2,2,2,238,242,0
Gm12185,1,1,240,242,0
Traj44,0,0,242,242,0
Ugt2a1,1,1,240,242,0
Taar6,0,0,242,242,0
Ssr4,5,5,232,242,0
Ugt2b35,0,0,242,242,0
Traj5,0,0,242,242,0
Trav15n-1,2,2,238,242,0
Csmd2,0,0,242,242,0
Csmd1,0,0,242,242,0
Degs1,7,7,228,242,0
Tom1l2,5,5,232,242,0
Gm11938,3,3,236,242,0
Tom1l1,6,6,230,242,0
Trmo,4,4,234,242,0
Traj43,0,0,242,242,0
Gm10234,0,0,242,242,0
Tceanc2,5,5,232,242,0
Cyfip2,5,5,232,242,0
Trav16,5,5,232,242,0
Dennd2a,1,1,240,242,0
Gm21836,0,0,242,242,0
Gm20741,6,6,230,242,0
Cst12,7,7,228,242,0
Defa40,2,2,238,242,0
Sohlh2,1,1,240,242,0
Gm20777,2,2,238,242,0
Clca4a,1,1,240,242,0
Sval3,0,0,242,242,0
Topaz1,0,0,242,242,0
Gbgt1,6,6,230,242,0
Csf1,6,6,230,242,0
Trim58,1,1,240,242,0
Gm10229,1,1,240,242,0
Gbe1,3,3,236,242,0
Dgkh,2,2,238,242,0
Fbxl7,0,0,242,242,0
Gm11172,11,11,220,242,0
Syvn1,6,6,230,242,0
Taar8a,0,0,242,242,0
Cyp2c38,0,0,242,242,0
Taar7f,0,0,242,242,0
Cyp2c37,0,0,242,242,0
Traj4,0,0,242,242,0
Ccdc66,4,4,234,242,0
Topbp1,4,4,234,242,0
Tut1,3,3,236,242,0
Taar8b,0,0,242,242,0
Tex44,0,0,242,242,0
Ttc38,6,6,230,242,0
Gm2174,32,32,178,242,0
Gbp9,5,5,232,242,0
Tor1aip1,5,5,232,242,0
Ddx49,2,2,238,242,0
Ddx5,3,3,236,242,0
Clca4b,0,0,242,242,0
Fam104a,2,2,238,242,0
Ugt1a8,5,5,232,242,0
Gm49383,19,19,204,242,0
Ddx50,6,6,230,242,0
Ccdc9b,6,6,230,242,0
Gm572,0,0,242,242,0
Srpx,7,7,228,242,0
Cyp2c54,0,0,242,242,0
Cd63,4,4,234,242,0
Galr1,0,0,242,242,0
Tnnt2,12,12,218,242,0
Gm5916,0,0,242,242,0
Tcf15,9,9,224,242,0
Traj40,1,1,240,242,0
Clec16a,4,4,234,242,0
Fads1,5,5,232,242,0
Tex55,0,0,242,242,0
Gm21800,1,1,240,242,0
Gm11554,0,0,242,242,0
Cfap47,1,1,240,242,0
Trav13n-1,2,2,238,242,0
Traj56,0,0,242,242,0
Ttc24,0,0,242,242,0
Fam83a,9,9,224,242,0
Defa34,2,2,238,242,0
Clps,13,13,216,242,0
Gm11567,0,0,242,242,0
Tdpoz5,1,1,240,242,0
Clca2,0,0,242,242,0
Cdyl2,2,2,238,242,0
Gm11238,5,5,232,242,0
Trav13d-4,4,4,234,242,0
Ttc27,4,4,234,242,0
Fbxo17,6,6,230,242,0
Cstl1,12,12,218,242,0
Gm11214,15,15,212,242,0
Ten1,4,4,234,242,0
Ube3c,2,2,238,242,0
Gm11232,0,0,242,242,0
Gm21797,0,0,242,242,0
Traj48,0,0,242,242,0
Ceacam10,12,12,218,242,0
Defa25,0,0,242,242,0
Defa26,1,1,240,242,0
Faf2,3,3,236,242,0
Ankef1,2,3,237,242,-1
Xrcc6,2,3,237,242,-1
Ankhd1,4,5,233,242,-1
Tcte2,17,18,207,242,-1
Myh4,1,2,239,242,-1
Rc3h2,5,6,231,242,-1
Mgst3,9,10,223,242,-1
Myh8,2,3,237,242,-1
Mup17,2,3,237,242,-1
Myh3,0,1,241,242,-1
Rbpjl,3,4,235,242,-1
Muc2,3,4,235,242,-1
Mgat4e,1,2,239,242,-1
Agxt,1,2,239,242,-1
Rbmxl2,3,4,235,242,-1
Mxi1,2,3,237,242,-1
Myb,2,3,237,242,-1
Fam8a1,4,5,233,242,-1
Mybbp1a,3,4,235,242,-1
Mgat3,4,5,233,242,-1
Fam90a1a,0,1,241,242,-1
Xrn1,5,6,231,242,-1
Mup4,0,1,241,242,-1
Rbpj,4,5,233,242,-1
Mybphl,10,11,221,242,-1
Tbc1d15,2,3,237,242,-1
Trit1,3,4,235,242,-1
Figla,0,1,241,242,-1
Fam91a1,4,5,233,242,-1
Mup18,4,5,233,242,-1
Fam76b,5,6,231,242,-1
Mup15,2,3,237,242,-1
Mydgf,2,3,237,242,-1
Cldn18,1,2,239,242,-1
Rnase1,8,9,225,242,-1
Mgst1,15,16,211,242,-1
Rnase12,9,10,223,242,-1
Wfdc5,2,3,237,242,-1
Myh1,3,4,235,242,-1
Fan1,3,4,235,242,-1
Mup1,3,4,235,242,-1
Angpt2,4,5,233,242,-1
Xk,0,1,241,242,-1
Muc16,3,4,235,242,-1
Fbxl6,3,4,235,242,-1
Fbxo21,5,6,231,242,-1
Mrgprb1,2,3,237,242,-1
Mrgpra3,0,1,241,242,-1
Ms4a1,4,5,233,242,-1
Mre11a,7,8,227,242,-1
Rhoh,3,4,235,242,-1
Fbxw8,2,3,237,242,-1
Akap8,4,5,233,242,-1
Trp53inp1,10,11,221,242,-1
Akap6,0,1,241,242,-1
Fcer1a,2,3,237,242,-1
Mpped1,4,5,233,242,-1
Rev3l,5,6,231,242,-1
Rhov,6,7,229,242,-1
Alg11,3,4,235,242,-1
Mib1,2,3,237,242,-1
Wscd1,2,3,237,242,-1
Fcgbp,3,4,235,242,-1
Mphosph8,2,3,237,242,-1
Wrap53,5,6,231,242,-1
Msantd5,6,7,229,242,-1
Trp63,4,5,233,242,-1
Fchsd2,6,7,229,242,-1
Trpc3,1,2,239,242,-1
Fbxl2,2,3,237,242,-1
Ak2,5,6,231,242,-1
Msr1,4,5,233,242,-1
Alkbh7,2,3,237,242,-1
Fcrlb,2,3,237,242,-1
Allc,0,1,241,242,-1
Rhobtb2,5,6,231,242,-1
Mrgprf,5,6,231,242,-1
Aldh3a1,6,7,229,242,-1
Mri1,3,4,235,242,-1
Fbxo31,3,4,235,242,-1
Akr1c14,7,8,227,242,-1
Clasp1,2,3,237,242,-1
Fbxo40,2,3,237,242,-1
Mrpl44,3,4,235,242,-1
Tceal3,7,8,227,242,-1
Mrpl41,4,5,233,242,-1
Mrpl37,3,4,235,242,-1
Mrpl32,6,7,229,242,-1
Akt2,3,4,235,242,-1
Tcea1,4,5,233,242,-1
Xkr6,2,3,237,242,-1
Rgs7,4,5,233,242,-1
Xkr7,0,1,241,242,-1
Rftn1,2,3,237,242,-1
Mrpl19,4,5,233,242,-1
Mrpl18,3,4,235,242,-1
Mrpl16,3,4,235,242,-1
Rgs9bp,1,2,239,242,-1
Alas2,8,9,225,242,-1
Fbxo9,2,3,237,242,-1
Mrps36,6,7,229,242,-1
Rheb,2,3,237,242,-1
Mroh2b,0,1,241,242,-1
Fbxw13,3,4,235,242,-1
Akap8l,3,4,235,242,-1
Mrps9,3,4,235,242,-1
Fbxw19,0,1,241,242,-1
Mrtfb,4,5,233,242,-1
Fbxl17,2,3,237,242,-1
Rere,2,3,237,242,-1
Fbxl16,5,6,231,242,-1
Mllt3,5,6,231,242,-1
Mkrn2os,6,7,229,242,-1
Amtn,0,1,241,242,-1
Mkrn1,5,6,231,242,-1
Mtf1,7,8,227,242,-1
Clcn6,3,4,235,242,-1
Mixl1,2,3,237,242,-1
Amz2,4,5,233,242,-1
Anapc15,3,4,235,242,-1
Fgf6,1,2,239,242,-1
AI593442,2,3,237,242,-1
Miga2,3,4,235,242,-1
Miga1,5,6,231,242,-1
Rdh19,1,2,239,242,-1
Mtmr1,5,6,231,242,-1
Tbc1d22a,3,4,235,242,-1
Midn,3,4,235,242,-1
Ang,13,14,215,242,-1
Trpv2,4,5,233,242,-1
Rdh12,6,7,229,242,-1
Trpv3,1,2,239,242,-1
Cldn10,9,10,223,242,-1
Farp2,4,5,233,242,-1
Micall1,3,4,235,242,-1
Mical1,7,8,227,242,-1
Rce1,3,4,235,242,-1
Farp1,3,4,235,242,-1
Chsy3,1,2,239,242,-1
Fap,3,4,235,242,-1
Tcstv1,1,2,239,242,-1
Mlc1,0,1,241,242,-1
Fgd6,3,4,235,242,-1
Mstn,2,3,237,242,-1
Clcn4,2,3,237,242,-1
Fdx1,4,5,233,242,-1
Fem1a,2,3,237,242,-1
Repin1,4,5,233,242,-1
Rhox6,5,6,231,242,-1
Fbxl14,4,5,233,242,-1
Mob1a,6,7,229,242,-1
Msx3,1,2,239,242,-1
Aip,2,3,237,242,-1
Rem1,6,7,229,242,-1
Wnt5b,6,7,229,242,-1
Rell2,6,7,229,242,-1
Ferd3l,0,1,241,242,-1
Tcf7,6,7,229,242,-1
Trpc5,1,2,239,242,-1
Xpnpep3,3,4,235,242,-1
Trpc5os,3,4,235,242,-1
Aif1l,6,7,229,242,-1
Mrpl54,5,6,231,242,-1
Rhpn2,6,7,229,242,-1
Tchh,3,4,235,242,-1
Aicda,4,5,233,242,-1
Mmp21,4,5,233,242,-1
Fezf1,0,1,241,242,-1
Mtarc1,4,5,233,242,-1
Mtch1,6,7,229,242,-1
Fbln7,3,4,235,242,-1
Ric1,2,3,237,242,-1
Cibar2,8,9,225,242,-1
Mlycd,2,3,237,242,-1
Tbc1d10a,2,3,237,242,-1
Ccdc177,6,7,229,242,-1
Ankrd13a,2,3,237,242,-1
Gbf1,3,4,235,242,-1
Lamtor3,3,4,235,242,-1
Gcc1,2,3,237,242,-1
Ttc33,5,6,231,242,-1
Lasp1,3,4,235,242,-1
Sbds,2,3,237,242,-1
Sytl5,1,2,239,242,-1
Gbp3,10,11,221,242,-1
Gbp11,9,10,223,242,-1
Arl13a,1,2,239,242,-1
Lce1g,6,7,229,242,-1
Lmtk2,3,4,235,242,-1
Lce1k,0,1,241,242,-1
Lce3a,1,2,239,242,-1
Lce3e,2,3,237,242,-1
Sart3,3,4,235,242,-1
Gatad1,4,5,233,242,-1
Vps13c,2,3,237,242,-1
Arid3c,5,6,231,242,-1
Lcn5,4,5,233,242,-1
Lcn6,0,1,241,242,-1
Scaf1,3,4,235,242,-1
Scaf11,4,5,233,242,-1
Gcgr,3,4,235,242,-1
Lama4,2,3,237,242,-1
Arr3,4,5,233,242,-1
Syt16,1,2,239,242,-1
Gdpd2,3,4,235,242,-1
Krtap4-13,5,6,231,242,-1
Arpc5l,3,4,235,242,-1
Arpc5,6,7,229,242,-1
Arpc1a,3,4,235,242,-1
Krtap6-1,0,1,241,242,-1
Arnt2,3,4,235,242,-1
Krtap7-1,1,2,239,242,-1
Ttl,5,6,231,242,-1
Syt6,2,3,237,242,-1
Gdap1l1,4,5,233,242,-1
Vmn2r93,1,2,239,242,-1
Scara3,9,10,223,242,-1
Vmn2r94,0,1,241,242,-1
Sytl2,7,8,227,242,-1
Scai,5,6,231,242,-1
Gcm1,8,9,225,242,-1
Ttc26,4,5,233,242,-1
Sardh,7,8,227,242,-1
Lctl,8,9,225,242,-1
Lias,3,4,235,242,-1
Vps35,4,5,233,242,-1
Lin37,3,4,235,242,-1
Arhgef10l,4,5,233,242,-1
Taar8c,0,1,241,242,-1
Galnt4,2,3,237,242,-1
Arhgap9,3,4,235,242,-1
Liph,2,3,237,242,-1
Lipk,1,2,239,242,-1
Lipm,2,3,237,242,-1
Lipn,1,2,239,242,-1
Lix1,4,5,233,242,-1
Lman1,4,5,233,242,-1
Lmna,2,3,237,242,-1
Galc,3,4,235,242,-1
S100a11,11,12,219,242,-1
Gal3st4,7,8,227,242,-1
Gal3st3,4,5,233,242,-1
Arhgap24,4,5,233,242,-1
Ryr1,2,3,237,242,-1
Lilrb4a,21,22,199,242,-1
Arhgef3,4,5,233,242,-1
Arid1b,2,3,237,242,-1
Vps26c,2,3,237,242,-1
Sap30l,5,6,231,242,-1
Ldhc,10,11,221,242,-1
Ldlrad4,3,4,235,242,-1
Ttc19,4,5,233,242,-1
Lef1,5,6,231,242,-1
Lelp1,0,1,241,242,-1
Gas2l1,2,3,237,242,-1
Leng1,2,3,237,242,-1
Samsn1,2,3,237,242,-1
Gars,3,4,235,242,-1
Garre1,3,4,235,242,-1
Samd15,7,8,227,242,-1
Lgals12,2,3,237,242,-1
Garem1,3,4,235,242,-1
Lgals4,5,6,231,242,-1
Lgalsl,8,9,225,242,-1
Ganc,2,3,237,242,-1
Lhcgr,2,3,237,242,-1
Lhfpl1,7,8,227,242,-1
Krtap24-1,0,1,241,242,-1
Krtap21-1,0,1,241,242,-1
Syt13,1,2,239,242,-1
Scyl1,2,3,237,242,-1
Scube1,0,1,241,242,-1
Kif3b,2,3,237,242,-1
Scrt1,0,1,241,242,-1
Gls,2,3,237,242,-1
Glrb,3,4,235,242,-1
Cep128,6,7,229,242,-1
Klf14,1,2,239,242,-1
Astn1,3,4,235,242,-1
Cep135,2,3,237,242,-1
Glo1,4,5,233,242,-1
Klhdc4,3,4,235,242,-1
Cep170b,4,5,233,242,-1
Scn10a,1,2,239,242,-1
Tubb5,5,6,231,242,-1
Klhl21,4,5,233,242,-1
Klhl23,4,5,233,242,-1
Glg1,2,3,237,242,-1
Klhl30,3,4,235,242,-1
Aspa,12,13,217,242,-1
Kif26a,0,1,241,242,-1
Sdc3,7,8,227,242,-1
Klhl5,5,6,231,242,-1
Sval2,3,4,235,242,-1
Twist1,7,8,227,242,-1
Atg4b,3,4,235,242,-1
Kctd6,6,7,229,242,-1
Cenpj,4,5,233,242,-1
Kdm1a,2,3,237,242,-1
Atg2a,2,3,237,242,-1
Gm10188,9,10,223,242,-1
Kdm5b,2,3,237,242,-1
Atg16l1,3,4,235,242,-1
Atg13,3,4,235,242,-1
Kdm7a,7,8,227,242,-1
Atg12,2,3,237,242,-1
Kel,2,3,237,242,-1
Khdc1a,1,2,239,242,-1
Khdc4,5,6,231,242,-1
Sdf2l1,7,8,227,242,-1
Tut7,5,6,231,242,-1
Atf6b,3,4,235,242,-1
Sdccag8,6,7,229,242,-1
Sycp2,2,3,237,242,-1
Gkn3,10,11,221,242,-1
Ces1a,0,1,241,242,-1
Scgb1b2,0,1,241,242,-1
Scgb1b19,0,1,241,242,-1
Gimap8,4,5,233,242,-1
Gimap7,7,8,227,242,-1
Asb16,1,2,239,242,-1
Gimap3,7,8,227,242,-1
Gigyf1,5,6,231,242,-1
Synj2,2,3,237,242,-1
Ghr,5,6,231,242,-1
Arxes2,8,9,225,242,-1
Synpo2,3,4,235,242,-1
Synpr,2,3,237,242,-1
Gga3,5,6,231,242,-1
Gga2,4,5,233,242,-1
Gfus,3,4,235,242,-1
Sys1,4,5,233,242,-1
Gfm1,3,4,235,242,-1
Krtap12-1,0,1,241,242,-1
Krtap14,0,1,241,242,-1
Krtap16-1,0,1,241,242,-1
Syne1,3,4,235,242,-1
Scgb1b27,9,10,223,242,-1
Klk1,9,10,223,242,-1
Asb3,2,3,237,242,-1
Syde1,5,6,231,242,-1
Klk1b1,2,3,237,242,-1
Tubb2a,2,3,237,242,-1
Ash1l,4,5,233,242,-1
Gjc3,3,4,235,242,-1
Klk8,9,10,223,242,-1
Klra17,4,5,233,242,-1
Scgb2b24,1,2,239,242,-1
Gjb3,8,9,225,242,-1
Cep76,3,4,235,242,-1
Ascl1,1,2,239,242,-1
Klrc1,2,3,237,242,-1
Ascc2,2,3,237,242,-1
Klri1,1,2,239,242,-1
Syna,4,5,233,242,-1
Gja4,9,10,223,242,-1
Kmt2a,3,4,235,242,-1
Scgb2b11,0,1,241,242,-1
Scgb2a2,3,4,235,242,-1
Cfl2,4,5,233,242,-1
Lmx1a,0,1,241,242,-1
Tax1bp3,4,5,233,242,-1
Mapkapk5,3,4,235,242,-1
Map7d1,2,3,237,242,-1
Tas2r106,0,1,241,242,-1
Rpl10,8,9,225,242,-1
Antxr1,4,5,233,242,-1
Antkmt,7,8,227,242,-1
Rpain,4,5,233,242,-1
Foxn2,4,5,233,242,-1
Mapk8ip3,2,3,237,242,-1
Anp32b,3,4,235,242,-1
Mapre2,4,5,233,242,-1
Lnp1,6,7,229,242,-1
Marchf1,7,8,227,242,-1
Foxl2,2,3,237,242,-1
Marchf5,2,3,237,242,-1
Foxl1,4,5,233,242,-1
Marcks,6,7,229,242,-1
Marcksl1,5,6,231,242,-1
Ano6,4,5,233,242,-1
Foxj2,4,5,233,242,-1
Romo1,3,4,235,242,-1
Anxa11,3,4,235,242,-1
Map3k8,2,3,237,242,-1
Anxa4,5,6,231,242,-1
Chmp3,3,4,235,242,-1
Rpl6,5,6,231,242,-1
Chkb,3,4,235,242,-1
Maged2,5,6,231,242,-1
Frmpd1,4,5,233,242,-1
Rpl41,6,7,229,242,-1
Mall,1,2,239,242,-1
Frmd4a,5,6,231,242,-1
Maml3,0,1,241,242,-1
Mamld1,3,4,235,242,-1
Frem2,1,2,239,242,-1
Man1b1,2,3,237,242,-1
Rpl34,3,4,235,242,-1
Fras1,2,3,237,242,-1
Map11,4,5,233,242,-1
Rpl27,6,7,229,242,-1
Map2k1,2,3,237,242,-1
Chmp2b,2,3,237,242,-1
Map3k14,2,3,237,242,-1
Foxr2,0,1,241,242,-1
Ano2,5,6,231,242,-1
Mast3,3,4,235,242,-1
Wdr13,3,4,235,242,-1
Rnf187,2,3,237,242,-1
Med25,4,5,233,242,-1
Tas2r125,1,2,239,242,-1
Med29,3,4,235,242,-1
Rnf183,12,13,217,242,-1
Rnf181,4,5,233,242,-1
Fmn2,1,2,239,242,-1
Wdr82,5,6,231,242,-1
Flt1,3,4,235,242,-1
Meltf,3,4,235,242,-1
Flad1,4,5,233,242,-1
Met,5,6,231,242,-1
Wdr90,1,2,239,242,-1
Chst3,2,3,237,242,-1
Tatdn2,4,5,233,242,-1
Rnf114,3,4,235,242,-1
Mettl26,8,9,225,242,-1
Fkbp3,6,7,229,242,-1
Rnf11,3,4,235,242,-1
Mex3b,4,5,233,242,-1
Rnf185,4,5,233,242,-1
Rnf19b,3,4,235,242,-1
Foxi3,2,3,237,242,-1
Rnf212,8,9,225,242,-1
Tas2r109,0,1,241,242,-1
Robo2,7,8,227,242,-1
Mb21d2,4,5,233,242,-1
Foxe1,0,1,241,242,-1
Mbd3l2,1,2,239,242,-1
Chrd,5,6,231,242,-1
Foxa1,1,2,239,242,-1
Mcemp1,8,9,225,242,-1
Mchr1,5,6,231,242,-1
Mcl1,3,4,235,242,-1
Mcm10,3,4,235,242,-1
Mcm3ap,2,3,237,242,-1
Fnip1,2,3,237,242,-1
Fndc5,9,10,223,242,-1
Fndc4,6,7,229,242,-1
Fndc3b,5,6,231,242,-1
Wdr55,4,5,233,242,-1
Chrna6,1,2,239,242,-1
Mdn1,1,2,239,242,-1
Mageb3,9,10,223,242,-1
Fry,4,5,233,242,-1
Washc5,4,5,233,242,-1
Rtn3,3,4,235,242,-1
Arf6,3,4,235,242,-1
Arf1,3,4,235,242,-1
G6pc3,3,4,235,242,-1
Lrrc28,7,8,227,242,-1
Lrrc3,3,4,235,242,-1
Arap1,8,9,225,242,-1
Vstm2b,6,7,229,242,-1
G430095P16Rik,14,15,213,242,-1
Rsu1,7,8,227,242,-1
Tspoap1,7,8,227,242,-1
Aqp6,7,8,227,242,-1
Lrrc47,2,3,237,242,-1
Rsph6a,8,9,225,242,-1
Rsl24d1,3,4,235,242,-1
Fzd4,2,3,237,242,-1
Lrrc8c,3,4,235,242,-1
Rs1,0,1,241,242,-1
Fyb2,6,7,229,242,-1
Rrp1b,4,5,233,242,-1
Gabarapl2,4,5,233,242,-1
Vsig10,6,7,229,242,-1
Lsg1,4,5,233,242,-1
Rtn4r,9,10,223,242,-1
Gak,4,5,233,242,-1
Lnpk,3,4,235,242,-1
Vps53,3,4,235,242,-1
Lor,5,6,231,242,-1
Rwdd4a,2,3,237,242,-1
Lpar2,3,4,235,242,-1
Rusc1,4,5,233,242,-1
Arhgap17,5,6,231,242,-1
Lpcat1,4,5,233,242,-1
Tspyl2,5,6,231,242,-1
Arhgap12,4,5,233,242,-1
Rundc1,2,3,237,242,-1
Lpin2,2,3,237,242,-1
Lpp,4,5,233,242,-1
Gabre,2,3,237,242,-1
Lrig2,3,4,235,242,-1
Rtn4rl2,7,8,227,242,-1
Gabpa,2,3,237,242,-1
Lrp6,4,5,233,242,-1
Rrp15,3,4,235,242,-1
Lsm1,4,5,233,242,-1
Mageb11,0,1,241,242,-1
Trip11,2,3,237,242,-1
Lysmd1,3,4,235,242,-1
Rps14,3,4,235,242,-1
Lysmd4,4,5,233,242,-1
Rps10,3,4,235,242,-1
Fth1,4,5,233,242,-1
Rplp2,7,8,227,242,-1
Mad1l1,3,4,235,242,-1
Madcam1,6,7,229,242,-1
Maea,4,5,233,242,-1
Mael,6,7,229,242,-1
Maf1,3,4,235,242,-1
Ap3d1,3,4,235,242,-1
Fscn3,6,7,229,242,-1
Magea14,0,1,241,242,-1
Ap3b1,2,3,237,242,-1
Ap2s1,3,4,235,242,-1
Ap2b1,2,3,237,242,-1
Ap2a2,3,4,235,242,-1
Washc4,5,6,231,242,-1
Rps15,3,4,235,242,-1
Rps16,4,5,233,242,-1
Lsm2,3,4,235,242,-1
Rps19bp1,2,3,237,242,-1
Rrbp1,3,4,235,242,-1
Rras,2,3,237,242,-1
Tal2,0,1,241,242,-1
Apol11a,0,1,241,242,-1
Apol10b,6,7,229,242,-1
Ltbr,4,5,233,242,-1
LTO1,4,5,233,242,-1
Furin,6,7,229,242,-1
Aplnr,14,15,213,242,-1
Apln,4,5,233,242,-1
Ly6g6e,8,9,225,242,-1
Rps4x,9,10,223,242,-1
Ly6i,12,13,217,242,-1
Aph1b,5,6,231,242,-1
Ly9,5,6,231,242,-1
Rps27rt,10,11,221,242,-1
Apc,5,6,231,242,-1
Rps21,5,6,231,242,-1
Chic1,5,6,231,242,-1
Rbm42,3,4,235,242,-1
Npnt,2,3,237,242,-1
Agfg1,3,4,235,242,-1
Tnpo2,3,4,235,242,-1
Olfr824,0,1,241,242,-1
Olfr827,0,1,241,242,-1
Tnfsf10,5,6,231,242,-1
Zfp623,5,6,231,242,-1
Olfr836,1,2,239,242,-1
Olfr839-ps1,4,5,233,242,-1
Olfr843,0,1,241,242,-1
Olfr846,2,3,237,242,-1
Cryl1,5,6,231,242,-1
Trav21-dv12,2,3,237,242,-1
Tnip2,3,4,235,242,-1
Prkdc,2,3,237,242,-1
Olfr876,1,2,239,242,-1
Dglucy,8,9,225,242,-1
5530400C23Rik,1,2,239,242,-1
Trav16n,3,4,235,242,-1
Prkcz,3,4,235,242,-1
Dgkk,3,4,235,242,-1
Prkch,2,3,237,242,-1
Csf2,10,11,221,242,-1
Csf2rb,9,10,223,242,-1
Tnni3k,3,4,235,242,-1
Tnp1,10,11,221,242,-1
Olfr806,1,2,239,242,-1
Crtc3,4,5,233,242,-1
Tnfrsf10b,2,3,237,242,-1
Olfr715,3,4,235,242,-1
Tmf1,3,4,235,242,-1
Olfr675,2,3,237,242,-1
Dnaaf5,3,4,235,242,-1
Cript,7,8,227,242,-1
Dmwd,3,4,235,242,-1
Olfr698,0,1,241,242,-1
Olfr699,6,7,229,242,-1
Olfr702,0,1,241,242,-1
Dmrtc1a,6,7,229,242,-1
Olfr713,2,3,237,242,-1
Zfp605,5,6,231,242,-1
Prl3a1,1,2,239,242,-1
Crmp1,0,1,241,242,-1
Tmtc2,1,2,239,242,-1
Olfr745,2,3,237,242,-1
Crocc2,0,1,241,242,-1
Zfp617,2,3,237,242,-1
Olfr768,0,1,241,242,-1
Prl3d3,4,5,233,242,-1
Trav6d-3,2,3,237,242,-1
6430550D23Rik,11,12,219,242,-1
6330411D24Rik,6,7,229,242,-1
Zfp655,5,6,231,242,-1
Desi2,3,4,235,242,-1
P2ry14,9,10,223,242,-1
Prkcb,2,3,237,242,-1
Prim2,3,4,235,242,-1
Trav15-2-dv6-2,2,3,237,242,-1
Orc1,3,4,235,242,-1
Defb28,8,9,225,242,-1
Prex2,4,5,233,242,-1
Osbpl3,3,4,235,242,-1
Defb11,8,9,225,242,-1
Zfp764,6,7,229,242,-1
Otop3,0,1,241,242,-1
Defa36,1,2,239,242,-1
Defa35,2,3,237,242,-1
Otub1,3,4,235,242,-1
Otud3,2,3,237,242,-1
Otud4,2,3,237,242,-1
Defa33,2,3,237,242,-1
Prdm10,1,2,239,242,-1
Prcp,4,5,233,242,-1
Cst8,0,1,241,242,-1
Ovgp1,6,7,229,242,-1
Oxct1,2,3,237,242,-1
Prc1,7,8,227,242,-1
Zfp790,7,8,227,242,-1
4930563E22Rik,4,5,233,242,-1
Opn1mw,5,6,231,242,-1
Opcml,0,1,241,242,-1
Opa1,3,4,235,242,-1
Dennd3,4,5,233,242,-1
Olfr935,0,1,241,242,-1
Olfr937,0,1,241,242,-1
Olfr938,0,1,241,242,-1
Olfr94,2,3,237,242,-1
Olfr945,1,2,239,242,-1
4933417A18Rik,2,3,237,242,-1
Csgalnact2,5,6,231,242,-1
Olfr96,1,2,239,242,-1
Depdc1a,5,6,231,242,-1
Olfr97,0,1,241,242,-1
Olfr972,0,1,241,242,-1
Csnk1a1,5,6,231,242,-1
Zfp672,4,5,233,242,-1
Olfr980,1,2,239,242,-1
Togaram1,2,3,237,242,-1
Prkacb,4,5,233,242,-1
Dek,4,5,233,242,-1
Onecut1,0,1,241,242,-1
Onecut3,0,1,241,242,-1
Csn1s2a,4,5,233,242,-1
Defb47,19,20,203,242,-1
Oog4,1,2,239,242,-1
Tmem9b,4,5,233,242,-1
Trav7-5,2,3,237,242,-1
Tmem92,0,1,241,242,-1
Dnaja2,3,4,235,242,-1
Tmem203,4,5,233,242,-1
Dus1l,2,3,237,242,-1
Prps1,4,5,233,242,-1
Cox8c,14,15,213,242,-1
Tmem207,3,4,235,242,-1
Dtx3l,5,6,231,242,-1
Tmem215,1,2,239,242,-1
Trbj1-3,0,1,241,242,-1
Dthd1,2,3,237,242,-1
Dst,2,3,237,242,-1
A730046J19Rik,1,2,239,242,-1
Cpeb1,3,4,235,242,-1
Olfr419,1,2,239,242,-1
Dsg2,3,4,235,242,-1
Tmem230,4,5,233,242,-1
Tmem231,3,4,235,242,-1
Tmem236,5,6,231,242,-1
Cpeb3,8,9,225,242,-1
Cplane1,18,19,205,242,-1
Olfr449,0,1,241,242,-1
Cplx4,0,1,241,242,-1
Zfp51,5,6,231,242,-1
Olfr459,4,5,233,242,-1
Dus4l,4,5,233,242,-1
Dusp11,6,7,229,242,-1
Prpsap1,3,4,235,242,-1
Tmem189,2,3,237,242,-1
Olfr250,1,2,239,242,-1
Dyrk1a,2,3,237,242,-1
Trbj2-7,0,1,241,242,-1
Cox17,8,9,225,242,-1
Dynlt3,5,6,231,242,-1
Aadacl4fm1,0,1,241,242,-1
Tmem182,4,5,233,242,-1
Olfr290,0,1,241,242,-1
Aadacl2fm1,0,1,241,242,-1
Olfr294,0,1,241,242,-1
Dynap,3,4,235,242,-1
A930003A15Rik,2,3,237,242,-1
Olfr313,0,1,241,242,-1
Prr19,8,9,225,242,-1
Olfr32,1,2,239,242,-1
Zfp456,15,16,211,242,-1
Duxf3,5,6,231,242,-1
Dut,3,4,235,242,-1
A930009A15Rik,2,3,237,242,-1
Prr11,7,8,227,242,-1
Olfr347,0,1,241,242,-1
Trbj1-4,0,1,241,242,-1
Olfr461,4,5,233,242,-1
Tmem247,1,2,239,242,-1
Olfr474,1,2,239,242,-1
9830107B12Rik,2,3,237,242,-1
Tmem52,5,6,231,242,-1
Olfr596,4,5,233,242,-1
Trav7d-6,0,1,241,242,-1
Olfr6,0,1,241,242,-1
9930111J21Rik1,15,16,211,242,-1
Crcp,2,3,237,242,-1
Olfr61,1,2,239,242,-1
Olfr613,4,5,233,242,-1
Tmem64,3,4,235,242,-1
9930022D16Rik,0,1,241,242,-1
Creb3l2,5,6,231,242,-1
Olfr586,1,2,239,242,-1
Dnajb9,8,9,225,242,-1
Zfp58,5,6,231,242,-1
Trav7d-2,3,4,235,242,-1
Olfr638,1,2,239,242,-1
Olfr644,0,1,241,242,-1
Olfr645,2,3,237,242,-1
Dnajb2,6,7,229,242,-1
Prok1,8,9,225,242,-1
Olfr657,0,1,241,242,-1
Olfr658,1,2,239,242,-1
Olfr588-ps1,1,2,239,242,-1
Zfp574,3,4,235,242,-1
Cpne2,8,9,225,242,-1
Olfr512,0,1,241,242,-1
Prpf3,4,5,233,242,-1
Cpne3,6,7,229,242,-1
Olfr48,0,1,241,242,-1
Olfr481,0,1,241,242,-1
Dpy19l1,2,3,237,242,-1
Cpne5,5,6,231,242,-1
Olfr49,2,3,237,242,-1
Cpne6,1,2,239,242,-1
Dppa1,3,4,235,242,-1
Olfr5,1,2,239,242,-1
Tmem266,0,1,241,242,-1
Dnmt3a,5,6,231,242,-1
Cpsf1,4,5,233,242,-1
Tmem28,1,2,239,242,-1
Olfr530,0,1,241,242,-1
Olfr532,2,3,237,242,-1
Olfr536,0,1,241,242,-1
Olfr541,1,2,239,242,-1
A030005L19Rik,13,14,215,242,-1
Olfr559,0,1,241,242,-1
Tmem38b,8,9,225,242,-1
Olfr570,0,1,241,242,-1
P2ry12,6,7,229,242,-1
Zfp820,4,5,233,242,-1
Mylip,4,5,233,242,-1
Pik3ip1,6,7,229,242,-1
Phf12,4,5,233,242,-1
Polr1d,2,3,237,242,-1
Phf2,2,3,237,242,-1
Cysltr1,4,5,233,242,-1
Phf6,4,5,233,242,-1
Traj25,2,3,237,242,-1
Cyren,4,5,233,242,-1
Polk,5,6,231,242,-1
Cypt2,3,4,235,242,-1
1700034I23Rik,6,7,229,242,-1
Cyp7a1,2,3,237,242,-1
Pold4,6,7,229,242,-1
Pi4k2a,3,4,235,242,-1
Pi4kb,4,5,233,242,-1
Picalm,5,6,231,242,-1
Pid1,6,7,229,242,-1
Poc1b,3,4,235,242,-1
Pnpt1,5,6,231,242,-1
Pigo,2,3,237,242,-1
Pigr,4,5,233,242,-1
Pnpla1,1,2,239,242,-1
Cul9,3,4,235,242,-1
Pik3ca,2,3,237,242,-1
Trappc4,7,8,227,242,-1
Polr2h,3,4,235,242,-1
Cyth4,5,6,231,242,-1
Zkscan3,3,4,235,242,-1
Traf3ip2,5,6,231,242,-1
Trappc8,5,6,231,242,-1
Zic2,3,4,235,242,-1
Ctso,5,6,231,242,-1
Daglb,5,6,231,242,-1
Peli1,4,5,233,242,-1
Pou3f3,5,6,231,242,-1
Dact1,4,5,233,242,-1
Pex11a,3,4,235,242,-1
Traf6,4,5,233,242,-1
Pex6,2,3,237,242,-1
Polr2l,4,5,233,242,-1
Pfkl,8,9,225,242,-1
Pomt1,5,6,231,242,-1
Pfn2,3,4,235,242,-1
D6Wsu163e,7,8,227,242,-1
Pgap3,4,5,233,242,-1
D430019H16Rik,2,3,237,242,-1
Polr3e,2,3,237,242,-1
Trappc5,2,3,237,242,-1
D030056L22Rik,3,4,235,242,-1
Pgr15l,0,1,241,242,-1
Znhit2,5,6,231,242,-1
Pik3r1,4,5,233,242,-1
Pramel45,2,3,237,242,-1
Pik3r4,4,5,233,242,-1
Cyp2b13,0,1,241,242,-1
Pls3,5,6,231,242,-1
Zswim1,3,4,235,242,-1
Plrg1,3,4,235,242,-1
Plcb4,2,3,237,242,-1
Plppr4,3,4,235,242,-1
Plce1,3,4,235,242,-1
Cyp26a1,5,6,231,242,-1
Cyb5b,2,3,237,242,-1
Plcxd3,2,3,237,242,-1
Zswim6,3,4,235,242,-1
Pld3,4,5,233,242,-1
Pld5,2,3,237,242,-1
Plpp5,5,6,231,242,-1
Plec,3,4,235,242,-1
Plek2,6,7,229,242,-1
1110057P08Rik,0,1,241,242,-1
Zyg11a,1,2,239,242,-1
Plekhj1,7,8,227,242,-1
Plekho2,3,4,235,242,-1
Cyc1,3,4,235,242,-1
Plgrkt,9,10,223,242,-1
Traj46,0,1,241,242,-1
Cyp2b23,0,1,241,242,-1
Cxxc1,2,3,237,242,-1
Pla2g4e,2,3,237,242,-1
Pmm2,2,3,237,242,-1
Pikfyve,4,5,233,242,-1
Pim3,4,5,233,242,-1
1700025B11Rik,3,4,235,242,-1
Pip4p1,4,5,233,242,-1
Pip5k1a,2,3,237,242,-1
Cux1,2,3,237,242,-1
1700019N19Rik,6,7,229,242,-1
Trap1,3,4,235,242,-1
Trak1,3,4,235,242,-1
Cyp2j6,6,7,229,242,-1
Zranb1,4,5,233,242,-1
Pla2g4d,3,4,235,242,-1
Cyp2j13,4,5,233,242,-1
Cyp2f2,3,4,235,242,-1
Pm20d2,4,5,233,242,-1
Pkia,15,16,211,242,-1
Pklr,6,7,229,242,-1
Traj57,0,1,241,242,-1
Zscan26,4,5,233,242,-1
Pla2g3,1,2,239,242,-1
Cyp2c40,1,2,239,242,-1
Zscan4b,2,3,237,242,-1
Ppargc1b,3,4,235,242,-1
Pdzk1,6,7,229,242,-1
Pdzd8,4,5,233,242,-1
Ppcs,6,7,229,242,-1
Pqbp1,6,7,229,242,-1
Parp6,3,4,235,242,-1
Parp9,6,7,229,242,-1
Ddx18,4,5,233,242,-1
Pprc1,4,5,233,242,-1
Ddx10,3,4,235,242,-1
Ppp6r3,3,4,235,242,-1
4833420G17Rik,4,5,233,242,-1
Ddo,2,3,237,242,-1
Zfp961,7,8,227,242,-1
3425401B19Rik,2,3,237,242,-1
3300002I08Rik,15,16,211,242,-1
Pax7,1,2,239,242,-1
Zfp966,9,10,223,242,-1
Ppp2r5a,2,3,237,242,-1
Ppp2r3c,4,5,233,242,-1
Trav12d-3,5,6,231,242,-1
3110009E18Rik,6,7,229,242,-1
Ddhd1,4,5,233,242,-1
Ddc,2,3,237,242,-1
Ppp2ca,3,4,235,242,-1
Ppp1r9a,5,6,231,242,-1
Ddb2,6,7,229,242,-1
Parp14,4,5,233,242,-1
Parp12,5,6,231,242,-1
Pramel12,6,7,229,242,-1
Paics,3,4,235,242,-1
Zfp827,3,4,235,242,-1
Def6,6,7,229,242,-1
Decr2,5,6,231,242,-1
Zfp869,4,5,233,242,-1
Pacs1,4,5,233,242,-1
Zfp873,5,6,231,242,-1
Padi3,1,2,239,242,-1
Zfp874b,6,7,229,242,-1
Pafah1b2,5,6,231,242,-1
4930470P17Rik,2,3,237,242,-1
Top3a,6,7,229,242,-1
Tor2a,5,6,231,242,-1
Pramel3,0,1,241,242,-1
Ddx56,5,6,231,242,-1
Zfp942,7,8,227,242,-1
Pam16,9,10,223,242,-1
Zfp943,5,6,231,242,-1
Pank1,3,4,235,242,-1
Pappa,1,2,239,242,-1
Ddx3x,6,7,229,242,-1
Tor1aip2,3,4,235,242,-1
Pard3,3,4,235,242,-1
Pcdh11x,0,1,241,242,-1
Pcdh7,3,4,235,242,-1
Ctdspl2,5,6,231,242,-1
Cts3,1,2,239,242,-1
Tprg,3,4,235,242,-1
Tprgl,4,5,233,242,-1
Pdcd11,3,4,235,242,-1
2310009B15Rik,3,4,235,242,-1
Pdcd2l,4,5,233,242,-1
Trav11,2,3,237,242,-1
Pdcd6ip,3,4,235,242,-1
Pde10a,3,4,235,242,-1
Pde12,2,3,237,242,-1
Pde1b,0,1,241,242,-1
Pde9a,7,8,227,242,-1
Zfyve21,6,7,229,242,-1
Dbh,1,2,239,242,-1
Trat1,6,7,229,242,-1
Pdha2,0,1,241,242,-1
Ppih,6,7,229,242,-1
Zgpat,4,5,233,242,-1
Pdlim5,5,6,231,242,-1
Pdp2,6,7,229,242,-1
Ppfia1,2,3,237,242,-1
Zhx1,4,5,233,242,-1
Pdzd2,7,8,227,242,-1
Ppp1r12a,3,4,235,242,-1
Dcbld2,3,4,235,242,-1
Pcdha12,2,3,237,242,-1
Tpi1,2,3,237,242,-1
Pcdha9,2,3,237,242,-1
2700081O15Rik,5,6,231,242,-1
Ppp1r3a,0,1,241,242,-1
Zfp980,9,10,223,242,-1
Pcdhb15,3,4,235,242,-1
Pcdhb18,0,1,241,242,-1
Pcdhb7,1,2,239,242,-1
Zfp989,6,7,229,242,-1
Dctn3,6,7,229,242,-1
2510039O18Rik,2,3,237,242,-1
Pcdhgb2,0,1,241,242,-1
Pcnx4,3,4,235,242,-1
2310079G19Rik,0,1,241,242,-1
Dcpp3,3,4,235,242,-1
Pced1a,2,3,237,242,-1
Zfy2,0,1,241,242,-1
Dclre1a,3,4,235,242,-1
Pcgf3,6,7,229,242,-1
Dclk2,0,1,241,242,-1
Ppp1r18,3,4,235,242,-1
Ppp1r15b,2,3,237,242,-1
Pcnx,3,4,235,242,-1
Prrc2c,4,5,233,242,-1
Prrg1,10,11,221,242,-1
Olfr228,2,3,237,242,-1
Npc1,3,4,235,242,-1
Nmnat2,4,5,233,242,-1
Nmt1,3,4,235,242,-1
Cmc2,4,5,233,242,-1
Qser1,5,6,231,242,-1
Nodal,3,4,235,242,-1
Adam17,2,3,237,242,-1
Nol3,10,11,221,242,-1
Qrfprl,2,3,237,242,-1
Nol7,3,4,235,242,-1
Evi5,4,5,233,242,-1
Nop14,2,3,237,242,-1
Nop16,4,5,233,242,-1
Evc,6,7,229,242,-1
Eva1c,6,7,229,242,-1
Cmpk1,9,10,223,242,-1
Etv6,5,6,231,242,-1
Nostrin,5,6,231,242,-1
Qdpr,6,7,229,242,-1
Zcchc14,2,3,237,242,-1
Etv4,4,5,233,242,-1
Nox1,13,14,215,242,-1
Acy3,2,3,237,242,-1
Zcchc9,7,8,227,242,-1
Rab10,2,3,237,242,-1
Exoc2,2,3,237,242,-1
Cmc1,7,8,227,242,-1
Nkx2-1,5,6,231,242,-1
Adamts12,0,1,241,242,-1
Rab3gap1,3,4,235,242,-1
Nip7,2,3,237,242,-1
Rab3c,2,3,237,242,-1
F13a1,3,4,235,242,-1
F12,6,7,229,242,-1
F11,3,4,235,242,-1
Nipal3,3,4,235,242,-1
Nkap,5,6,231,242,-1
Extl1,1,2,239,242,-1
Nkx2-2,1,2,239,242,-1
Zc3h13,2,3,237,242,-1
Nkx2-3,1,2,239,242,-1
Zbtb7b,8,9,225,242,-1
Clybl,5,6,231,242,-1
Nkx6-1,3,4,235,242,-1
Rab21,3,4,235,242,-1
Nlgn1,2,3,237,242,-1
Nlrp1a,0,1,241,242,-1
Cma2,2,3,237,242,-1
Rab13,10,11,221,242,-1
Exoc6,3,4,235,242,-1
Pyroxd1,2,3,237,242,-1
Acvr2a,3,4,235,242,-1
Tmem174,2,3,237,242,-1
Npffr1,4,5,233,242,-1
Esp15,0,1,241,242,-1
Zdhhc9,7,8,227,242,-1
Zeb2,8,9,225,242,-1
Nrsn1,0,1,241,242,-1
Thbd,4,5,233,242,-1
Nsd3,4,5,233,242,-1
Ptprk,5,6,231,242,-1
Ptprd,4,5,233,242,-1
Zfand3,2,3,237,242,-1
Acpp,6,7,229,242,-1
Ptprc,6,7,229,242,-1
Ptprb,2,3,237,242,-1
Zfat,2,3,237,242,-1
Erp44,5,6,231,242,-1
Nt5m,4,5,233,242,-1
Ptpn21,2,3,237,242,-1
Ptpn14,3,4,235,242,-1
Zfhx3,1,2,239,242,-1
Ptpn12,4,5,233,242,-1
Ptpn11,5,6,231,242,-1
Them7,7,8,227,242,-1
Cnih3,6,7,229,242,-1
Ptk7,3,4,235,242,-1
Esp16,0,1,241,242,-1
Acsm5,2,3,237,242,-1
Ptprz1,1,2,239,242,-1
Pxdc1,6,7,229,242,-1
Etfrf1,5,6,231,242,-1
Pycrl,3,4,235,242,-1
Tgm6,1,2,239,242,-1
Zdhhc18,3,4,235,242,-1
Sec13,4,5,233,242,-1
Actr3,5,6,231,242,-1
Npr1,7,8,227,242,-1
Tgoln1,3,4,235,242,-1
Zdhhc20,5,6,231,242,-1
Tgtp1,17,18,207,242,-1
Esyt2,3,4,235,242,-1
Acta2,9,10,223,242,-1
Esrrg,5,6,231,242,-1
Zdhhc25,0,1,241,242,-1
Pwp2,4,5,233,242,-1
Pwp1,3,4,235,242,-1
Nr2c2ap,6,7,229,242,-1
Nr2e1,2,3,237,242,-1
Esp8,3,4,235,242,-1
Thap11,4,5,233,242,-1
Nrbp2,3,4,235,242,-1
Thap2,5,6,231,242,-1
Adamts15,3,4,235,242,-1
Trim52,0,1,241,242,-1
Adamts19,0,1,241,242,-1
Ngp,10,11,221,242,-1
Nacc2,5,6,231,242,-1
Nadsyn1,4,5,233,242,-1
Rbbp8nl,3,4,235,242,-1
Nagpa,5,6,231,242,-1
Rb1cc1,5,6,231,242,-1
Nalcn,0,1,241,242,-1
Nanog,9,10,223,242,-1
Terf1,2,3,237,242,-1
Fam199x,5,6,231,242,-1
Fam193b,4,5,233,242,-1
Ywhaq,4,5,233,242,-1
Nars,3,4,235,242,-1
Rassf1,4,5,233,242,-1
Trim8,4,5,233,242,-1
Rasip1,2,3,237,242,-1
Adipor2,3,4,235,242,-1
Nat9,2,3,237,242,-1
Adi1,7,8,227,242,-1
Trim75,5,6,231,242,-1
Fam177a2,7,8,227,242,-1
Ncam2,1,2,239,242,-1
Rasd2,2,3,237,242,-1
Adgrl4,9,10,223,242,-1
Naca,5,6,231,242,-1
Nabp2,2,3,237,242,-1
Tep1,4,5,233,242,-1
Myoz1,8,9,225,242,-1
Myo10,3,4,235,242,-1
Myo18b,2,3,237,242,-1
Myo1c,3,4,235,242,-1
Clec2i,10,11,221,242,-1
Teddm2,5,6,231,242,-1
Teddm3,1,2,239,242,-1
Tek,3,4,235,242,-1
Ythdc1,3,4,235,242,-1
Fam222a,3,4,235,242,-1
Rbm26,5,6,231,242,-1
Mypn,2,3,237,242,-1
Naaladl2,0,1,241,242,-1
Myrfl,1,2,239,242,-1
Rbm19,2,3,237,242,-1
Rbm15,2,3,237,242,-1
Ythdf1,3,4,235,242,-1
Naa15,2,3,237,242,-1
Adssl1,2,3,237,242,-1
Adss,2,3,237,242,-1
Ythdf2,4,5,233,242,-1
Rbfox2,2,3,237,242,-1
Fam20c,2,3,237,242,-1
Zar1l,4,5,233,242,-1
Fam172a,5,6,231,242,-1
Nckap1l,5,6,231,242,-1
Rabepk,3,4,235,242,-1
Tex37,2,3,237,242,-1
Clk3,3,4,235,242,-1
Nell1,2,3,237,242,-1
Rad1,2,3,237,242,-1
Trim59,7,8,227,242,-1
Neto1,1,2,239,242,-1
Fahd2a,3,4,235,242,-1
Neurl1a,2,3,237,242,-1
Rabl6,2,3,237,242,-1
Neurod6,1,2,239,242,-1
Fah,7,8,227,242,-1
Adcy2,0,1,241,242,-1
Rabep1,2,3,237,242,-1
Fads6,5,6,231,242,-1
Nfia,9,10,223,242,-1
Adamtsl3,4,5,233,242,-1
Trim54,2,3,237,242,-1
Nfkbiz,4,5,233,242,-1
F8a,2,3,237,242,-1
Rab5if,3,4,235,242,-1
F8,11,12,219,242,-1
Zbtb40,4,5,233,242,-1
Adcy10,0,1,241,242,-1
Nefm,1,2,239,242,-1
Adgrf5,5,6,231,242,-1
Zbtb1,3,4,235,242,-1
Tex10,2,3,237,242,-1
Clec7a,12,13,217,242,-1
Ndel1,2,3,237,242,-1
Adgre4,4,5,233,242,-1
Rapgef2,2,3,237,242,-1
Clhc1,6,7,229,242,-1
Adgrb1,1,2,239,242,-1
Ndrg2,9,10,223,242,-1
Ndrg3,3,4,235,242,-1
Fam162b,1,2,239,242,-1
Rap1gds1,6,7,229,242,-1
Nectin4,5,6,231,242,-1
Fam151a,2,3,237,242,-1
Ndufaf6,5,6,231,242,-1
Ndufb1,5,6,231,242,-1
Adcyap1r1,0,1,241,242,-1
Adcyap1,2,3,237,242,-1
Ndufb4,6,7,229,242,-1
Ralbp1,2,3,237,242,-1
Fam131a,11,12,219,242,-1
Adcy8,1,2,239,242,-1
Neb,6,7,229,242,-1
Erich1,3,4,235,242,-1
Acot11,3,4,235,242,-1
Nudt18,3,4,235,242,-1
Psen2,12,13,217,242,-1
Olfr1325,0,1,241,242,-1
Olfr1328,2,3,237,242,-1
Eif1ad,2,3,237,242,-1
Eid3,14,15,213,242,-1
Olfr1337,1,2,239,242,-1
Olfr1338,1,2,239,242,-1
Olfr1347,0,1,241,242,-1
Ehd2,5,6,231,242,-1
Egr3,9,10,223,242,-1
Colgalt2,2,3,237,242,-1
Zfp358,7,8,227,242,-1
Olfr1378,0,1,241,242,-1
Olfr138,0,1,241,242,-1
Olfr1381,4,5,233,242,-1
Abcd2,3,4,235,242,-1
Abcc9,5,6,231,242,-1
Abcc6,2,3,237,242,-1
Commd1,3,4,235,242,-1
Olfr1388,4,5,233,242,-1
Commd4,6,7,229,242,-1
Abcc4,2,3,237,242,-1
Olfr1393,2,3,237,242,-1
Efhc2,1,2,239,242,-1
Olfr1321,0,1,241,242,-1
Olfr1318,2,3,237,242,-1
Olfr1314,1,2,239,242,-1
Prune2,5,6,231,242,-1
Eif3c,3,4,235,242,-1
Eif3b,3,4,235,242,-1
Eif2s3x,7,8,227,242,-1
Col3a1,10,11,221,242,-1
Tm4sf5,6,7,229,242,-1
Col4a2,3,4,235,242,-1
Eif2b2,4,5,233,242,-1
Prxl2c,3,4,235,242,-1
Olfr1278,0,1,241,242,-1
Abhd16b,5,6,231,242,-1
Olfr1287,0,1,241,242,-1
Olfr1312,2,3,237,242,-1
Olfr1288,0,1,241,242,-1
Olfr1289,0,1,241,242,-1
Trdv5,14,15,213,242,-1
Tm9sf3,4,5,233,242,-1
Olfr1295,1,2,239,242,-1
Olfr1297,0,1,241,242,-1
Col4a4,3,4,235,242,-1
Tmbim6,4,5,233,242,-1
Col5a2,3,4,235,242,-1
Abhd13,4,5,233,242,-1
Tmed2,4,5,233,242,-1
Tmed5,5,6,231,242,-1
Tmem100,3,4,235,242,-1
Olfr173,2,3,237,242,-1
Olfr1511,1,2,239,242,-1
Olfr1513,0,1,241,242,-1
Ech1,5,6,231,242,-1
Olfr159,0,1,241,242,-1
Olfr16,0,1,241,242,-1
Ear6,3,4,235,242,-1
Ear2,14,15,213,242,-1
Ear14,0,1,241,242,-1
Olfr17,3,4,235,242,-1
Olfr172,3,4,235,242,-1
Prss1,1,2,239,242,-1
Copz2,6,7,229,242,-1
Olfr183,5,6,231,242,-1
Olfr187,0,1,241,242,-1
Prrt4,1,2,239,242,-1
Olfr190,1,2,239,242,-1
Coq6,5,6,231,242,-1
E330014E10Rik,0,1,241,242,-1
Olfr195,1,2,239,242,-1
Trbv15,3,4,235,242,-1
Olfr215,2,3,237,242,-1
Olfr218,0,1,241,242,-1
Eci1,3,4,235,242,-1
Olfr1500,0,1,241,242,-1
Olfr1418,0,1,241,242,-1
Edf1,4,5,233,242,-1
Tmem106b,4,5,233,242,-1
Olfr1424,0,1,241,242,-1
Olfr1425,0,1,241,242,-1
Olfr1426,0,1,241,242,-1
Cop1,4,5,233,242,-1
Eef1d,5,6,231,242,-1
Eef1aknmt,2,3,237,242,-1
Olfr1448,1,2,239,242,-1
Abca9,3,4,235,242,-1
Copg1,3,4,235,242,-1
Abca5,5,6,231,242,-1
Ecpas,2,3,237,242,-1
Edem1,3,4,235,242,-1
Olfr1466,0,1,241,242,-1
Olfr1469,1,2,239,242,-1
Edc4,2,3,237,242,-1
Olfr148,0,1,241,242,-1
Ect2l,0,1,241,242,-1
Cops7a,4,5,233,242,-1
Prss3,1,2,239,242,-1
Tmem132e,0,1,241,242,-1
Olfr1493-ps1,0,1,241,242,-1
Abhd4,4,5,233,242,-1
Zfp277,2,3,237,242,-1
Nudt2,6,7,229,242,-1
Olfr1245,3,4,235,242,-1
Acbd4,7,8,227,242,-1
Ocel1,3,4,235,242,-1
Psme4,4,5,233,242,-1
Psme3ip1,4,5,233,242,-1
Psme1,6,7,229,242,-1
Psmd9,4,5,233,242,-1
Odf2,9,10,223,242,-1
Psmd8,4,5,233,242,-1
Epha1,6,7,229,242,-1
Odr4,4,5,233,242,-1
Ofcc1,0,1,241,242,-1
Timm22,5,6,231,242,-1
Cnppd1,5,6,231,242,-1
Psmc3ip,8,9,225,242,-1
Olfr1009,0,1,241,242,-1
Eola1,7,8,227,242,-1
Zfp235,3,4,235,242,-1
Timm8a2,12,13,217,242,-1
Acaa1a,2,3,237,242,-1
Olfr102,5,6,231,242,-1
Timm8b,4,5,233,242,-1
Timm9,3,4,235,242,-1
Entpd3,5,6,231,242,-1
Timd4,4,5,233,242,-1
Obox5,5,6,231,242,-1
Oaz1,3,4,235,242,-1
Ptdss1,4,5,233,242,-1
Nudt4,4,5,233,242,-1
Ptgis,2,3,237,242,-1
Nudt7,10,11,221,242,-1
Thrap3,3,4,235,242,-1
Nup133,3,4,235,242,-1
Nup155,2,3,237,242,-1
Zfp1,2,3,237,242,-1
Trim28,4,5,233,242,-1
Thumpd3,4,5,233,242,-1
Nup88,4,5,233,242,-1
Thy1,8,9,225,242,-1
Oasl2,10,11,221,242,-1
Ptchd1,1,2,239,242,-1
Nwd1,1,2,239,242,-1
Ptcd2,3,4,235,242,-1
Nxnl1,2,3,237,242,-1
Ptbp1,5,6,231,242,-1
Tiam1,3,4,235,242,-1
Nxph2,0,1,241,242,-1
Tiam2,4,5,233,242,-1
Nxt1,4,5,233,242,-1
Cnot10,3,4,235,242,-1
Cntn4,3,4,235,242,-1
Olfr1052,0,1,241,242,-1
Olfr1055,4,5,233,242,-1
Col24a1,4,5,233,242,-1
Olfr1179,0,1,241,242,-1
Psg29,2,3,237,242,-1
Elf4,4,5,233,242,-1
Olfr1188,0,1,241,242,-1
Olfr1192-ps1,0,1,241,242,-1
Elavl1,4,5,233,242,-1
Treml4,4,5,233,242,-1
Olfr1201,0,1,241,242,-1
Olfr1205,2,3,237,242,-1
Olfr1213,1,2,239,242,-1
Olfr122,0,1,241,242,-1
Olfr1166,0,1,241,242,-1
Eif4e3,2,3,237,242,-1
Eif4e,9,10,223,242,-1
Zfp276,5,6,231,242,-1
Col27a1,3,4,235,242,-1
Olfr1233,0,1,241,242,-1
Col28a1,5,6,231,242,-1
Psg18,3,4,235,242,-1
Olfr1239,0,1,241,242,-1
Treh,6,7,229,242,-1
Eif3l,6,7,229,242,-1
Elk1,4,5,233,242,-1
Olfr1161,1,2,239,242,-1
Eno2,4,5,233,242,-1
Olfr1106,1,2,239,242,-1
Eno1b,12,13,217,242,-1
Olfr1062,7,8,227,242,-1
Abra,3,4,235,242,-1
Endou,9,10,223,242,-1
Endog,5,6,231,242,-1
En2,1,2,239,242,-1
Trgv7,1,2,239,242,-1
Eml1,2,3,237,242,-1
Zfp266,4,5,233,242,-1
Tktl2,0,1,241,242,-1
Tlcd2,7,8,227,242,-1
Trgj1,0,1,241,242,-1
Ablim3,2,3,237,242,-1
Tlcd3b,4,5,233,242,-1
Olfr1115,0,1,241,242,-1
Tlcd4,4,5,233,242,-1
Emc7,2,3,237,242,-1
Cobll1,3,4,235,242,-1
Zfp275,4,5,233,242,-1
Elp4,5,6,231,242,-1
Trgj2,0,1,241,242,-1
Olfr1152,5,6,231,242,-1
Sebox,5,6,231,242,-1
Angptl6,6,7,229,242,-1
Ins2,11,12,219,242,-1
Irf2bp1,3,4,235,242,-1
Grk5,5,6,231,242,-1
Skint11,2,3,237,242,-1
Srd5a3,4,5,233,242,-1
Ugt1a6b,12,13,217,242,-1
Btaf1,4,5,233,242,-1
Vmn1r28,0,1,241,242,-1
Igkv4-79,5,6,231,242,-1
Uty,8,9,225,242,-1
Hoxd4,2,3,237,242,-1
Gm44805,9,10,223,242,-1
Slc39a2,3,4,235,242,-1
Styx,6,7,229,242,-1
Hoxd3,7,8,227,242,-1
Gm44579,0,1,241,242,-1
Serpinb1a,17,18,207,242,-1
Slc39a10,4,5,233,242,-1
Avpi1,3,4,235,242,-1
Tysnd1,5,6,231,242,-1
Suclg1,2,3,237,242,-1
Btbd17,4,5,233,242,-1
Gsdmc,2,3,237,242,-1
Gsg1l,2,3,237,242,-1
Gm21974,6,7,229,242,-1
Igkv4-68,6,7,229,242,-1
Gm17402,27,28,187,242,-1
Slc39a8,2,3,237,242,-1
Grid2,0,1,241,242,-1
Cdkn2aipnl,4,5,233,242,-1
Grid2ip,0,1,241,242,-1
Sgo2a,4,5,233,242,-1
Slc44a1,5,6,231,242,-1
Atxn7l3b,2,3,237,242,-1
Hrnr,1,2,239,242,-1
Grin2a,2,3,237,242,-1
Sult1a1,16,17,209,242,-1
Vmn1r93,0,1,241,242,-1
Sulf2,6,7,229,242,-1
Capzb,4,5,233,242,-1
Igkv4-51,4,5,233,242,-1
Sugt1,2,3,237,242,-1
Vmn1r160,0,1,241,242,-1
AU022252,6,7,229,242,-1
Vmn1r9,2,3,237,242,-1
Hrc,4,5,233,242,-1
Suds3,2,3,237,242,-1
Hps4,3,4,235,242,-1
Hps3,5,6,231,242,-1
Avpr1b,1,2,239,242,-1
Srd5a1,2,3,237,242,-1
Usp32,6,7,229,242,-1
Gm26897,1,2,239,242,-1
Slc35e2,3,4,235,242,-1
Gtf2ird1,4,5,233,242,-1
Gm42543,2,3,237,242,-1
Cd38,8,9,225,242,-1
Gm2663,2,3,237,242,-1
Ipo9,4,5,233,242,-1
Ipo13,2,3,237,242,-1
Slc35a4,4,5,233,242,-1
Spag9,2,3,237,242,-1
Gtsf1,13,14,215,242,-1
Slc34a1,4,5,233,242,-1
Hoxc4,4,5,233,242,-1
Sqle,2,3,237,242,-1
Ucn,23,24,195,242,-1
Homer2,1,2,239,242,-1
Gm13547,25,26,191,242,-1
Slc32a1,1,2,239,242,-1
Slc31a2,5,6,231,242,-1
Serpinb8,7,8,227,242,-1
Ubp1,3,4,235,242,-1
Intu,2,3,237,242,-1
Stk24,5,6,231,242,-1
Vmn1r131,0,1,241,242,-1
Spaca9,13,14,215,242,-1
Serpinb6a,3,4,235,242,-1
Gtf2f1,2,3,237,242,-1
Sp6,5,6,231,242,-1
Hoxc13,1,2,239,242,-1
Igkv4-92,4,5,233,242,-1
Vac14,2,3,237,242,-1
Iqcj,1,2,239,242,-1
Sp9,0,1,241,242,-1
Gm43517,2,3,237,242,-1
Gm13287,1,2,239,242,-1
Hoxc12,3,4,235,242,-1
Vmn1r30,7,8,227,242,-1
Btbd3,5,6,231,242,-1
Uevld,7,8,227,242,-1
Gm4302,8,9,225,242,-1
Serpinb3d,0,1,241,242,-1
Vmn1r14,0,1,241,242,-1
Vmn1r139,4,5,233,242,-1
Hoxb3,8,9,225,242,-1
Igkv5-45,8,9,225,242,-1
Capg,10,11,221,242,-1
Vars,7,8,227,242,-1
Ucn3,2,3,237,242,-1
Slc44a3,5,6,231,242,-1
Gria3,7,8,227,242,-1
Ccl17,20,21,201,242,-1
Serpina12,0,1,241,242,-1
Slc6a1,0,1,241,242,-1
Gpr137b,7,8,227,242,-1
Serp1,2,3,237,242,-1
Sod3,2,3,237,242,-1
Gm49322,5,6,231,242,-1
Gpr143,2,3,237,242,-1
Brdt,0,1,241,242,-1
Gpr150,2,3,237,242,-1
Gpr152,4,5,233,242,-1
Gpr153,2,3,237,242,-1
Bcan,3,4,235,242,-1
Utp6,2,3,237,242,-1
Hsp90b1,6,7,229,242,-1
Itpka,1,2,239,242,-1
Brf2,3,4,235,242,-1
Atp6v1a,5,6,231,242,-1
Sinhcaf,6,7,229,242,-1
Gpr165,0,1,241,242,-1
Gm19345,10,11,221,242,-1
Ugt2b5,2,3,237,242,-1
Ubap1l,14,15,213,242,-1
Cdh15,5,6,231,242,-1
Itpripl2,5,6,231,242,-1
Slc6a14,5,6,231,242,-1
Vmn1r177,0,1,241,242,-1
Hspa9,3,4,235,242,-1
Srpx2,6,7,229,242,-1
Cav3,3,4,235,242,-1
Ccdc70,2,3,237,242,-1
Gm21760,3,4,235,242,-1
Gm11060,1,2,239,242,-1
Siglecg,4,5,233,242,-1
Bcas2,3,4,235,242,-1
Sgsm2,2,3,237,242,-1
Cdh10,4,5,233,242,-1
Gm11077,0,1,241,242,-1
Slc6a2,1,2,239,242,-1
Ccdc71l,2,3,237,242,-1
Sgsm1,2,3,237,242,-1
Htr1b,3,4,235,242,-1
Hspg2,5,6,231,242,-1
Usp39,3,4,235,242,-1
Ivd,3,4,235,242,-1
Gpn3,3,4,235,242,-1
Catsper4,15,16,211,242,-1
Vmn1r178,1,2,239,242,-1
Gm21833,7,8,227,242,-1
Usp54,4,5,233,242,-1
Gm1123,7,8,227,242,-1
Gm47995,8,9,225,242,-1
Igkv14-100,7,8,227,242,-1
Vmn2r102,2,3,237,242,-1
Gps1,2,3,237,242,-1
Ccdc93,3,4,235,242,-1
Gm11939,3,4,235,242,-1
Igkv14-126,9,10,223,242,-1
Itfg1,5,6,231,242,-1
Vmn1r169,1,2,239,242,-1
Ugt1a9,7,8,227,242,-1
Card19,7,8,227,242,-1
Sox12,5,6,231,242,-1
Brms1,4,5,233,242,-1
Igkv18-36,7,8,227,242,-1
Gramd1b,5,6,231,242,-1
Slc45a4,4,5,233,242,-1
Ube4b,3,4,235,242,-1
Igkv20-101-2,0,1,241,242,-1
BC029722,3,4,235,242,-1
Cckbr,4,5,233,242,-1
BC028528,11,12,219,242,-1
Grem1,5,6,231,242,-1
Isl1,0,1,241,242,-1
Itga2b,0,1,241,242,-1
Gprc6a,0,1,241,242,-1
Sult2a4,2,3,237,242,-1
Utp20,3,4,235,242,-1
Gpr20,1,2,239,242,-1
Gm11487,11,12,219,242,-1
Gpr25,10,11,221,242,-1
Sos1,5,6,231,242,-1
Serpina1f,3,4,235,242,-1
Gm11562,6,7,229,242,-1
Hsd3b5,1,2,239,242,-1
Gpr45,0,1,241,242,-1
Gpr50,1,2,239,242,-1
Casp3,5,6,231,242,-1
Brinp2,1,2,239,242,-1
Ugt2b36,2,3,237,242,-1
Ugt2b1,0,1,241,242,-1
Vmn2r109,0,1,241,242,-1
Gpr82,3,4,235,242,-1
Gm45902,2,3,237,242,-1
Cdrt4,10,11,221,242,-1
Utp11,5,6,231,242,-1
Igkv13-84,3,4,235,242,-1
Utp18,2,3,237,242,-1
Carm1,4,5,233,242,-1
Camkk2,5,6,231,242,-1
Serpinb9,3,4,235,242,-1
Spast,3,4,235,242,-1
Hcfc1,5,6,231,242,-1
Hgsnat,7,8,227,242,-1
Sf3b2,5,6,231,242,-1
Sfrp2,7,8,227,242,-1
C2cd4c,2,3,237,242,-1
Slc24a5,15,16,211,242,-1
C2cd2l,3,4,235,242,-1
Spink6,3,4,235,242,-1
Hbs1l,3,4,235,242,-1
Vmac,4,5,233,242,-1
Slc24a3,3,4,235,242,-1
Cdk11b,3,4,235,242,-1
Slc25a36,4,5,233,242,-1
Sf3b3,3,4,235,242,-1
Hgf,2,3,237,242,-1
Slc24a1,1,2,239,242,-1
C1rb,12,13,217,242,-1
Il5,3,4,235,242,-1
Spire2,4,5,233,242,-1
Gm28919,1,2,239,242,-1
Hcrtr1,3,4,235,242,-1
Il3ra,4,5,233,242,-1
Sf3b5,2,3,237,242,-1
Slc25a10,4,5,233,242,-1
Vmn1r50,3,4,235,242,-1
Il17a,3,4,235,242,-1
Sprr3,0,1,241,242,-1
Vil1,5,6,231,242,-1
Btf3l4,4,5,233,242,-1
Slc25a32,4,5,233,242,-1
Il12a,5,6,231,242,-1
Setd5,2,3,237,242,-1
C77080,3,4,235,242,-1
Slc25a20,4,5,233,242,-1
Imp3,3,4,235,242,-1
Setd7,4,5,233,242,-1
Setx,4,5,233,242,-1
Btg1c,3,4,235,242,-1
Gm15446,17,18,207,242,-1
Virma,3,4,235,242,-1
Strbp,4,5,233,242,-1
Cdh9,0,1,241,242,-1
Btg3,6,7,229,242,-1
Slc25a18,7,8,227,242,-1
Ubr2,2,3,237,242,-1
Stradb,3,4,235,242,-1
Il9r,4,5,233,242,-1
Cct6a,2,3,237,242,-1
Vmn1r51,1,2,239,242,-1
Hdac10,6,7,229,242,-1
Vmn1r100,0,1,241,242,-1
Il22,3,4,235,242,-1
Gm29776,4,5,233,242,-1
Sprr1b,1,2,239,242,-1
Vmn1r11,0,1,241,242,-1
Sprr2e,4,5,233,242,-1
Bud31,5,6,231,242,-1
Cd200r2,2,3,237,242,-1
Slc22a12,4,5,233,242,-1
Cdipt,2,3,237,242,-1
Vmn1r57,1,2,239,242,-1
Helq,4,5,233,242,-1
B4galt3,6,7,229,242,-1
Vmn1r56,0,1,241,242,-1
Sprr2d,2,3,237,242,-1
Il1rl1,9,10,223,242,-1
Cdip1,4,5,233,242,-1
Il1r1,5,6,231,242,-1
Gm29582,0,1,241,242,-1
Slc20a2,5,6,231,242,-1
Herc1,2,3,237,242,-1
Gm29554,3,4,235,242,-1
Vmn1r53,2,3,237,242,-1
Il21,3,4,235,242,-1
Heca,3,4,235,242,-1
Vmn1r65,5,6,231,242,-1
Cd209c,6,7,229,242,-1
Vmn1r115,0,1,241,242,-1
Il31ra,3,4,235,242,-1
Cd163,6,7,229,242,-1
Hexim2,6,7,229,242,-1
Slc18a3,0,1,241,242,-1
Il17rd,2,3,237,242,-1
Hexa,2,3,237,242,-1
Spopfm2,1,2,239,242,-1
Spopl,5,6,231,242,-1
Vmn1r63,1,2,239,242,-1
Il2ra,3,4,235,242,-1
Sppl2c,0,1,241,242,-1
Slc22a22,5,6,231,242,-1
Cdiptos,6,7,229,242,-1
Slc22a2,3,4,235,242,-1
Il18bp,5,6,231,242,-1
Spring1,2,3,237,242,-1
Hes6,3,4,235,242,-1
Gm2916,10,11,221,242,-1
Sprn,6,7,229,242,-1
Vmn1r52,1,2,239,242,-1
Il11ra2,12,13,217,242,-1
Cct3,3,4,235,242,-1
Stx4a,4,5,233,242,-1
H2ab2,0,1,241,242,-1
Spata32,5,6,231,242,-1
Calm3,4,5,233,242,-1
Hnf1a,4,5,233,242,-1
Slc28a2b,3,4,235,242,-1
Gm1673,17,18,207,242,-1
Insm2,1,2,239,242,-1
Insl5,21,22,199,242,-1
Calcr,0,1,241,242,-1
Slc27a6,4,5,233,242,-1
Insl3,23,24,195,242,-1
Sptssb,4,5,233,242,-1
Ina,2,3,237,242,-1
Insig1,2,3,237,242,-1
Gm14295,16,17,209,242,-1
Cybb,13,14,215,242,-1
Ins1,0,1,241,242,-1
Inpp5k,2,3,237,242,-1
Slc11a2,4,5,233,242,-1
Slc12a1,3,4,235,242,-1
H2ac6,7,8,227,242,-1
Stx11,9,10,223,242,-1
H2aj,3,4,235,242,-1
Spata31d1d,3,4,235,242,-1
Stk35,2,3,237,242,-1
Cd300lb,8,9,225,242,-1
Slc29a4,5,6,231,242,-1
Gusb,5,6,231,242,-1
Hnrnpu,4,5,233,242,-1
Hnrnph3,4,5,233,242,-1
Gypc,4,5,233,242,-1
Igkv8-21,5,6,231,242,-1
Hnrnph2,3,4,235,242,-1
Gzf1,3,4,235,242,-1
Camk2a,7,8,227,242,-1
Stk26,1,2,239,242,-1
Plin3,2,3,237,242,-1
Hnrnpf,3,4,235,242,-1
Baz1a,3,4,235,242,-1
Igkv9-123,6,7,229,242,-1
Ccpg1,3,4,235,242,-1
Caln1,6,7,229,242,-1
H2-DMa,9,10,223,242,-1
Uchl4,7,8,227,242,-1
Insyn2a,2,3,237,242,-1
H2-Eb1,12,13,217,242,-1
H2-M1,0,1,241,242,-1
H2-M10.1,3,4,235,242,-1
Stk38l,3,4,235,242,-1
Specc1,3,4,235,242,-1
Vmn1r74,2,3,237,242,-1
Slc15a3,9,10,223,242,-1
Inhba,2,3,237,242,-1
Stt3a,7,8,227,242,-1
Ing4,3,4,235,242,-1
H3c14,16,17,209,242,-1
Cacna1f,0,1,241,242,-1
Strit1,4,5,233,242,-1
Il10ra,5,6,231,242,-1
Hipk2,2,3,237,242,-1
H4c1,17,18,207,242,-1
Inafm2,3,4,235,242,-1
Cdh8,1,2,239,242,-1
Gm28539,14,15,213,242,-1
Hip1r,4,5,233,242,-1
Spin2e,5,6,231,242,-1
Hip1,3,4,235,242,-1
Cabs1,0,1,241,242,-1
Slc16a13,12,13,217,242,-1
Gm28551,7,8,227,242,-1
H4f16,3,4,235,242,-1
Ccser1,3,4,235,242,-1
Ubxn7,4,5,233,242,-1
Ighj3,0,1,241,242,-1
Gm1604b,2,3,237,242,-1
Cacng6,2,3,237,242,-1
Gm14326,9,10,223,242,-1
Hmgcl,6,7,229,242,-1
H2al1n,1,2,239,242,-1
Inpp4b,4,5,233,242,-1
Uba1,3,4,235,242,-1
Sptlc3,2,3,237,242,-1
B230219D22Rik,5,6,231,242,-1
Spef1l,9,10,223,242,-1
H2al2c,2,3,237,242,-1
Hmga1,5,6,231,242,-1
Vmn1r73,3,4,235,242,-1
Slc12a8,5,6,231,242,-1
Ccr9,3,4,235,242,-1
Cacnb3,4,5,233,242,-1
Inip,3,4,235,242,-1
Slc25a5,6,7,229,242,-1
Gm28269,5,6,231,242,-1
Sptbn1,2,3,237,242,-1
Slc25a47,2,3,237,242,-1
H2bc4,6,7,229,242,-1
Inhbc,0,1,241,242,-1
Spg21,3,4,235,242,-1
Gpbp1,4,5,233,242,-1
Ston1,5,6,231,242,-1
Ccdc110,6,7,229,242,-1
Bend4,4,5,233,242,-1
Sh3bp4,4,5,233,242,-1
Smim3,7,8,227,242,-1
Vmn2r25,2,3,237,242,-1
Smim31,3,4,235,242,-1
Ccdc137,4,5,233,242,-1
Smim40-ps,10,11,221,242,-1
Vmn1r191,1,2,239,242,-1
Shank2,3,4,235,242,-1
Ighv5-12-4,2,3,237,242,-1
Atp2a2,2,3,237,242,-1
Slco1b2,0,1,241,242,-1
Slco1a6,11,12,219,242,-1
Boc,3,4,235,242,-1
Ccdc138,4,5,233,242,-1
Smim27,5,6,231,242,-1
Sh3pxd2a,2,3,237,242,-1
Ighv3-5,3,4,235,242,-1
Smim24,11,12,219,242,-1
Ccdc22,3,4,235,242,-1
Slco3a1,3,4,235,242,-1
Ift57,7,8,227,242,-1
Gna11,7,8,227,242,-1
Srxn1,5,6,231,242,-1
Slfn4,6,7,229,242,-1
Sh3tc1,3,4,235,242,-1
Bcl2l1,3,4,235,242,-1
Selenos,2,3,237,242,-1
Kbtbd8,4,5,233,242,-1
Smg7,3,4,235,242,-1
Snrpn,3,4,235,242,-1
Kcna1,1,2,239,242,-1
Gm7879,27,28,187,242,-1
Gnaz,5,6,231,242,-1
Igdcc3,3,4,235,242,-1
Sema4g,4,5,233,242,-1
Usp24,2,3,237,242,-1
Gm10722,26,27,189,242,-1
Smo,5,6,231,242,-1
Igfbp5,5,6,231,242,-1
Bop1,3,4,235,242,-1
Uqcrh,4,5,233,242,-1
Vmn2r28,4,5,233,242,-1
Ube2o,2,3,237,242,-1
Gm20441,12,13,217,242,-1
Shoc1,0,1,241,242,-1
Icosl,7,8,227,242,-1
Igfals,8,9,225,242,-1
Vmn1r208,3,4,235,242,-1
Snrpc,4,5,233,242,-1
Sh3glb1,5,6,231,242,-1
Unc119,7,8,227,242,-1
Gm20883,1,2,239,242,-1
Igf2,3,4,235,242,-1
Gm5431,4,5,233,242,-1
Bin2,3,4,235,242,-1
Id2,10,11,221,242,-1
Stac2,3,4,235,242,-1
Kat5,5,6,231,242,-1
Sema4b,4,5,233,242,-1
Gng10,8,9,225,242,-1
Shmt1,3,4,235,242,-1
Gne,6,7,229,242,-1
Sema3f,5,6,231,242,-1
Umps,3,4,235,242,-1
Igdcc4,1,2,239,242,-1
Gm815,1,2,239,242,-1
Kcna10,2,3,237,242,-1
Vmn1r185,1,2,239,242,-1
Kcne4,3,4,235,242,-1
Gm10337,18,19,205,242,-1
Bmp15,1,2,239,242,-1
Smap1,4,5,233,242,-1
Vmn2r22,0,1,241,242,-1
Ssh3,7,8,227,242,-1
Vmn1r199,0,1,241,242,-1
Shc4,2,3,237,242,-1
Unc13b,3,4,235,242,-1
Gm50457,2,3,237,242,-1
Ighv1-74,4,5,233,242,-1
Ifitm1,11,12,219,242,-1
Txndc11,3,4,235,242,-1
Ifnar2,6,7,229,242,-1
Slitrk6,3,4,235,242,-1
Ighv1-77,7,8,227,242,-1
Bclaf3,5,6,231,242,-1
Atp13a1,3,4,235,242,-1
Bco1,9,10,223,242,-1
Ccdc3,2,3,237,242,-1
Bmp1,3,4,235,242,-1
Gm9,2,3,237,242,-1
Gm5127,1,2,239,242,-1
Bloc1s6,2,3,237,242,-1
Kcnh1,0,1,241,242,-1
Gm8882,0,1,241,242,-1
Bmi1,5,6,231,242,-1
Susd1,5,6,231,242,-1
Stap1,6,7,229,242,-1
Bco2,3,4,235,242,-1
Ssna1,3,4,235,242,-1
Cda,11,12,219,242,-1
Gm21119,13,14,215,242,-1
Slitrk3,1,2,239,242,-1
Smarca4,3,4,235,242,-1
Gm10439,3,4,235,242,-1
Smcp,6,7,229,242,-1
Kcnj16,5,6,231,242,-1
Supt16,5,6,231,242,-1
Shisa8,7,8,227,242,-1
Vmn1r234,1,2,239,242,-1
Bnc1,0,1,241,242,-1
Gm9925,15,16,211,242,-1
Gm9918,3,4,235,242,-1
Atp1b3,3,4,235,242,-1
Gm21366,0,1,241,242,-1
Shisa6,1,2,239,242,-1
Bloc1s1,4,5,233,242,-1
Vmn1r231,0,1,241,242,-1
Selenoo,2,3,237,242,-1
Cd8b1,9,10,223,242,-1
Ushbp1,4,5,233,242,-1
Smbd1,7,8,227,242,-1
Ssr2,5,6,231,242,-1
Cemip2,6,7,229,242,-1
Urm1,2,3,237,242,-1
Ighv16-1,0,1,241,242,-1
Smarcd3,6,7,229,242,-1
Ighv1-66,4,5,233,242,-1
Gm21256,2,3,237,242,-1
Cd9,5,6,231,242,-1
Gm9736,0,1,241,242,-1
Supv3l1,3,4,235,242,-1
Vmn1r228,2,3,237,242,-1
Gm20730,5,6,231,242,-1
Kcnj10,6,7,229,242,-1
Ighv1-43,5,6,231,242,-1
Secisbp2l,4,5,233,242,-1
Kcns1,3,4,235,242,-1
Srrt,2,3,237,242,-1
Kcnq2,5,6,231,242,-1
Vmn1r24,1,2,239,242,-1
St3gal4,9,10,223,242,-1
Gon7,5,6,231,242,-1
Cblb,3,4,235,242,-1
Snd1,3,4,235,242,-1
Sec14l3,4,5,233,242,-1
Ccdc160,4,5,233,242,-1
Ube2m,5,6,231,242,-1
Cblif,2,3,237,242,-1
Cdc42bpa,5,6,231,242,-1
Usp3,3,4,235,242,-1
Jpt2,4,5,233,242,-1
Sema6c,8,9,225,242,-1
Ighv1-16,0,1,241,242,-1
Slc7a15,1,2,239,242,-1
Vmn1r211,0,1,241,242,-1
Kcnmb4,9,10,223,242,-1
Ighv7-2,0,1,241,242,-1
Ighv1-15,8,9,225,242,-1
Upf1,3,4,235,242,-1
Ighv8-6,0,1,241,242,-1
Smurf2,3,4,235,242,-1
Cdc37,3,4,235,242,-1
Kcnq4,0,1,241,242,-1
Bfsp1,4,5,233,242,-1
Vmn2r130,0,1,241,242,-1
Septin11,6,7,229,242,-1
Ceacam16,4,5,233,242,-1
Smtnl2,2,3,237,242,-1
Kcns2,1,2,239,242,-1
Gm11011,12,13,217,242,-1
Ighv1-23,5,6,231,242,-1
Atp5j,4,5,233,242,-1
Cbfa2t3,4,5,233,242,-1
Ica1l,0,1,241,242,-1
Bpifa5,2,3,237,242,-1
Huwe1,6,7,229,242,-1
Septin2,2,3,237,242,-1
Gm21708,1,2,239,242,-1
Kcns3,3,4,235,242,-1
Josd1,2,3,237,242,-1
Ighv7-4,3,4,235,242,-1
Smu1,4,5,233,242,-1
St6gal2,0,1,241,242,-1
Ube3b,2,3,237,242,-1
Slc7a8,7,8,227,242,-1
Jam2,6,7,229,242,-1
Gm49394,1,2,239,242,-1
St6galnac5,1,2,239,242,-1
Srsf10,4,5,233,242,-1
Ccdc184,10,11,221,242,-1
Ceacam15,0,1,241,242,-1
Stat2,4,5,233,242,-1
Igfl3,0,1,241,242,-1
Stau2,6,7,229,242,-1
Snrpa,5,6,231,242,-1
St8sia5,3,4,235,242,-1
Ceacam5,1,2,239,242,-1
Bhlhe23,0,1,241,242,-1
Vmn1r217,1,2,239,242,-1
Kank4,2,3,237,242,-1
Septin6,4,5,233,242,-1
Gm5965,1,2,239,242,-1
Ighv6-6,3,4,235,242,-1
Jup,4,5,233,242,-1
Cbln2,1,2,239,242,-1
Uqcr10,3,4,235,242,-1
Sec22a,5,6,231,242,-1
Kcnv2,1,2,239,242,-1
Gm5926,4,5,233,242,-1
Golga1,2,3,237,242,-1
Ube2h,3,4,235,242,-1
Kctd10,2,3,237,242,-1
Ighv1-37,5,6,231,242,-1
Hmgb2,6,8,228,242,-2
Rbm28,2,4,236,242,-2
Psph,3,5,234,242,-2
Elof1,3,5,234,242,-2
Cnot3,3,5,234,242,-2
Tigd3,2,4,236,242,-2
Mterf4,2,4,236,242,-2
Vmn1r2,2,4,236,242,-2
Ercc2,3,5,234,242,-2
Zfp141,4,6,232,242,-2
Aifm3,3,5,234,242,-2
Obox1,4,6,232,242,-2
Gm20937,3,5,234,242,-2
Obox3,6,8,228,242,-2
Rbm27,4,6,232,242,-2
Hlx,12,14,216,242,-2
Sptbn2,2,4,236,242,-2
Ube2u,12,14,216,242,-2
Cd300ld,5,7,230,242,-2
Blzf1,5,7,230,242,-2
Trir,2,4,236,242,-2
Hmg20b,2,4,236,242,-2
Acat2,2,4,236,242,-2
Psmg1,3,5,234,242,-2
Acat3,8,10,224,242,-2
Gm29133,2,4,236,242,-2
Trip12,5,7,230,242,-2
Slc12a7,4,6,232,242,-2
Slc12a6,3,5,234,242,-2
Zfp182,7,9,226,242,-2
Eloc,4,6,232,242,-2
Myocd,1,3,238,242,-2
Mtf2,4,6,232,242,-2
Gm20830,3,5,234,242,-2
Myl4,6,8,228,242,-2
Recql4,3,5,234,242,-2
Cog8,2,4,236,242,-2
Yme1l1,4,6,232,242,-2
Btbd35f5,1,3,238,242,-2
Bicd1,4,6,232,242,-2
Myo3b,2,4,236,242,-2
Mtap,7,9,226,242,-2
Cnnm2,4,6,232,242,-2
Bicc1,4,6,232,242,-2
Myo1a,2,4,236,242,-2
Epx,3,5,234,242,-2
Agbl1,0,2,240,242,-2
Ptch1,6,8,228,242,-2
Trim24,4,6,232,242,-2
Acer1,7,9,226,242,-2
Ptbp2,5,7,230,242,-2
Slbp,2,4,236,242,-2
Ptbp3,2,4,236,242,-2
Ptcd1,7,9,226,242,-2
Nxf3,10,12,220,242,-2
Herc4,3,5,234,242,-2
Tial1,4,6,232,242,-2
Ube2v1,2,4,236,242,-2
Elp1,2,4,236,242,-2
Erbb4,3,5,234,242,-2
Bysl,2,4,236,242,-2
Bhmt2,4,6,232,242,-2
Oasl1,3,5,234,242,-2
Bloc1s3,3,5,234,242,-2
Psrc1,14,16,212,242,-2
Rbm4,3,5,234,242,-2
Tedc2,1,3,238,242,-2
Olfr1157,1,3,238,242,-2
Cdc40,3,5,234,242,-2
Erc2,2,4,236,242,-2
Elob,5,7,230,242,-2
Tigd2,2,4,236,242,-2
Fam240b,0,2,240,242,-2
Clcn3,2,4,236,242,-2
Afmid,7,9,226,242,-2
Tifab,8,10,224,242,-2
Mynn,4,6,232,242,-2
St6galnac3,10,12,220,242,-2
Tifa,5,7,230,242,-2
Olfr1167,3,5,234,242,-2
Zfp142,2,4,236,242,-2
Oaf,9,11,222,242,-2
Elmod2,5,7,230,242,-2
Coa3,4,6,232,242,-2
Elp3,3,5,234,242,-2
Zfp207,5,7,230,242,-2
Ubr1,2,4,236,242,-2
Enox2,8,10,224,242,-2
Igfn1,3,5,234,242,-2
Mtmr7,6,8,228,242,-2
Sprr2j-ps,3,5,234,242,-2
Olfr1048,0,2,240,242,-2
Spryd3,3,5,234,242,-2
Tcp1,4,6,232,242,-2
Cd27,8,10,224,242,-2
Cntn3,0,2,240,242,-2
Rd3l,1,3,238,242,-2
Higd1b,15,17,210,242,-2
Mup20,5,7,230,242,-2
Ensa,2,4,236,242,-2
Psmb5,2,4,236,242,-2
Cntn1,0,2,240,242,-2
Sh3glb2,3,5,234,242,-2
Gm28036,12,14,216,242,-2
Rdh16f1,11,13,218,242,-2
Mup5,3,5,234,242,-2
Ube2n,4,6,232,242,-2
Timp2,5,7,230,242,-2
Olfr103,2,4,236,242,-2
Olfr1029,4,6,232,242,-2
Cntf,22,24,196,242,-2
Farsa,3,5,234,242,-2
Btnl4,4,6,232,242,-2
Eml3,3,5,234,242,-2
Igfbpl1,0,2,240,242,-2
Fancm,4,6,232,242,-2
Olfr1094,0,2,240,242,-2
Mturn,3,5,234,242,-2
Mtss2,4,6,232,242,-2
Cdc25a,4,6,232,242,-2
Slc17a5,5,7,230,242,-2
Muc20,3,5,234,242,-2
Triap1,3,5,234,242,-2
Tjp1,3,5,234,242,-2
Tcp10b,5,7,230,242,-2
Tcta,3,5,234,242,-2
Btn2a2,6,8,228,242,-2
Eml4,2,4,236,242,-2
Abracl,6,8,228,242,-2
Muc5b,0,2,240,242,-2
Slc17a3,3,5,234,242,-2
Rc3h1,4,6,232,242,-2
Bicdl2,8,10,224,242,-2
Eno3,3,5,234,242,-2
Tinagl1,5,7,230,242,-2
Mtpap,4,6,232,242,-2
Slc17a1,4,6,232,242,-2
Fars2,3,5,234,242,-2
Ahcyl2,2,4,236,242,-2
Emg1,3,5,234,242,-2
Ahcyl1,2,4,236,242,-2
Timmdc1,3,5,234,242,-2
Fam71f2,9,11,222,242,-2
Timm23,3,5,234,242,-2
Emc3,4,6,232,242,-2
Cd2bp2,3,5,234,242,-2
Agrn,2,4,236,242,-2
Epg5,3,5,234,242,-2
Psmd3,2,4,236,242,-2
Olfr113,5,7,230,242,-2
Sharpin,2,4,236,242,-2
Olfr1130,0,2,240,242,-2
Emc10,2,4,236,242,-2
Rbm5,3,5,234,242,-2
Mtfr1,2,4,236,242,-2
Fam83d,4,6,232,242,-2
Cd209f,4,6,232,242,-2
Ofd1,2,4,236,242,-2
Hjv,0,2,240,242,-2
Sst,2,4,236,242,-2
Rdx,3,5,234,242,-2
Shc1,3,5,234,242,-2
Olfr114,0,2,240,242,-2
Slc14a1,2,4,236,242,-2
Ssrp1,4,6,232,242,-2
Myh10,3,5,234,242,-2
Tdrd3,3,5,234,242,-2
Hivep1,5,7,230,242,-2
Olah,5,7,230,242,-2
Cobl,3,5,234,242,-2
Mxra8,3,5,234,242,-2
Olfr1023,1,3,238,242,-2
Olfr112,1,3,238,242,-2
Olfr1122,2,4,236,242,-2
St3gal1,6,8,228,242,-2
Xrn2,2,4,236,242,-2
Ssu2,1,3,238,242,-2
Agtr2,1,3,238,242,-2
Xrra1,2,4,236,242,-2
Mx2,5,7,230,242,-2
Eomes,3,5,234,242,-2
Zfp219,4,6,232,242,-2
Olfr1012,1,3,238,242,-2
Emc4,4,6,232,242,-2
Gm28490,3,5,234,242,-2
Fam83e,9,11,222,242,-2
Cnst,2,4,236,242,-2
Mtfr2,6,8,228,242,-2
Emc6,2,4,236,242,-2
Acad10,3,5,234,242,-2
Epb41l3,3,5,234,242,-2
Spta1,0,2,240,242,-2
Rbms1,4,6,232,242,-2
Acad8,3,5,234,242,-2
Cnpy4,2,4,236,242,-2
Btf3,3,5,234,242,-2
Rad21,2,4,236,242,-2
Cdadc1,2,4,236,242,-2
Exosc10,5,7,230,242,-2
Zc3h12c,3,5,234,242,-2
Hsd17b14,5,7,230,242,-2
Ibtk,2,4,236,242,-2
Rapgef1,2,4,236,242,-2
Borcs6,3,5,234,242,-2
Nlrp5,0,2,240,242,-2
Exoc5,5,7,230,242,-2
Srgap3,7,9,226,242,-2
Borcs5,2,4,236,242,-2
Ice2,4,6,232,242,-2
Icmt,2,4,236,242,-2
Ndc1,4,6,232,242,-2
Gm10228,8,10,224,242,-2
Tll1,1,3,238,242,-2
Rapgefl1,0,2,240,242,-2
Brix1,6,8,228,242,-2
Vmn1r184,2,4,236,242,-2
Ercc8,3,5,234,242,-2
Nlrp10,4,6,232,242,-2
Sirpb1b,6,8,228,242,-2
Ndufa12,4,6,232,242,-2
Brinp1,5,7,230,242,-2
Fam161b,2,4,236,242,-2
Sirt1,4,6,232,242,-2
Bpgm,5,7,230,242,-2
Sirt2,3,5,234,242,-2
Nle1,6,8,228,242,-2
Fam162a,5,7,230,242,-2
Sri,7,9,226,242,-2
Exosc4,4,6,232,242,-2
Srsf1,3,5,234,242,-2
Nlk,2,4,236,242,-2
Rab1a,4,6,232,242,-2
Tfpt,3,5,234,242,-2
Fam168b,2,4,236,242,-2
Nme7,3,5,234,242,-2
Zc3h14,4,6,232,242,-2
Rara,2,4,236,242,-2
Brpf1,3,5,234,242,-2
Nol8,5,7,230,242,-2
Nom1,2,4,236,242,-2
Fam171b,2,4,236,242,-2
Adgrg6,2,4,236,242,-2
Ncf2,7,9,226,242,-2
Evc2,4,6,232,242,-2
Nop58,2,4,236,242,-2
Ncbp3,3,5,234,242,-2
Srf,5,7,230,242,-2
Gm21953,2,4,236,242,-2
Rasgef1a,3,5,234,242,-2
Fam177a,11,13,218,242,-2
Nos2,4,6,232,242,-2
Srsf5,4,6,232,242,-2
Cmip,2,4,236,242,-2
Bola2,4,6,232,242,-2
Ubfd1,3,5,234,242,-2
Exd1,3,5,234,242,-2
Qtrt2,2,4,236,242,-2
Zc3h18,3,5,234,242,-2
Exd2,4,6,232,242,-2
Sirt5,3,5,234,242,-2
Nmt2,4,6,232,242,-2
Rarres2,10,12,220,242,-2
Adam1a,6,8,228,242,-2
Ncoa3,2,4,236,242,-2
Nnat,9,11,222,242,-2
Nnt,3,5,234,242,-2
Qsox1,3,5,234,242,-2
Nod1,8,10,224,242,-2
Hs6st2,1,3,238,242,-2
Hs3st5,4,6,232,242,-2
Ext1,2,4,236,242,-2
Nkiras1,4,6,232,242,-2
Extl3,5,7,230,242,-2
Faap100,3,5,234,242,-2
Faf1,3,5,234,242,-2
Nf2,2,4,236,242,-2
Bpnt2,5,7,230,242,-2
Bptf,3,5,234,242,-2
Fads2,4,6,232,242,-2
Braf,4,6,232,242,-2
Zbtb37,5,7,230,242,-2
Brat1,2,4,236,242,-2
Fam122a,3,5,234,242,-2
Nfic,3,5,234,242,-2
Rae1,2,4,236,242,-2
Fam122b,5,7,230,242,-2
Hspb6,3,5,234,242,-2
Nfix,2,4,236,242,-2
Hus1b,8,10,224,242,-2
Clk1,6,8,228,242,-2
Gm21776,1,3,238,242,-2
Nectin2,4,6,232,242,-2
Net1,3,5,234,242,-2
Clk4,5,7,230,242,-2
Nelfa,3,5,234,242,-2
Rac3,5,7,230,242,-2
Tex49,22,24,196,242,-2
Nek9,2,4,236,242,-2
Htra2,4,6,232,242,-2
Htt,2,4,236,242,-2
Neurod2,0,2,240,242,-2
Adcy4,8,10,224,242,-2
Rad52,2,4,236,242,-2
Rad54b,8,10,224,242,-2
Zbtb21,4,6,232,242,-2
Srpr,2,4,236,242,-2
Adarb1,1,3,238,242,-2
Gm21820,3,5,234,242,-2
F9,2,4,236,242,-2
Eya1,2,4,236,242,-2
Nfxl1,2,4,236,242,-2
Tfap4,6,8,228,242,-2
Ezr,2,4,236,242,-2
Rab37,5,7,230,242,-2
Zbtb14,5,7,230,242,-2
Cd74,11,13,218,242,-2
Ranbp10,2,4,236,242,-2
Nit1,3,5,234,242,-2
Nit2,4,6,232,242,-2
Rangap1,5,7,230,242,-2
Rab33a,6,8,228,242,-2
Clta,4,6,232,242,-2
Ndufa3,6,8,228,242,-2
Cltc,3,5,234,242,-2
Ndufa13,2,4,236,242,-2
Nkapd1,3,5,234,242,-2
Hsf2bp,5,7,230,242,-2
Gm21858,5,7,230,242,-2
Cd5l,4,6,232,242,-2
Sin3a,2,4,236,242,-2
Sidt1,6,8,228,242,-2
Adamts7,1,3,238,242,-2
Vmn1r173,0,2,240,242,-2
Rab4a,7,9,226,242,-2
Rai14,2,4,236,242,-2
F7,0,2,240,242,-2
Ndufs3,4,6,232,242,-2
Nicn1,5,7,230,242,-2
Nhlrc3,2,4,236,242,-2
Tex16,5,7,230,242,-2
Sin3b,4,6,232,242,-2
Siah1b,4,6,232,242,-2
Clip2,2,4,236,242,-2
Trim62,1,3,238,242,-2
Ncald,10,12,220,242,-2
Tespa1,8,10,224,242,-2
Srsf9,2,4,236,242,-2
Naa10,3,5,234,242,-2
Thbs3,3,5,234,242,-2
Nt5c3,7,9,226,242,-2
Erp29,2,4,236,242,-2
Nt5dc3,2,4,236,242,-2
Ero1b,5,7,230,242,-2
Bmp4,9,11,222,242,-2
Clec2m,1,3,238,242,-2
Ptpn2,4,6,232,242,-2
Rbm10,2,4,236,242,-2
Acox3,5,7,230,242,-2
Bmp3,1,3,238,242,-2
Htr5b,5,7,230,242,-2
Ntmt1,2,4,236,242,-2
Clec2l,4,6,232,242,-2
Homer1,4,6,232,242,-2
Gm26657,3,5,234,242,-2
Ptpra,4,6,232,242,-2
Btbd35f20,0,2,240,242,-2
Clec3a,3,5,234,242,-2
Hoxa7,5,7,230,242,-2
Trim32,4,6,232,242,-2
Acsf3,3,5,234,242,-2
Nacc1,3,5,234,242,-2
Acsf2,6,8,228,242,-2
Nrxn3,1,3,238,242,-2
Nsd2,2,4,236,242,-2
Ythdf3,4,6,232,242,-2
Vmn1r132,0,2,240,242,-2
Nab2,5,7,230,242,-2
Acsbg1,9,11,222,242,-2
Gm21149,9,11,222,242,-2
Ptprh,2,4,236,242,-2
Nsmce4a,2,4,236,242,-2
Fam217a,6,8,228,242,-2
N4bp3,5,7,230,242,-2
Ptprs,2,4,236,242,-2
Cngb1,7,9,226,242,-2
Nudt22,4,6,232,242,-2
Ubqln1,5,7,230,242,-2
Gm21103,6,8,228,242,-2
Ptgr1,9,11,222,242,-2
Slain1,2,4,236,242,-2
Ergic3,2,4,236,242,-2
Thoc3,2,4,236,242,-2
Myrf,2,4,236,242,-2
Hnrnpc,3,5,234,242,-2
Numa1,2,4,236,242,-2
Hnrnpa3,4,6,232,242,-2
Ereg,2,4,236,242,-2
Nup153,4,6,232,242,-2
Slain2,4,6,232,242,-2
Ptges2,4,6,232,242,-2
Nudt21,5,7,230,242,-2
Tenm2,0,2,240,242,-2
Tent2,2,4,236,242,-2
Ptma,4,6,232,242,-2
Aebp2,2,4,236,242,-2
Cnih1,5,7,230,242,-2
Nuak2,4,6,232,242,-2
Rbm14,4,6,232,242,-2
Ptp4a2,3,5,234,242,-2
Nucb1,2,4,236,242,-2
Mzt1,4,6,232,242,-2
Hnrnpk,4,6,232,242,-2
Rbm18,2,4,236,242,-2
Nudcd3,2,4,236,242,-2
Cnih4,5,7,230,242,-2
Nudt10,2,4,236,242,-2
Thnsl2,6,8,228,242,-2
Skor2,0,2,240,242,-2
Esm1,7,9,226,242,-2
Hoxa9,4,6,232,242,-2
Notch2,4,6,232,242,-2
Nat8f1,8,10,224,242,-2
Cd47,5,7,230,242,-2
Npm2,12,14,216,242,-2
Adipor1,2,4,236,242,-2
Actr2,3,5,234,242,-2
Nat8l,2,4,236,242,-2
Bsnd,3,5,234,242,-2
Fam185a,2,4,236,242,-2
Cd40lg,2,4,236,242,-2
Npsr1,1,3,238,242,-2
Yy1,3,5,234,242,-2
Btbd1,3,5,234,242,-2
Esyt1,7,9,226,242,-2
Npy4r,0,2,240,242,-2
Hoxd8,5,7,230,242,-2
Nat8f4,3,5,234,242,-2
Srebf2,2,4,236,242,-2
Actr5,3,5,234,242,-2
Nphp4,2,4,236,242,-2
Etl4,8,10,224,242,-2
Nbdy,6,8,228,242,-2
Pyurf,5,7,230,242,-2
Zcchc4,3,5,234,242,-2
Ska3,3,5,234,242,-2
Acvr2b,2,4,236,242,-2
Ski,3,5,234,242,-2
Npepps,2,4,236,242,-2
Vmn1r16,2,4,236,242,-2
Pygl,2,4,236,242,-2
Gm21970,19,21,202,242,-2
Nbas,2,4,236,242,-2
Naxd,2,4,236,242,-2
Nav3,0,2,240,242,-2
Nav2,3,5,234,242,-2
Pwwp2a,2,4,236,242,-2
Bnip2,2,4,236,242,-2
Rbck1,2,4,236,242,-2
Rasl11b,8,10,224,242,-2
Esp4,3,5,234,242,-2
Raver1,4,6,232,242,-2
Actb,8,10,224,242,-2
Nrarp,2,4,236,242,-2
Ifi211,8,10,224,242,-2
Ifi214,5,7,230,242,-2
Rbbp4,2,4,236,242,-2
Hoxc11,3,5,234,242,-2
Nags,2,4,236,242,-2
Thap3,6,8,228,242,-2
Ifi27,8,10,224,242,-2
Gm2381,5,7,230,242,-2
Ywhab,5,7,230,242,-2
Bmpr1b,3,5,234,242,-2
Shisa5,6,8,228,242,-2
Actg1,4,6,232,242,-2
Srcin1,4,6,232,242,-2
Rassf4,5,7,230,242,-2
Bnip1,4,6,232,242,-2
Ubl3,3,5,234,242,-2
Nr1h2,4,6,232,242,-2
Nars2,3,5,234,242,-2
Cmtr2,4,6,232,242,-2
Btbd11,2,4,236,242,-2
Cd4,4,6,232,242,-2
Pvalb,5,7,230,242,-2
Thap1,4,6,232,242,-2
Fam189a1,1,3,238,242,-2
Clec4a3,11,13,218,242,-2
Cd3g,13,15,214,242,-2
Napg,4,6,232,242,-2
Zdhhc3,2,4,236,242,-2
Btbd18,1,3,238,242,-2
Hsd17b11,7,9,226,242,-2
Tmem139,10,12,220,242,-2
Cd207,1,3,238,242,-2
Golim4,5,7,230,242,-2
Ctdsp1,5,7,230,242,-2
Ddi1,0,2,240,242,-2
Ppp2r1a,5,7,230,242,-2
Ppp2cb,2,4,236,242,-2
Golga2,2,4,236,242,-2
Pcdh1,4,6,232,242,-2
Umodl1,0,2,240,242,-2
2900026A02Rik,4,6,232,242,-2
Ppp1r3g,3,5,234,242,-2
Pcdh19,3,5,234,242,-2
Ccdc57,2,4,236,242,-2
Slc8b1,6,8,228,242,-2
Ppp1r3f,2,4,236,242,-2
Ppp1r3d,3,5,234,242,-2
Pcdhb13,0,2,240,242,-2
Gm49450,17,19,206,242,-2
Gnl1,2,4,236,242,-2
Dcun1d2,3,5,234,242,-2
Gngt2,8,10,224,242,-2
Ppp2r3d,5,7,230,242,-2
Paxx,5,7,230,242,-2
Ctbp2,4,6,232,242,-2
Ppp2r5c,2,4,236,242,-2
Slc7a2,2,4,236,242,-2
Parn,3,5,234,242,-2
Ctc1,2,4,236,242,-2
Cbfa2t2,2,4,236,242,-2
4921517D22Rik,1,3,238,242,-2
Pptc7,3,5,234,242,-2
Ddx19a,3,5,234,242,-2
Parva,3,5,234,242,-2
Cbfb,5,7,230,242,-2
Usp30,5,7,230,242,-2
4921507P07Rik,2,4,236,242,-2
Tpbg,1,3,238,242,-2
Zfp958,4,6,232,242,-2
Ddost,3,5,234,242,-2
Pate7,1,3,238,242,-2
Ctdnep1,3,5,234,242,-2
Pax2,2,4,236,242,-2
Golph3l,3,5,234,242,-2
Pax8,8,10,224,242,-2
Pcdhb2,4,6,232,242,-2
Tpgs2,4,6,232,242,-2
Pcdhb5,1,3,238,242,-2
Dctpp1,3,5,234,242,-2
Gm49721,4,6,232,242,-2
Slco2b1,7,9,226,242,-2
Pdap1,2,4,236,242,-2
Dcaf4,6,8,228,242,-2
Tpsab1,4,6,232,242,-2
Gna13,3,5,234,242,-2
Gmpr2,3,5,234,242,-2
Ppme1,4,6,232,242,-2
Pdcl,4,6,232,242,-2
Ctrl,11,13,218,242,-2
2310002L09Rik,0,2,240,242,-2
Usp15,4,6,232,242,-2
Ppm1l,2,4,236,242,-2
Usp14,2,4,236,242,-2
2210418O10Rik,4,6,232,242,-2
Pde7a,4,6,232,242,-2
Pde7b,6,8,228,242,-2
Ppip5k1,4,6,232,242,-2
Ppil4,4,6,232,242,-2
Trav11d,4,6,232,242,-2
Cbx8,3,5,234,242,-2
Slco1c1,1,3,238,242,-2
Cbx5,3,5,234,242,-2
Pcdhb8,9,11,222,242,-2
2610028H24Rik,6,8,228,242,-2
Usp19,3,5,234,242,-2
Slc9a9,0,2,240,242,-2
Ctla2a,11,13,218,242,-2
Cbx3,3,5,234,242,-2
Tpm3-rs7,12,14,216,242,-2
Tpp2,3,5,234,242,-2
Pcid2,3,5,234,242,-2
Ppp1r12b,2,4,236,242,-2
Dchs2,1,3,238,242,-2
Ctnnal1,6,8,228,242,-2
Gnat2,5,7,230,242,-2
Zfyve19,2,4,236,242,-2
Snx30,4,6,232,242,-2
Cbx7,5,7,230,242,-2
Ppp1r12c,2,4,236,242,-2
Pcsk6,4,6,232,242,-2
Gpaa1,3,5,234,242,-2
Gpalpp1,2,4,236,242,-2
Slc1a5,4,6,232,242,-2
Ormdl2,6,8,228,242,-2
Osbpl10,4,6,232,242,-2
Osbpl11,5,7,230,242,-2
Osbpl2,4,6,232,242,-2
4931422A03Rik,12,14,216,242,-2
Prelid3b,4,6,232,242,-2
Oser1,5,7,230,242,-2
Csrp2,8,10,224,242,-2
Prdx5,2,4,236,242,-2
Ost4,3,5,234,242,-2
Ccdc81,7,9,226,242,-2
Prdm5,3,5,234,242,-2
Otop2,0,2,240,242,-2
Uhmk1,4,6,232,242,-2
Prdm16,2,4,236,242,-2
Otud5,2,4,236,242,-2
Zfp773,5,7,230,242,-2
Usp49,4,6,232,242,-2
Defa31,6,8,228,242,-2
Ovol3,15,17,210,242,-2
Cspp1,6,8,228,242,-2
Trav14d-3-dv8,11,13,218,242,-2
4921539E11Rik,0,2,240,242,-2
Orc2,3,5,234,242,-2
Dennd2d,5,7,230,242,-2
Usp9x,4,6,232,242,-2
Olfr984,2,4,236,242,-2
4933407L21Rik,16,18,208,242,-2
Gm4756,7,9,226,242,-2
Slc51b,6,8,228,242,-2
4933403O08Rik,0,2,240,242,-2
Gpr34,6,8,228,242,-2
Gpr33,0,2,240,242,-2
Defb5,1,3,238,242,-2
Usp6nl,2,4,236,242,-2
Trav15d-2-dv6d-2,2,4,236,242,-2
Casp8ap2,5,7,230,242,-2
Trav15-1-dv6-1,0,2,240,242,-2
Oprl1,3,5,234,242,-2
Optn,2,4,236,242,-2
Sorcs3,0,2,240,242,-2
Defb3,0,2,240,242,-2
Orai3,4,6,232,242,-2
Oxa1l,3,5,234,242,-2
Sod1,3,5,234,242,-2
Usp43,1,3,238,242,-2
Slc6a17,4,6,232,242,-2
Zfp9,2,4,236,242,-2
Pak1,3,5,234,242,-2
Pak1ip1,2,4,236,242,-2
4930453N24Rik,2,4,236,242,-2
Pald1,7,9,226,242,-2
Palld,3,5,234,242,-2
Tor1a,3,5,234,242,-2
Gpbar1,12,14,216,242,-2
Ddx51,3,5,234,242,-2
Ddx43,3,5,234,242,-2
4930412O13Rik,5,7,230,242,-2
Slc7a11,3,5,234,242,-2
Pappa2,1,3,238,242,-2
Trav13d-1,2,4,236,242,-2
Zfp947,2,4,236,242,-2
Ctbp1,4,6,232,242,-2
4930402H24Rik,4,6,232,242,-2
Gpat3,8,10,224,242,-2
Ddx39b,3,5,234,242,-2
Ulk1,4,6,232,242,-2
Zfp879,2,4,236,242,-2
Pafah2,4,6,232,242,-2
Gpkow,5,7,230,242,-2
Oxld1,6,8,228,242,-2
Oxnad1,7,9,226,242,-2
Pramel7,2,4,236,242,-2
Gpn2,2,4,236,242,-2
4930562C15Rik,5,7,230,242,-2
Cstf2t,2,4,236,242,-2
Gpn1,5,7,230,242,-2
Cstf3,2,4,236,242,-2
P3h2,4,6,232,242,-2
Pafah1b3,2,4,236,242,-2
P3h3,3,5,234,242,-2
Socs5,3,5,234,242,-2
Zfp839,4,6,232,242,-2
Pabpc4l,10,12,220,242,-2
Pramel39,5,7,230,242,-2
Zfp84,3,5,234,242,-2
Pacc1,5,7,230,242,-2
Paf1,2,4,236,242,-2
Cts6,0,2,240,242,-2
Gmds,2,4,236,242,-2
Pdgfc,4,6,232,242,-2
1700024B05Rik,6,8,228,242,-2
Snrpd3,8,10,224,242,-2
Znrf4,2,4,236,242,-2
1700021F07Rik,2,4,236,242,-2
Pip5k1c,4,6,232,242,-2
Gm7694,2,4,236,242,-2
Cux2,5,7,230,242,-2
Pmvk,3,5,234,242,-2
Pitpna,2,4,236,242,-2
Pmpca,3,5,234,242,-2
Gm7544,2,4,236,242,-2
Tram1,4,6,232,242,-2
Pitpnm2,3,5,234,242,-2
1700017B05Rik,5,7,230,242,-2
Smim9,13,15,214,242,-2
Piwil4,1,3,238,242,-2
Zranb2,5,7,230,242,-2
Snrpb,3,5,234,242,-2
Pmf1,3,5,234,242,-2
Pkd2,4,6,232,242,-2
Pip4k2c,3,5,234,242,-2
Pink1,3,5,234,242,-2
Gmcl1,4,6,232,242,-2
Pim2,5,7,230,242,-2
Cul2,5,7,230,242,-2
Trappc12,2,4,236,242,-2
Smg1,3,5,234,242,-2
Pigk,2,4,236,242,-2
Urgcp,4,6,232,242,-2
1700029H14Rik,2,4,236,242,-2
Gm525,9,11,222,242,-2
Pigt,2,4,236,242,-2
Cyp4a12b,2,4,236,242,-2
Pnpla2,4,6,232,242,-2
1700029F12Rik,2,4,236,242,-2
Ccdc24,17,19,206,242,-2
Smim13,3,5,234,242,-2
Pik3c2a,2,4,236,242,-2
Pnmal2,2,4,236,242,-2
Urb1,1,3,238,242,-2
Znrd2,5,7,230,242,-2
Pilrb2,16,18,208,242,-2
1700025G04Rik,3,5,234,242,-2
Unc93b1,8,10,224,242,-2
Snrnp40,4,6,232,242,-2
Pkib,3,5,234,242,-2
Plxnd1,2,4,236,242,-2
Zswim5,2,4,236,242,-2
Cyp20a1,3,5,234,242,-2
Uprt,7,9,226,242,-2
Pld1,5,7,230,242,-2
Plpp6,2,4,236,242,-2
Sned1,1,3,238,242,-2
Smurf1,2,4,236,242,-2
Gm6309,7,9,226,242,-2
Gm6268,0,2,240,242,-2
Smyd4,2,4,236,242,-2
Gm5849,5,7,230,242,-2
Smyd5,2,4,236,242,-2
Plekhg2,2,4,236,242,-2
Zyg11b,2,4,236,242,-2
1110008P14Rik,4,6,232,242,-2
Gm5862,8,10,224,242,-2
Plekho1,4,6,232,242,-2
Upf3b,4,6,232,242,-2
Plg,1,3,238,242,-2
Zswim4,2,4,236,242,-2
1700001C19Rik,7,9,226,242,-2
Gm648,5,7,230,242,-2
Smox,6,8,228,242,-2
Plxnc1,3,5,234,242,-2
1700013H16Rik,1,3,238,242,-2
1700013G24Rik,1,3,238,242,-2
Snrnp25,6,8,228,242,-2
Gm7072,5,7,230,242,-2
Gm5698,6,8,228,242,-2
Cxcr6,8,10,224,242,-2
Ccdc153,9,11,222,242,-2
Pla2g6,5,7,230,242,-2
Cyp27b1,6,8,228,242,-2
Uqcc2,3,5,234,242,-2
Gm6614,0,2,240,242,-2
Pltp,9,11,222,242,-2
Cyp2c23,8,10,224,242,-2
Upf3a,3,5,234,242,-2
Zswim3,4,6,232,242,-2
Snip1,2,4,236,242,-2
Traj52,1,3,238,242,-2
Pofut2,3,5,234,242,-2
1700030J22Rik,5,7,230,242,-2
Pold1,2,4,236,242,-2
Daam2,6,8,228,242,-2
Gm9733,6,8,228,242,-2
Snx25,3,5,234,242,-2
Ppard,3,5,234,242,-2
1810013L24Rik,3,5,234,242,-2
Ppan,2,4,236,242,-2
Ctsq,0,2,240,242,-2
Traf5,3,5,234,242,-2
Peli2,6,8,228,242,-2
Dad1,3,5,234,242,-2
Dact3,0,2,240,242,-2
Pes1,2,4,236,242,-2
Pou3f1,2,4,236,242,-2
Ctsr,0,2,240,242,-2
Pex14,3,5,234,242,-2
Pot1a,6,8,228,242,-2
Pex26,5,7,230,242,-2
Dab2ip,2,4,236,242,-2
Gm5105,1,3,238,242,-2
Snx13,6,8,228,242,-2
Ppat,3,5,234,242,-2
Usp11,2,4,236,242,-2
Dapk2,5,7,230,242,-2
Gm9844,30,32,180,242,-2
Snx27,3,5,234,242,-2
Pdhx,4,6,232,242,-2
Ppif,2,4,236,242,-2
Dazap2,4,6,232,242,-2
Ppic,7,9,226,242,-2
Pdk3,2,4,236,242,-2
Trabd2b,2,4,236,242,-2
Ctsj,0,2,240,242,-2
Slirp,4,6,232,242,-2
Zhx3,4,6,232,242,-2
Ppfibp2,3,5,234,242,-2
Ppfibp1,2,4,236,242,-2
Tradd,10,12,220,242,-2
Ppfia3,2,4,236,242,-2
Pds5a,4,6,232,242,-2
Pdxdc1,4,6,232,242,-2
Pdxk,4,6,232,242,-2
Pdxp,1,3,238,242,-2
Zkscan8,4,6,232,242,-2
Pfdn5,4,6,232,242,-2
Phtf1,2,4,236,242,-2
Pfkfb4,2,4,236,242,-2
Polr2c,3,5,234,242,-2
Polr1f,3,5,234,242,-2
Smap2,3,5,234,242,-2
Phf10,2,4,236,242,-2
Ccdc127,4,6,232,242,-2
Smarcal1,4,6,232,242,-2
Smarcb1,3,5,234,242,-2
Phf20,5,7,230,242,-2
Polr1a,2,4,236,242,-2
Polq,2,4,236,242,-2
Gm8265,12,14,216,242,-2
Zmynd15,8,10,224,242,-2
Cypt14,1,3,238,242,-2
Phldb3,3,5,234,242,-2
Gm5157,4,6,232,242,-2
Phlpp2,2,4,236,242,-2
Phospho1,9,11,222,242,-2
Polh,2,4,236,242,-2
Polg2,6,8,228,242,-2
Phc2,2,4,236,242,-2
Polr2e,3,5,234,242,-2
Phb,3,5,234,242,-2
Pgc,3,5,234,242,-2
Pfn3,10,12,220,242,-2
Pfn5,1,3,238,242,-2
D7Ertd443e,5,7,230,242,-2
Usf1,5,7,230,242,-2
Use1,2,4,236,242,-2
D630003M21Rik,1,3,238,242,-2
Pom121,3,5,234,242,-2
Pgbd1,3,5,234,242,-2
Usb1,5,7,230,242,-2
Zmpste24,5,7,230,242,-2
Polr3gl,2,4,236,242,-2
Smad4,2,4,236,242,-2
Polr3b,2,4,236,242,-2
Polr3a,2,4,236,242,-2
Traj2,2,4,236,242,-2
Urod,2,4,236,242,-2
Snw1,2,4,236,242,-2
Ctu1,6,8,228,242,-2
Caskin1,0,2,240,242,-2
Dennd4a,3,5,234,242,-2
Casc3,4,6,232,242,-2
Olfr155,0,2,240,242,-2
Ebf4,2,4,236,242,-2
Olfr168,0,2,240,242,-2
Cacnb1,2,4,236,242,-2
Vdac2,3,5,234,242,-2
Tmem14c,4,6,232,242,-2
Prrx1,2,4,236,242,-2
Cacnb4,1,3,238,242,-2
H2az1,3,5,234,242,-2
Olfr194,1,3,238,242,-2
H2ax,5,7,230,242,-2
Zfp410,4,6,232,242,-2
Tmem150c,3,5,234,242,-2
Coq8a,7,9,226,242,-2
Tmem154,4,6,232,242,-2
Tmem156,9,11,222,242,-2
Prrt1,3,5,234,242,-2
Tmem167,4,6,232,242,-2
E130309D02Rik,2,4,236,242,-2
Tmem176a,7,9,226,242,-2
Prss27,4,6,232,242,-2
Ecd,4,6,232,242,-2
Spata2,2,4,236,242,-2
Ubxn8,4,6,232,242,-2
Tmem131l,2,4,236,242,-2
Vezf1,4,6,232,242,-2
Cops4,7,9,226,242,-2
Cacna1b,10,12,220,242,-2
Edaradd,0,2,240,242,-2
Edar,1,3,238,242,-2
Slc25a39,3,5,234,242,-2
Cacna1c,3,5,234,242,-2
Olfr149,4,6,232,242,-2
Cacna1d,2,4,236,242,-2
Olfr1494,1,3,238,242,-2
Olfr1497,0,2,240,242,-2
Tmem134,3,5,234,242,-2
Olfr15,2,4,236,242,-2
Copz1,3,5,234,242,-2
Echdc3,6,8,228,242,-2
Cacna1i,6,8,228,242,-2
Cacna2d1,2,4,236,242,-2
Spic,8,10,224,242,-2
H2al1o,1,3,238,242,-2
Olfr229,0,2,240,242,-2
Tmem177,4,6,232,242,-2
Dytn,2,4,236,242,-2
Cox5b,5,7,230,242,-2
Ccr2,5,7,230,242,-2
Vax1,4,6,232,242,-2
Prr15l,5,7,230,242,-2
Prr13,6,8,228,242,-2
Dusp7,4,6,232,242,-2
Calm1,2,4,236,242,-2
Spata5,2,4,236,242,-2
Olfr341,0,2,240,242,-2
Slc29a1,6,8,228,242,-2
Olfr351,3,5,234,242,-2
A930004D18Rik,6,8,228,242,-2
Olfr365,2,4,236,242,-2
Calm5,2,4,236,242,-2
Olfr376,1,3,238,242,-2
Ccpg1os,12,14,216,242,-2
Vat1l,2,4,236,242,-2
Cpa3,2,4,236,242,-2
Olfr393,5,7,230,242,-2
Spata7,2,4,236,242,-2
Dync1li1,2,4,236,242,-2
Dync2i2,5,7,230,242,-2
Olfr275,0,2,240,242,-2
Cacng4,2,4,236,242,-2
Cox15,4,6,232,242,-2
Dyrk4,8,10,224,242,-2
H2al1b,1,3,238,242,-2
Olfr26,0,2,240,242,-2
Olfr262,1,3,238,242,-2
Olfr266,1,3,238,242,-2
Cacng7,1,3,238,242,-2
Tmem181a,3,5,234,242,-2
H2ab3,9,11,222,242,-2
Olfr285,2,4,236,242,-2
Vcpip1,2,4,236,242,-2
Aadacl2fm3,1,3,238,242,-2
Gm3543,6,8,228,242,-2
Zfp445,4,6,232,242,-2
Cadm3,1,3,238,242,-2
Ccr7,3,5,234,242,-2
Prr3,4,6,232,242,-2
Trbv26,2,4,236,242,-2
Spin2f,4,6,232,242,-2
Spin2g,3,5,234,242,-2
Olfr129,1,3,238,242,-2
Heatr5a,2,4,236,242,-2
Spred2,3,5,234,242,-2
C1qc,7,9,226,242,-2
Spr,5,7,230,242,-2
Tm4sf1,7,9,226,242,-2
Slc22a27,0,2,240,242,-2
Hdgfl2,2,4,236,242,-2
Sppl3,4,6,232,242,-2
Eif3i,3,5,234,242,-2
Olfr1259,1,3,238,242,-2
Psd2,1,3,238,242,-2
Hdac5,3,5,234,242,-2
Spop,2,4,236,242,-2
Olfr1264,2,4,236,242,-2
Abhd18,4,6,232,242,-2
Tm6sf1,4,6,232,242,-2
Cd164,5,7,230,242,-2
Zfp280c,8,10,224,242,-2
Slc23a2,4,6,232,242,-2
Heatr6,2,4,236,242,-2
Eif4b,2,4,236,242,-2
Olfr1226,2,4,236,242,-2
Elac2,2,4,236,242,-2
Tll2,0,2,240,242,-2
C030006K11Rik,5,7,230,242,-2
Helz2,2,4,236,242,-2
Col17a1,0,2,240,242,-2
Helz,2,4,236,242,-2
Psg26,0,2,240,242,-2
Helt,3,5,234,242,-2
Psg25,0,2,240,242,-2
Olfr12,2,4,236,242,-2
Eif4e1b,8,10,224,242,-2
Ubr4,3,5,234,242,-2
Eif4h,3,5,234,242,-2
Tlr6,11,13,218,242,-2
Eif4g1,4,6,232,242,-2
Olfr1217,3,5,234,242,-2
Trem3,7,9,226,242,-2
Eif4ebp1,5,7,230,242,-2
Gm2a,4,6,232,242,-2
Eif2ak4,3,5,234,242,-2
Hcn3,2,4,236,242,-2
Copa,3,5,234,242,-2
Hcn1,1,3,238,242,-2
Zfp345,2,4,236,242,-2
Zfp352,3,5,234,242,-2
Abce1,5,7,230,242,-2
Slc25a21,7,9,226,242,-2
Harbi1,7,9,226,242,-2
Slc25a29,3,5,234,242,-2
Slc25a3,3,5,234,242,-2
Hamp2,17,19,206,242,-2
Efna1,5,7,230,242,-2
Prss37,3,5,234,242,-2
Efl1,3,5,234,242,-2
Gm3298,24,26,192,242,-2
Commd8,3,5,234,242,-2
Olfr1413,0,2,240,242,-2
Hadha,2,4,236,242,-2
Tmem101,3,5,234,242,-2
Hacd1,4,6,232,242,-2
Habp4,2,4,236,242,-2
Cct2,5,7,230,242,-2
Tmed1,2,4,236,242,-2
Prss44,2,4,236,242,-2
Tmco5,2,4,236,242,-2
Eid2b,2,4,236,242,-2
Tm9sf4,4,6,232,242,-2
Tma7,6,8,228,242,-2
Cct7,8,10,224,242,-2
Zfp30,4,6,232,242,-2
Ubxn6,3,5,234,242,-2
Col6a4,5,7,230,242,-2
Tmcc1,3,5,234,242,-2
Eif1,3,5,234,242,-2
Abcg5,0,2,240,242,-2
Colec12,2,4,236,242,-2
Tmcc3,5,7,230,242,-2
Vit,1,3,238,242,-2
Olfr1344,3,5,234,242,-2
Ehd1,2,4,236,242,-2
Ehbp1,3,5,234,242,-2
Slc25a17,3,5,234,242,-2
Col9a3,0,2,240,242,-2
Colec10,0,2,240,242,-2
Zfp473,3,5,234,242,-2
Slc2a12,7,9,226,242,-2
Tnrc6c,2,4,236,242,-2
Dlx1,2,4,236,242,-2
Prl7a1,1,3,238,242,-2
Dlst,3,5,234,242,-2
Dll3,3,5,234,242,-2
Zfp612,2,4,236,242,-2
Prl6a1,0,2,240,242,-2
Olfr761,1,3,238,242,-2
Dlgap5,5,7,230,242,-2
Dlgap4,4,6,232,242,-2
Olfr765,0,2,240,242,-2
Tmx4,3,5,234,242,-2
Grip1,1,3,238,242,-2
Slc41a1,3,5,234,242,-2
Dlec1,6,8,228,242,-2
Prl3b1,0,2,240,242,-2
Slc43a1,3,5,234,242,-2
Olfr784,4,6,232,242,-2
Olfr798,2,4,236,242,-2
Prl2b1,0,2,240,242,-2
Sox3,1,3,238,242,-2
8030462N17Rik,5,7,230,242,-2
Zfp608,2,4,236,242,-2
Slc2a13,2,4,236,242,-2
Zfp607a,2,4,236,242,-2
Olfr70,1,3,238,242,-2
Crlf2,2,4,236,242,-2
Tmprss7,6,8,228,242,-2
9130230L23Rik,7,9,226,242,-2
Olfr710,0,2,240,242,-2
Ccl25,4,6,232,242,-2
Dmrt1,1,3,238,242,-2
Olfr715b,3,5,234,242,-2
Olfr718-ps1,2,4,236,242,-2
Capza1,6,8,228,242,-2
Grm3,1,3,238,242,-2
Slc39a6,3,5,234,242,-2
Grk6,5,7,230,242,-2
Olfr729,5,7,230,242,-2
Tmub1,5,7,230,242,-2
Tmx1,3,5,234,242,-2
Prl8a8,0,2,240,242,-2
Olfr734,1,3,238,242,-2
Olfr736,0,2,240,242,-2
Tnfrsf18,7,9,226,242,-2
Dido1,3,5,234,242,-2
Crybb1,6,8,228,242,-2
Diaph2,7,9,226,242,-2
5430403G16Rik,1,3,238,242,-2
Ccdc97,2,4,236,242,-2
Card14,2,4,236,242,-2
Dgkb,7,9,226,242,-2
Olfr912,1,3,238,242,-2
Tnni2,26,28,188,242,-2
Tnpo1,4,6,232,242,-2
Prkcd,2,4,236,242,-2
Det1,5,7,230,242,-2
Tnpo3,2,4,236,242,-2
Slc4a1ap,3,5,234,242,-2
Olfr933,0,2,240,242,-2
Utp14a,3,5,234,242,-2
Carnmt1,4,6,232,242,-2
Derl1,2,4,236,242,-2
Gpr89,5,7,230,242,-2
Dera,6,8,228,242,-2
Depp1,16,18,208,242,-2
Sowahd,2,4,236,242,-2
Cse1l,4,6,232,242,-2
Slc47a2,2,4,236,242,-2
Olfr894,0,2,240,242,-2
Olfr860,0,2,240,242,-2
Tnfrsf8,1,3,238,242,-2
Olfr832,0,2,240,242,-2
Dhx34,3,5,234,242,-2
Tnfsf12,10,12,220,242,-2
Tnfsf15,5,7,230,242,-2
Dhx15,3,5,234,242,-2
Prkn,11,13,218,242,-2
Grb7,6,8,228,242,-2
Zfp628,3,5,234,242,-2
Prkd3,4,6,232,242,-2
Trav19,5,7,230,242,-2
Sox2,3,5,234,242,-2
Tnk1,7,9,226,242,-2
Olfr874,0,2,240,242,-2
Olfr877,2,4,236,242,-2
Dhdds,4,6,232,242,-2
Tnks2,6,8,228,242,-2
Olfr891,0,2,240,242,-2
Tmprss11g,1,3,238,242,-2
Ugt1a6a,14,16,212,242,-2
Slc39a13,3,5,234,242,-2
Olfr549,2,4,236,242,-2
Camkk1,4,6,232,242,-2
Slc31a1,5,7,230,242,-2
Gucy2e,0,2,240,242,-2
Ccnk,5,7,230,242,-2
Olfr484,0,2,240,242,-2
Cpne4,8,10,224,242,-2
Zfp52,6,8,228,242,-2
Gm40460,0,2,240,242,-2
Cpox,2,4,236,242,-2
Dpm3,3,5,234,242,-2
Zfp521,5,7,230,242,-2
Dph2,2,4,236,242,-2
Olfr518,3,5,234,242,-2
Cpsf2,2,4,236,242,-2
Olfr525,3,5,234,242,-2
Gtpbp4,4,6,232,242,-2
Gm4181,2,4,236,242,-2
Tmem29,7,9,226,242,-2
Gm42416,1,3,238,242,-2
Prpf31,2,4,236,242,-2
Ccno,2,4,236,242,-2
Prpf38b,3,5,234,242,-2
Cplx2,4,6,232,242,-2
Prph2,0,2,240,242,-2
Olfr403,1,3,238,242,-2
Cpd,4,6,232,242,-2
Spata19,6,8,228,242,-2
Prph,7,9,226,242,-2
H13,2,4,236,242,-2
Gzmf,1,3,238,242,-2
Prpf4b,3,5,234,242,-2
Olfr447,1,3,238,242,-2
Dpysl5,0,2,240,242,-2
Camk2b,2,4,236,242,-2
Ccnt2,4,6,232,242,-2
Tmem245,2,4,236,242,-2
Spata1,7,9,226,242,-2
Gm38431,5,7,230,242,-2
Dram2,7,9,226,242,-2
Gxylt1,2,4,236,242,-2
Gm3858,3,5,234,242,-2
Dok7,6,8,228,242,-2
Olfr55,0,2,240,242,-2
Tmprss11a,0,2,240,242,-2
Tmem37,5,7,230,242,-2
Dnajc21,2,4,236,242,-2
Olfr624,2,4,236,242,-2
Gsn,6,8,228,242,-2
Tmem87b,6,8,228,242,-2
Gskip,3,5,234,242,-2
Olfr643,0,2,240,242,-2
Gsk3a,2,4,236,242,-2
Gsg1l2,0,2,240,242,-2
Creg2,1,3,238,242,-2
Tmem88,6,8,228,242,-2
Dnajb12,2,4,236,242,-2
Capn9,0,2,240,242,-2
Tmem97,7,9,226,242,-2
Slc38a5,5,7,230,242,-2
Olfr668,0,2,240,242,-2
Gsdma3,2,4,236,242,-2
Uvrag,2,4,236,242,-2
Tmpo,3,5,234,242,-2
Olfr678,6,8,228,242,-2
Ufc1,4,6,232,242,-2
Gstm1,5,7,230,242,-2
Tmem61,5,7,230,242,-2
Slc36a1,4,6,232,242,-2
Tmem38a,5,7,230,242,-2
Dock11,1,3,238,242,-2
Olfr566,0,2,240,242,-2
Slc35f3,5,7,230,242,-2
Olfr571,2,4,236,242,-2
Tmem44,5,7,230,242,-2
Slc35f6,4,6,232,242,-2
Dnm2,4,6,232,242,-2
Vapa,3,5,234,242,-2
Tmem59l,2,4,236,242,-2
Slc36a3,4,6,232,242,-2
Cracr2b,5,7,230,242,-2
Gstt1,9,11,222,242,-2
Dnase1l2,9,11,222,242,-2
Pros1,7,9,226,242,-2
Tmem54,7,9,226,242,-2
Dnajc6,2,4,236,242,-2
Slc38a1,2,4,236,242,-2
Xpnpep2,6,8,228,242,-2
Kctd11,5,7,230,242,-2
Nmd3,9,11,222,242,-2
Lclat1,7,9,226,242,-2
Vps11,2,4,236,242,-2
Ceacam12,3,5,234,242,-2
Mesp2,9,11,222,242,-2
Lce1l,3,5,234,242,-2
Igkv6-23,8,10,224,242,-2
Igkv6-25,7,9,226,242,-2
Ceacam11,0,2,240,242,-2
Flnc,0,2,240,242,-2
Men1,4,6,232,242,-2
Lce3d,5,7,230,242,-2
Lce3f,4,6,232,242,-2
Flot2,2,4,236,242,-2
Trub2,3,5,234,242,-2
Sart1,2,4,236,242,-2
Kbtbd2,3,5,234,242,-2
Atp6v1c2,11,13,218,242,-2
Rnf152,2,4,236,242,-2
Gatad2b,3,5,234,242,-2
Arid4a,3,5,234,242,-2
Flt3,2,4,236,242,-2
Flt4,2,4,236,242,-2
Baz1b,2,4,236,242,-2
Cdyl,3,5,234,242,-2
Megf8,2,4,236,242,-2
Mefv,2,4,236,242,-2
Mef2d,2,4,236,242,-2
Lcorl,5,7,230,242,-2
Igkv8-26,4,6,232,242,-2
Igkv6-15,9,11,222,242,-2
Rnf144a,2,4,236,242,-2
Lce1b,3,5,234,242,-2
Stk19,2,4,236,242,-2
Fkbp15,4,6,232,242,-2
Fkbp1a,2,4,236,242,-2
Serinc3,5,7,230,242,-2
Rnd2,6,8,228,242,-2
Large2,7,9,226,242,-2
Tax1bp1,4,6,232,242,-2
Igkv4-91,5,7,230,242,-2
Gbp8,4,6,232,242,-2
Arl5b,5,7,230,242,-2
Mettl7a1,7,9,226,242,-2
Gbp5,2,4,236,242,-2
Arl3,2,4,236,242,-2
Fkbp7,7,9,226,242,-2
Cdh22,2,4,236,242,-2
Vopp1,4,6,232,242,-2
Saxo1,2,4,236,242,-2
Ttc29,3,5,234,242,-2
Rnf123,3,5,234,242,-2
Igkv5-48,6,8,228,242,-2
Ankrd26,2,4,236,242,-2
Mettl2,3,5,234,242,-2
Rnf13,6,8,228,242,-2
Rnf130,5,7,230,242,-2
Gm11127,8,10,224,242,-2
Mettl15,6,8,228,242,-2
Rnf133,1,3,238,242,-2
Tasp1,2,4,236,242,-2
Cdx4,0,2,240,242,-2
Bax,5,7,230,242,-2
Vps18,4,6,232,242,-2
Igsf21,0,2,240,242,-2
Sfxn2,5,7,230,242,-2
Tyk2,2,4,236,242,-2
Arhgef6,2,4,236,242,-2
Atrip,4,6,232,242,-2
Sftpd,3,5,234,242,-2
Ankrd55,10,12,220,242,-2
Mcur1,5,7,230,242,-2
Ankrd60,5,7,230,242,-2
Isy1,4,6,232,242,-2
Lgi4,11,13,218,242,-2
Cdkn2d,3,5,234,242,-2
Mcrs1,5,7,230,242,-2
Lgr5,5,7,230,242,-2
Ttbk1,3,5,234,242,-2
Vmn1r42,1,3,238,242,-2
Atrnl1,2,4,236,242,-2
Gm12117,28,30,184,242,-2
Mcpt4,4,6,232,242,-2
Fndc3c1,4,6,232,242,-2
Isoc1,6,8,228,242,-2
Tyms,5,7,230,242,-2
Sall4,2,4,236,242,-2
Gamt,9,11,222,242,-2
Lhx1,8,10,224,242,-2
Stkld1,12,14,216,242,-2
Atxn2,5,7,230,242,-2
Lhx4,0,2,240,242,-2
Tas2r123,0,2,240,242,-2
Bambi,0,2,240,242,-2
Atp8a2,6,8,228,242,-2
Wdr61,2,4,236,242,-2
Gm17067,6,8,228,242,-2
Med26,3,5,234,242,-2
Sfxn4,5,7,230,242,-2
Stk32c,3,5,234,242,-2
Wdr74,5,7,230,242,-2
Gata2,7,9,226,242,-2
Cds2,6,8,228,242,-2
Ttc21a,2,4,236,242,-2
Rnf19a,2,4,236,242,-2
Med19,2,4,236,242,-2
Try5,6,8,228,242,-2
Ldlrad1,8,10,224,242,-2
Sap25,24,26,192,242,-2
Med15,4,6,232,242,-2
Ldoc1,0,2,240,242,-2
Med14,4,6,232,242,-2
Med13,3,5,234,242,-2
Gas2l3,4,6,232,242,-2
Iglv1,18,20,204,242,-2
Lemd2,3,5,234,242,-2
Gm11756,5,7,230,242,-2
Mecp2,7,9,226,242,-2
Tsc22d4,3,5,234,242,-2
Samm50,3,5,234,242,-2
Txnl4b,3,5,234,242,-2
Samd4b,3,5,234,242,-2
Me1,3,5,234,242,-2
Gcat,2,4,236,242,-2
Vmp1,4,6,232,242,-2
Gm17387,7,9,226,242,-2
Vmn2r79,5,7,230,242,-2
Rims1,1,3,238,242,-2
Arrdc4,5,7,230,242,-2
Sypl2,3,5,234,242,-2
Ttll11,5,7,230,242,-2
BC107364,7,9,226,242,-2
Vmn2r83,0,2,240,242,-2
Mknk1,3,5,234,242,-2
Vmn2r84,2,4,236,242,-2
Stfa2l1,16,18,208,242,-2
Atp2c2,2,4,236,242,-2
Cdh16,16,18,208,242,-2
Trpm2,2,4,236,242,-2
Cdh17,2,4,236,242,-2
BC048679,5,7,230,242,-2
Wipf1,4,6,232,242,-2
Gfi1b,3,5,234,242,-2
Krtap13,2,4,236,242,-2
Anapc10,3,5,234,242,-2
Scd3,3,5,234,242,-2
Tbc1d9,2,4,236,242,-2
Sun1,3,5,234,242,-2
Krtap16-3,0,2,240,242,-2
Atp5a1,4,6,232,242,-2
Anapc11,2,4,236,242,-2
Riok2,3,5,234,242,-2
Riok3,3,5,234,242,-2
Ripk1,3,5,234,242,-2
Ttll12,5,7,230,242,-2
Gfral,0,2,240,242,-2
Txndc5,4,6,232,242,-2
Krt8,7,9,226,242,-2
Tbp,4,6,232,242,-2
Vmn2r67,0,2,240,242,-2
Cdcp3,0,2,240,242,-2
Igkj2,2,4,236,242,-2
Kbtbd13,1,3,238,242,-2
Gigyf2,2,4,236,242,-2
Igkj3,0,2,240,242,-2
Igkj4,1,3,238,242,-2
Wnt11,5,7,230,242,-2
Mmp16,2,4,236,242,-2
Vmn2r7,4,6,232,242,-2
Ffar4,6,8,228,242,-2
Amigo1,3,5,234,242,-2
Ubap2l,5,7,230,242,-2
Ghitm,3,5,234,242,-2
Atp2a3,4,6,232,242,-2
Gh,13,15,214,242,-2
Katnbl1,7,9,226,242,-2
Ammecr1l,2,4,236,242,-2
Tbck,4,6,232,242,-2
Tbcel,2,4,236,242,-2
Gm1979,12,14,216,242,-2
Riiad1,14,16,212,242,-2
As3mt,2,4,236,242,-2
Gm10668,3,5,234,242,-2
Ubap2,3,5,234,242,-2
Kat2b,3,5,234,242,-2
Syt11,5,7,230,242,-2
Gemin6,5,7,230,242,-2
Lamtor5,3,5,234,242,-2
Ceacam14,0,2,240,242,-2
L3mbtl2,4,6,232,242,-2
Gm17535,20,22,200,242,-2
Ces4a,0,2,240,242,-2
Jak3,2,4,236,242,-2
Gcn1,2,4,236,242,-2
Armcx4,0,2,240,242,-2
Atp5md,5,7,230,242,-2
Mgat4c,7,9,226,242,-2
Angptl8,16,18,208,242,-2
Ttc9,0,2,240,242,-2
Mgat4a,5,7,230,242,-2
Cetn4,11,13,218,242,-2
Sytl3,4,6,232,242,-2
Scaf8,2,4,236,242,-2
Ficd,3,5,234,242,-2
Ttc7,3,5,234,242,-2
Mfsd7a,4,6,232,242,-2
Rnase11,1,3,238,242,-2
BC004004,3,5,234,242,-2
Fignl2,6,8,228,242,-2
Mfsd4a,7,9,226,242,-2
Bbx,2,4,236,242,-2
Lamp3,1,3,238,242,-2
Armc5,2,4,236,242,-2
Bbs9,4,6,232,242,-2
Gm11100,5,7,230,242,-2
Lamtor4,3,5,234,242,-2
Tbc1d17,5,7,230,242,-2
Fhl3,8,10,224,242,-2
Tbc1d30,2,4,236,242,-2
Scara5,6,8,228,242,-2
Gemin5,2,4,236,242,-2
Krtap20-2,1,3,238,242,-2
Krtap27-1,2,4,236,242,-2
Fgfr2,5,7,230,242,-2
Trps1,7,9,226,242,-2
Krtap29-1,0,2,240,242,-2
Krtap3-1,4,6,232,242,-2
Txndc9,3,5,234,242,-2
Stim1,3,5,234,242,-2
Vmn1r25,0,2,240,242,-2
Syt3,2,4,236,242,-2
Ceacam18,0,2,240,242,-2
Anapc5,4,6,232,242,-2
Ripply1,9,11,222,242,-2
Krtap4-1,0,2,240,242,-2
Fh1,3,5,234,242,-2
Ang4,11,13,218,242,-2
Vmn2r14,1,3,238,242,-2
Krtap4-8,2,4,236,242,-2
Jmjd4,3,5,234,242,-2
Rlbp1,4,6,232,242,-2
Jcad,2,4,236,242,-2
Gdf10,3,5,234,242,-2
Mia2,3,5,234,242,-2
Sgpl1,5,7,230,242,-2
Kti12,4,6,232,242,-2
Gm17606,10,12,220,242,-2
Sall2,7,9,226,242,-2
Vps28,3,5,234,242,-2
Fndc7,3,5,234,242,-2
Cdk5rap1,2,4,236,242,-2
Serpinb7,4,6,232,242,-2
Vsig10l,3,5,234,242,-2
Strap,2,4,236,242,-2
Ilkap,2,4,236,242,-2
Iltifb,0,2,240,242,-2
Fscn1,3,5,234,242,-2
Gab1,2,4,236,242,-2
Invs,2,4,236,242,-2
Gm136,5,7,230,242,-2
Strip2,3,5,234,242,-2
Cdk5,6,8,228,242,-2
Chil5,4,6,232,242,-2
Madd,2,4,236,242,-2
G3bp2,2,4,236,242,-2
Rspo4,1,3,238,242,-2
Serpind1,4,6,232,242,-2
Impg2,0,2,240,242,-2
Tafa2,3,5,234,242,-2
Macrod1,3,5,234,242,-2
Ints12,3,5,234,242,-2
Rsph4a,2,4,236,242,-2
Fstl5,1,3,238,242,-2
Lrrc55,0,2,240,242,-2
Rpp14,4,6,232,242,-2
Lrrc59,4,6,232,242,-2
Ap4m1,4,6,232,242,-2
Tafa3,3,5,234,242,-2
Axin1,2,4,236,242,-2
Ipo5,3,5,234,242,-2
AY761185,2,4,236,242,-2
Mageb6b1,1,3,238,242,-2
Aopep,4,6,232,242,-2
Lrba,2,4,236,242,-2
Lrch3,3,5,234,242,-2
Cgrrf1,3,5,234,242,-2
Lrfn3,3,5,234,242,-2
Gm14698,20,22,200,242,-2
Gm14548,7,9,226,242,-2
Rubcnl,5,7,230,242,-2
U2af1l4,6,8,228,242,-2
Maml1,2,4,236,242,-2
Malt1,2,4,236,242,-2
Taf1c,1,3,238,242,-2
Tars,3,5,234,242,-2
Rttn,1,3,238,242,-2
Ap1b1,3,5,234,242,-2
Lrig1,3,5,234,242,-2
Wbp2,5,7,230,242,-2
Chac2,2,4,236,242,-2
Taf3,2,4,236,242,-2
Lrp10,7,9,226,242,-2
Lrp11,3,5,234,242,-2
Magi1,3,5,234,242,-2
Il7,8,10,224,242,-2
Mageh1,6,8,228,242,-2
Arfgef1,5,7,230,242,-2
Vrtn,0,2,240,242,-2
Frrs1l,0,2,240,242,-2
M6pr,4,6,232,242,-2
Chchd1,4,6,232,242,-2
Taf1a,5,7,230,242,-2
App,4,6,232,242,-2
Tanc1,2,4,236,242,-2
Apoo,6,8,228,242,-2
Fto,2,4,236,242,-2
Ftsj3,2,4,236,242,-2
Chd1,3,5,234,242,-2
Stt3b,3,5,234,242,-2
Rrn3,2,4,236,242,-2
Ly6g6g,6,8,228,242,-2
Vwa1,7,9,226,242,-2
Fuca2,9,11,222,242,-2
Fundc1,6,8,228,242,-2
Chek2,3,5,234,242,-2
Tspan6,4,6,232,242,-2
Lss,4,6,232,242,-2
Serpinf1,6,8,228,242,-2
Rps6ka6,2,4,236,242,-2
Ino80e,3,5,234,242,-2
Apoc2,14,16,212,242,-2
Ltbp2,7,9,226,242,-2
Fut10,3,5,234,242,-2
Lum,3,5,234,242,-2
Fut4,5,7,230,242,-2
Apobr,8,10,224,242,-2
Luc7l,4,6,232,242,-2
Vwa8,2,4,236,242,-2
Vwc2,1,3,238,242,-2
Inpp5d,4,6,232,242,-2
Tagln3,7,9,226,242,-2
Gm14151,2,4,236,242,-2
Rpp40,5,7,230,242,-2
Apcs,0,2,240,242,-2
Ap4s1,2,4,236,242,-2
Chchd3,2,4,236,242,-2
Lrrc73,7,9,226,242,-2
Rprd1b,3,5,234,242,-2
Lrrc74b,3,5,234,242,-2
Lzic,4,6,232,242,-2
Lyzl4,12,14,216,242,-2
Apaf1,2,4,236,242,-2
Wars2,3,5,234,242,-2
Fzd3,2,4,236,242,-2
Wars,2,4,236,242,-2
Inava,6,8,228,242,-2
Insyn2b,0,2,240,242,-2
Rsbn1l,5,7,230,242,-2
Chic2,1,3,238,242,-2
Sestd1,3,5,234,242,-2
Rps17,6,8,228,242,-2
Rps2,3,5,234,242,-2
Insyn1,0,2,240,242,-2
Chchd5,4,6,232,242,-2
Lypla1,6,8,228,242,-2
Fyco1,2,4,236,242,-2
Lypd6b,4,6,232,242,-2
Lypd4,3,5,234,242,-2
Vxn,4,6,232,242,-2
Lypd11,1,3,238,242,-2
Lrrn2,2,4,236,242,-2
Manbal,2,4,236,242,-2
Rpl28,3,5,234,242,-2
Mcm9,4,6,232,242,-2
Vmn1r89,2,4,236,242,-2
Galnt2,11,13,218,242,-2
Robo1,1,3,238,242,-2
Galnt18,4,6,232,242,-2
Lipf,2,4,236,242,-2
Babam1,2,4,236,242,-2
Auh,3,5,234,242,-2
Chp1,4,6,232,242,-2
Tyro3,4,6,232,242,-2
Vmn1r86,3,5,234,242,-2
Matn1,2,4,236,242,-2
Lipo3,4,6,232,242,-2
Arhgap42,3,5,234,242,-2
B9d1,11,13,218,242,-2
Mat2b,3,5,234,242,-2
Rock1,3,5,234,242,-2
Mat1a,5,7,230,242,-2
Vps4a,2,4,236,242,-2
Rock2,7,9,226,242,-2
Tsn,5,7,230,242,-2
Mast2,2,4,236,242,-2
Irf6,2,4,236,242,-2
Rom1,2,4,236,242,-2
Tacr2,5,7,230,242,-2
B830017H08Rik,7,9,226,242,-2
Galnt1,5,7,230,242,-2
Cfhr2,3,5,234,242,-2
Ano3,1,3,238,242,-2
Gm12728,32,34,176,242,-2
Arhgdib,8,10,224,242,-2
Ror2,0,2,240,242,-2
Mbd3l1,2,4,236,242,-2
Lif,7,9,226,242,-2
Mcm8,2,4,236,242,-2
Ikbkg,5,7,230,242,-2
Vps33a,2,4,236,242,-2
Mcm5,5,7,230,242,-2
Lilra5,3,5,234,242,-2
Atxn7,2,4,236,242,-2
Vps37a,4,6,232,242,-2
Gm15557,0,2,240,242,-2
Sftpa1,2,4,236,242,-2
Bag4,4,6,232,242,-2
Wdr48,5,7,230,242,-2
Isca1,3,5,234,242,-2
Irx6,1,3,238,242,-2
Rnf6,3,5,234,242,-2
Chrna1,5,7,230,242,-2
Wdr45b,2,4,236,242,-2
Chrm5,1,3,238,242,-2
Sft2d3,1,3,238,242,-2
Mbtd1,4,6,232,242,-2
Mboat1,6,8,228,242,-2
Lin28b,1,3,238,242,-2
Anks6,3,5,234,242,-2
Rngtt,7,9,226,242,-2
Vps39,2,4,236,242,-2
Mblac2,3,5,234,242,-2
Wdr37,3,5,234,242,-2
Arhgap35,2,4,236,242,-2
Stn1,2,4,236,242,-2
Aoc2,4,6,232,242,-2
Rxfp3,4,6,232,242,-2
Arhgap21,6,8,228,242,-2
Rpl17,4,6,232,242,-2
Map3k9,1,3,238,242,-2
Vps54,3,5,234,242,-2
Rpl18,5,7,230,242,-2
Ruvbl1,3,5,234,242,-2
Lpar1,8,10,224,242,-2
Map3k3,3,5,234,242,-2
Gm15080,3,5,234,242,-2
Map3k20,4,6,232,242,-2
B4galnt3,3,5,234,242,-2
Map3k19,0,2,240,242,-2
Cdk9,2,4,236,242,-2
Map3k10,4,6,232,242,-2
Cdk8,3,5,234,242,-2
Rpl23a,7,9,226,242,-2
Serpinb3a,0,2,240,242,-2
Stxbp5,3,5,234,242,-2
Rundc3a,2,4,236,242,-2
Anxa8,13,15,214,242,-2
Stox2,18,20,204,242,-2
Uba5,2,4,236,242,-2
Vps72,5,7,230,242,-2
Gm14743,3,5,234,242,-2
Tspan10,4,6,232,242,-2
Arhgap10,2,4,236,242,-2
Rpl27a,3,5,234,242,-2
Tspyl5,0,2,240,242,-2
Il20rb,2,4,236,242,-2
B630019K06Rik,5,7,230,242,-2
Taf1,3,5,234,242,-2
Mark3,2,4,236,242,-2
Mark1,1,3,238,242,-2
Lmbrd1,3,5,234,242,-2
Vps50,3,5,234,242,-2
Il18r1,5,7,230,242,-2
Il18rap,3,5,234,242,-2
Wdhd1,3,5,234,242,-2
Lmf2,3,5,234,242,-2
Irf3,4,6,232,242,-2
Marchf10,6,8,228,242,-2
AV320801,2,4,236,242,-2
Vmn1r80,2,4,236,242,-2
Mapre1,3,5,234,242,-2
Uba52,7,9,226,242,-2
Sfmbt1,2,4,236,242,-2
Mapkap1,3,5,234,242,-2
Vps51,3,5,234,242,-2
Il1rap,4,6,232,242,-2
Mapk6,2,4,236,242,-2
Gal3st2c,0,2,240,242,-2
Rpe,4,6,232,242,-2
Serpinb13,2,4,236,242,-2
Rpe65,3,5,234,242,-2
Gm13057,0,2,240,242,-2
Wdfy2,2,4,236,242,-2
Antxrl,5,7,230,242,-2
Anxa10,7,9,226,242,-2
Wnt2b,2,4,236,242,-2
Inpp5a,2,4,236,242,-2
Ascl4,7,9,226,242,-2
Alkbh4,10,12,220,242,-2
Kif5c,2,4,236,242,-2
Gm10267,3,5,234,242,-2
Scgb2b20,3,5,234,242,-2
Keg1,3,5,234,242,-2
Mrgpra9,0,2,240,242,-2
Khdc1b,1,3,238,242,-2
Bckdha,3,5,234,242,-2
Clasrp,2,4,236,242,-2
Rexo4,2,4,236,242,-2
Alkbh6,3,5,234,242,-2
Gm20521,25,27,190,242,-2
Tulp4,3,5,234,242,-2
Scmh1,2,4,236,242,-2
Morn5,11,13,218,242,-2
Mospd1,9,11,222,242,-2
Gm20721,12,14,216,242,-2
Surf1,4,6,232,242,-2
Sec22b,6,8,228,242,-2
Kif3a,2,4,236,242,-2
Kcnk13,9,11,222,242,-2
Fbxw26,2,4,236,242,-2
Mospd2,5,7,230,242,-2
Mrgpra1,1,3,238,242,-2
Alkbh3,2,4,236,242,-2
Mrgbp,4,6,232,242,-2
Klk9,2,4,236,242,-2
Ms4a20,0,2,240,242,-2
Cisd3,7,9,226,242,-2
Mrfap1,2,4,236,242,-2
Akr1a1,4,6,232,242,-2
Rgl3,7,9,226,242,-2
Atg101,4,6,232,242,-2
Vmn2r23,0,2,240,242,-2
Aldh3b3,6,8,228,242,-2
Trp53,3,5,234,242,-2
Vmn2r32,0,2,240,242,-2
Selenon,4,6,232,242,-2
Bcl7a,2,4,236,242,-2
Tbx18,3,5,234,242,-2
Vmn1r222,0,2,240,242,-2
Cep83,6,8,228,242,-2
Ak8,3,5,234,242,-2
Vmn2r6,1,3,238,242,-2
Fbxl3,4,6,232,242,-2
Fbxw21,0,2,240,242,-2
Atl2,4,6,232,242,-2
Atl3,5,7,230,242,-2
Gm20807,0,2,240,242,-2
Klrc2,1,3,238,242,-2
Gm1043,0,2,240,242,-2
Mon2,2,4,236,242,-2
Kifc2,2,4,236,242,-2
Aldh3a2,3,5,234,242,-2
Vmn2r57,0,2,240,242,-2
Cinp,3,5,234,242,-2
Sec23b,3,5,234,242,-2
Morc2a,2,4,236,242,-2
Klhl15,3,5,234,242,-2
Scgb2b2,11,13,218,242,-2
Xkrx,10,12,220,242,-2
Mrgprb4,0,2,240,242,-2
Klra5,5,7,230,242,-2
Scrn3,5,7,230,242,-2
Fbxw27,4,6,232,242,-2
Moxd2,0,2,240,242,-2
Gjd2,0,2,240,242,-2
Tcerg1,3,5,234,242,-2
Mrrf,4,6,232,242,-2
Ighv1-54,7,9,226,242,-2
Surf6,3,5,234,242,-2
Gm20489,1,3,238,242,-2
Wwc2,2,4,236,242,-2
Txk,5,7,230,242,-2
Klk1b11,1,3,238,242,-2
Vmn1r220,1,3,238,242,-2
Klhl6,4,6,232,242,-2
Klhl8,2,4,236,242,-2
Atn1,5,7,230,242,-2
Atp12a,0,2,240,242,-2
Rhox10,1,3,238,242,-2
Kcnk6,3,5,234,242,-2
Akap9,4,6,232,242,-2
Mprip,2,4,236,242,-2
Scgn,6,8,228,242,-2
Kif13b,2,4,236,242,-2
Gkn1,0,2,240,242,-2
Mpp3,6,8,228,242,-2
Ighv1-58,5,7,230,242,-2
Atf6,3,5,234,242,-2
Cdc73,4,6,232,242,-2
Alg10b,4,6,232,242,-2
Mpp7,3,5,234,242,-2
Mrps28,3,5,234,242,-2
Bcl2a1c,6,8,228,242,-2
Tut4,4,6,232,242,-2
Bend3,3,5,234,242,-2
Klhl42,5,7,230,242,-2
Klk1b24,5,7,230,242,-2
Alk,1,3,238,242,-2
Mrps25,2,4,236,242,-2
Kcnmb3,5,7,230,242,-2
Sec62,2,4,236,242,-2
Clca1,2,4,236,242,-2
Khdrbs1,2,4,236,242,-2
Rfc3,4,6,232,242,-2
Glyr1,2,4,236,242,-2
Mrc2,3,5,234,242,-2
Mrc1,8,10,224,242,-2
Scly,4,6,232,242,-2
Cep44,4,6,232,242,-2
Tubb4b,3,5,234,242,-2
Tubb2b,7,9,226,242,-2
Vmn1r22,2,4,236,242,-2
Kif21b,0,2,240,242,-2
Mpig6b,5,7,230,242,-2
Gm10354,10,12,220,242,-2
Sdc1,2,4,236,242,-2
Glb1l3,0,2,240,242,-2
Sh3bp5l,2,4,236,242,-2
Khnyn,2,4,236,242,-2
Mrps23,5,7,230,242,-2
Atp13a3,3,5,234,242,-2
Khsrp,3,5,234,242,-2
Glb1,3,5,234,242,-2
Cdc42bpg,2,4,236,242,-2
Alg2,3,5,234,242,-2
Sh3bp5,4,6,232,242,-2
Kif1b,2,4,236,242,-2
Atf1,3,5,234,242,-2
Mocs3,4,6,232,242,-2
Gm10128,7,9,226,242,-2
Fbxw2,2,4,236,242,-2
Vmn1r223,0,2,240,242,-2
Fbxl18,4,6,232,242,-2
Glrx2,3,5,234,242,-2
Gm10198,5,7,230,242,-2
Msl3,4,6,232,242,-2
Rhbg,8,10,224,242,-2
Wnt5a,2,4,236,242,-2
Kpna3,4,6,232,242,-2
Aspn,9,11,222,242,-2
Sec24c,4,6,232,242,-2
Ighv13-2,6,8,228,242,-2
Msx2,4,6,232,242,-2
Mnx1,1,3,238,242,-2
Scgb1b3,7,9,226,242,-2
Cks2,6,8,228,242,-2
Kdelr2,2,4,236,242,-2
Rest,4,6,232,242,-2
Asxl2,2,4,236,242,-2
Gls2,5,7,230,242,-2
Vmn2r45,0,2,240,242,-2
Ube2g2,5,7,230,242,-2
Gins4,4,6,232,242,-2
Fbxo42,2,4,236,242,-2
Ak3,4,6,232,242,-2
Mrpl49,3,5,234,242,-2
Mrpl33,3,5,234,242,-2
Ighv1-20,4,6,232,242,-2
Mrpl12,2,4,236,242,-2
Msrb2,3,5,234,242,-2
Tcaf3,4,6,232,242,-2
Glrp1,2,4,236,242,-2
Scn9a,0,2,240,242,-2
Kcnj5,0,2,240,242,-2
Tceal1,1,3,238,242,-2
Tcea3,6,8,228,242,-2
Gm10310,5,7,230,242,-2
Glrx,5,7,230,242,-2
Vmn1r215,1,3,238,242,-2
Rgs22,5,7,230,242,-2
Kmt2c,2,4,236,242,-2
Ajap1,3,5,234,242,-2
Ajuba,5,7,230,242,-2
Vmn2r24,1,3,238,242,-2
Kcnj11,1,3,238,242,-2
Gm20379,10,12,220,242,-2
Astn2,0,2,240,242,-2
Klf4,10,12,220,242,-2
Glt28d2,5,7,230,242,-2
Kdelr1,4,6,232,242,-2
Stam2,3,5,234,242,-2
Mrpl28,2,4,236,242,-2
Gm20604,3,5,234,242,-2
Svopl,8,10,224,242,-2
Kdm4a,2,4,236,242,-2
Kcna7,3,5,234,242,-2
Vmn2r63,4,6,232,242,-2
Ube2e3,6,8,228,242,-2
Ighv9-2,6,8,228,242,-2
Fbxw11,4,6,232,242,-2
Atg5,3,5,234,242,-2
Trnp1,1,3,238,242,-2
Sec14l1,2,4,236,242,-2
Mrpl24,3,5,234,242,-2
Ciita,7,9,226,242,-2
Syngap1,3,5,234,242,-2
Ighv9-1,8,10,224,242,-2
Glra3,1,3,238,242,-2
Ighv8-12,5,7,230,242,-2
Git2,1,3,238,242,-2
Supt7l,3,5,234,242,-2
Asb17,2,4,236,242,-2
Selenov,19,21,202,242,-2
Fem1c,3,5,234,242,-2
Atg9a,2,4,236,242,-2
Rhox5,9,11,222,242,-2
Aimp1,6,8,228,242,-2
Podnl1,3,6,233,242,-3
Pitx2,5,8,229,242,-3
Gm10309,7,10,225,242,-3
Trav7d-3,6,9,227,242,-3
Dlg5,3,6,233,242,-3
Grik5,2,5,235,242,-3
Kif26b,1,4,237,242,-3
Crebzf,3,6,233,242,-3
Gm13288,5,8,229,242,-3
Scyl3,3,6,233,242,-3
Capza3,0,3,239,242,-3
Tyw5,5,8,229,242,-3
Rwdd1,2,5,235,242,-3
Scyl2,3,6,233,242,-3
Kcnk2,1,4,237,242,-3
Poglut3,5,8,229,242,-3
Gm13272,6,9,227,242,-3
Pkd2l1,1,4,237,242,-3
Olfr648,2,5,235,242,-3
Zpr1,2,5,235,242,-3
Sugp1,2,5,235,242,-3
Vps37c,2,5,235,242,-3
Lpin3,3,6,233,242,-3
Dnajc22,2,5,235,242,-3
Vamp1,1,4,237,242,-3
Olfr641,1,4,237,242,-3
Ugdh,6,9,227,242,-3
Pkd1l2,0,3,239,242,-3
Cgas,1,4,237,242,-3
Cenpp,6,9,227,242,-3
Klf16,6,9,227,242,-3
Gsr,2,5,235,242,-3
Olfr790,0,3,239,242,-3
Arhgef12,3,6,233,242,-3
Tnfrsf11a,2,5,235,242,-3
Lpgat1,6,9,227,242,-3
Poglut1,5,8,229,242,-3
Prl2c1,0,3,239,242,-3
Dkk1,4,7,231,242,-3
Pkd1,11,14,217,242,-3
AW549877,5,8,229,242,-3
Pias4,8,11,223,242,-3
9630041A04Rik,2,5,235,242,-3
Ccna1,9,12,221,242,-3
Smcr8,2,5,235,242,-3
Capn15,2,5,235,242,-3
Car1,7,10,225,242,-3
Tnfrsf11b,1,4,237,242,-3
Olfr62,1,4,237,242,-3
Crebl2,6,9,227,242,-3
Tnfaip8l2,8,11,223,242,-3
Olfr64,3,6,233,242,-3
9930104L06Rik,2,5,235,242,-3
Olfr639,4,7,231,242,-3
Grin3a,0,3,239,242,-3
Crtc1,2,5,235,242,-3
Cdkal1,4,7,231,242,-3
Sox30,1,4,237,242,-3
Olfr787,2,5,235,242,-3
Disp2,1,4,237,242,-3
Olfr788,4,7,231,242,-3
Cyp4f16,6,9,227,242,-3
Tnfaip6,7,10,225,242,-3
Grk2,5,8,229,242,-3
Tspyl4,2,5,235,242,-3
Caprin1,3,6,233,242,-3
Dmrt2,2,5,235,242,-3
Lmln,1,4,237,242,-3
Grm8,2,5,235,242,-3
Glt6d1,1,4,237,242,-3
Ccl26,1,4,237,242,-3
Lmnb1,2,5,235,242,-3
Olfr704,3,6,233,242,-3
Scrib,4,7,231,242,-3
Grpel1,2,5,235,242,-3
Kifap3,2,5,235,242,-3
Pnrc2,9,12,221,242,-3
Grpr,0,3,239,242,-3
Cgnl1,4,7,231,242,-3
Pnp,5,8,229,242,-3
Grrp1,4,7,231,242,-3
Crkl,3,6,233,242,-3
Slc39a7,4,7,231,242,-3
Crk,3,6,233,242,-3
1700025C18Rik,0,3,239,242,-3
Tsr3,2,5,235,242,-3
Asz1,1,4,237,242,-3
Tmub2,2,5,235,242,-3
Gale,3,6,233,242,-3
Traj30,0,3,239,242,-3
Pik3cg,0,3,239,242,-3
Lman2l,3,6,233,242,-3
Lman2,2,5,235,242,-3
Ccdc201,3,6,233,242,-3
Kirrel,2,5,235,242,-3
Lmbr1,4,7,231,242,-3
Crls1,2,5,235,242,-3
Dmp1,3,6,233,242,-3
9130008F23Rik,7,10,225,242,-3
Crnkl1,2,5,235,242,-3
Vps4b,2,5,235,242,-3
Scp2d1,4,7,231,242,-3
Kirrel3,2,5,235,242,-3
Tmsb10,7,10,225,242,-3
Grm6,0,3,239,242,-3
Pno1,2,5,235,242,-3
Gltp,3,6,233,242,-3
Galm,3,6,233,242,-3
Pnma5,2,5,235,242,-3
Pigv,2,5,235,242,-3
Olfr692,3,6,233,242,-3
Slc39a3,3,6,233,242,-3
Gm7697,2,5,235,242,-3
Lipo2,4,7,231,242,-3
Galnt14,4,7,231,242,-3
Tyw1,2,5,235,242,-3
Cul5,2,5,235,242,-3
Tunar,0,3,239,242,-3
Pir,6,9,227,242,-3
Capns1,3,6,233,242,-3
Slc39a9,5,8,229,242,-3
Dlk2,7,10,225,242,-3
Vmn2r27,4,7,231,242,-3
Tmem95,14,17,211,242,-3
Sp100,5,8,229,242,-3
Sp2,3,6,233,242,-3
Arhgap44,2,5,235,242,-3
Gm7609,10,13,219,242,-3
Cfdp1,3,6,233,242,-3
Zfp583,10,13,219,242,-3
Ccm2,3,6,233,242,-3
Crh,1,4,237,242,-3
Crip2,6,9,227,242,-3
Zfp59,3,6,233,242,-3
Svop,6,9,227,242,-3
Rxra,3,6,233,242,-3
Grwd1,2,5,235,242,-3
Znrf3,6,9,227,242,-3
Tmprss11f,4,7,231,242,-3
Olfr686,0,3,239,242,-3
Irf2,7,10,225,242,-3
Gsap,5,8,229,242,-3
Trappc1,3,6,233,242,-3
Tmprss11d,8,11,223,242,-3
Pip4k2b,4,7,231,242,-3
Dnah10,6,9,227,242,-3
Suclg2,6,9,227,242,-3
Pigu,5,8,229,242,-3
Pigs,2,5,235,242,-3
Klc1,2,5,235,242,-3
S100a7l2,1,4,237,242,-3
Zfp598,2,5,235,242,-3
Atad2,1,4,237,242,-3
Sctr,1,4,237,242,-3
Scnm1,5,8,229,242,-3
Gimap4,5,8,229,242,-3
Arfip1,4,7,231,242,-3
Lrat,5,8,229,242,-3
Gm10190,22,25,195,242,-3
Smtnl1,0,3,239,242,-3
Sv2b,1,4,237,242,-3
Olfr39,7,10,225,242,-3
H2-Aa,8,11,223,242,-3
H2-Ab1,5,8,229,242,-3
Spata21,3,6,233,242,-3
Lrrc8b,4,7,231,242,-3
Olfr380,8,11,223,242,-3
Traj50,0,3,239,242,-3
Kdm3b,2,5,235,242,-3
Sdhd,2,5,235,242,-3
Prps1l1,2,5,235,242,-3
Rsbn1,4,7,231,242,-3
Cenpk,10,13,219,242,-3
H2-M10.4,0,3,239,242,-3
Fzd1,6,9,227,242,-3
Tmem202,9,12,221,242,-3
Olfr368,1,4,237,242,-3
Kdelr3,4,7,231,242,-3
Dusp13,13,16,213,242,-3
Olfr361,0,3,239,242,-3
Dusp15,7,10,225,242,-3
Dusp18,6,9,227,242,-3
Prpsap2,2,5,235,242,-3
H2-M10.3,1,4,237,242,-3
Gm6351,7,10,225,242,-3
Sdk2,0,3,239,242,-3
Rrp8,2,5,235,242,-3
Tmem212,6,9,227,242,-3
Cyp26c1,1,4,237,242,-3
Cyb5a,5,8,229,242,-3
Rskr,10,13,219,242,-3
Ints11,3,6,233,242,-3
Drg2,3,6,233,242,-3
Vasp,2,5,235,242,-3
Gzmc,4,7,231,242,-3
Prpf6,2,5,235,242,-3
Uckl1,5,8,229,242,-3
Dsel,2,5,235,242,-3
Tmem232,3,6,233,242,-3
Lrrc58,2,5,235,242,-3
Gm6525,12,15,215,242,-3
Kdm8,3,6,233,242,-3
Rsph1,4,7,231,242,-3
Pls1,3,6,233,242,-3
Vat1,3,6,233,242,-3
Camk1,5,8,229,242,-3
Olfr410,0,3,239,242,-3
Lrrc69,9,12,221,242,-3
Susd6,3,6,233,242,-3
Chchd2,5,8,229,242,-3
Plcb2,1,4,237,242,-3
Plcb3,3,6,233,242,-3
Ints1,2,5,235,242,-3
Kdm5a,2,5,235,242,-3
Plcd1,3,6,233,242,-3
Olfr395,0,3,239,242,-3
Dtnbp1,3,6,233,242,-3
Sms,7,10,225,242,-3
Tmem201,3,6,233,242,-3
Spata31d1c,0,3,239,242,-3
Zranb3,0,3,239,242,-3
Cylc1,0,3,239,242,-3
Sdr16c6,0,3,239,242,-3
Cox4i1,3,6,233,242,-3
Aacs,2,5,235,242,-3
Cyld,2,5,235,242,-3
Tmem19,6,9,227,242,-3
Apol8,14,17,211,242,-3
Spcs2,4,7,231,242,-3
Plekhf2,2,5,235,242,-3
Kcnv1,1,4,237,242,-3
Inppl1,2,5,235,242,-3
Rpusd4,3,6,233,242,-3
Cacul1,2,5,235,242,-3
Cylc2,0,3,239,242,-3
Snai2,6,9,227,242,-3
Appbp2,2,5,235,242,-3
Cactin,2,5,235,242,-3
Gm35315,5,8,229,242,-3
Aadacl4fm2,0,3,239,242,-3
Prr36,2,5,235,242,-3
Snapc5,4,7,231,242,-3
Plekhm2,3,6,233,242,-3
Slc26a2,1,4,237,242,-3
Aadat,3,6,233,242,-3
0610012G03Rik,3,6,233,242,-3
Plin4,5,8,229,242,-3
B020031M17Rik,3,6,233,242,-3
Snapc3,3,6,233,242,-3
Kctd15,2,5,235,242,-3
Olfr303,0,3,239,242,-3
Kctd5,2,5,235,242,-3
Lsm3,4,7,231,242,-3
Dync2i1,4,7,231,242,-3
Plpp2,6,9,227,242,-3
Lrrn3,2,5,235,242,-3
Rrp7a,2,5,235,242,-3
Cyp19a1,1,4,237,242,-3
Lrrtm1,0,3,239,242,-3
1110059G10Rik,6,9,227,242,-3
Cox6b1,7,10,225,242,-3
Vav2,2,5,235,242,-3
Gm36210,3,6,233,242,-3
H2-Q2,6,9,227,242,-3
Rrp36,2,5,235,242,-3
Vav3,4,7,231,242,-3
Rrp12,3,6,233,242,-3
Gm14180,0,3,239,242,-3
Dvl3,5,8,229,242,-3
Olfr318,1,4,237,242,-3
Prr16,2,5,235,242,-3
Cdk2,4,7,231,242,-3
Vcam1,8,11,223,242,-3
Rrp1,2,5,235,242,-3
Zw10,2,5,235,242,-3
Kcnt2,5,8,229,242,-3
Zwint,3,6,233,242,-3
Dync1i1,1,4,237,242,-3
Cdk19,3,6,233,242,-3
Cyb5r1,5,8,229,242,-3
Cox4i2,5,8,229,242,-3
Lrrc56,5,8,229,242,-3
Gm6526,4,7,231,242,-3
1700001L19Rik,5,8,229,242,-3
Dok2,3,6,233,242,-3
Pogz,2,5,235,242,-3
Lrit1,0,3,239,242,-3
Cr1l,5,8,229,242,-3
Proser1,3,6,233,242,-3
Chad,3,6,233,242,-3
Olfr56,4,7,231,242,-3
Ippk,3,6,233,242,-3
Cyp2c66,4,7,231,242,-3
Gm42421,17,20,205,242,-3
Spag6,11,14,217,242,-3
Gtf3c2,2,5,235,242,-3
Dok1,4,7,231,242,-3
Gabpb2,2,5,235,242,-3
Cpt2,2,5,235,242,-3
A630076J17Rik,2,5,235,242,-3
Zscan22,2,5,235,242,-3
Pla2g15,5,8,229,242,-3
Gtf3c3,2,5,235,242,-3
Prox1,1,4,237,242,-3
Slc35c2,3,6,233,242,-3
Olfr539,1,4,237,242,-3
Olfr538,0,3,239,242,-3
Pla2g1b,20,23,199,242,-3
Tmem30a,4,7,231,242,-3
Gtpbp10,5,8,229,242,-3
Cxcr1,5,8,229,242,-3
Gm42372,8,11,223,242,-3
Serpinb6d,1,4,237,242,-3
Dnttip1,3,6,233,242,-3
Dntt,2,5,235,242,-3
Gtf2f2,2,5,235,242,-3
Sdf2,3,6,233,242,-3
Prorsd1,9,12,221,242,-3
Smok2a,2,5,235,242,-3
Arglu1,3,6,233,242,-3
Spaca5,10,13,219,242,-3
Cenpb,4,7,231,242,-3
Dnajc9,3,6,233,242,-3
Olfr600,5,8,229,242,-3
Gm42906,10,13,219,242,-3
Vamp5,7,10,225,242,-3
Tmem53,8,11,223,242,-3
Iqcc,4,7,231,242,-3
Gstp2,12,15,215,242,-3
Awat1,0,3,239,242,-3
Cap1,3,6,233,242,-3
Kif13a,6,9,227,242,-3
Vangl1,6,9,227,242,-3
Gstz1,3,6,233,242,-3
Arfrp1,2,5,235,242,-3
Uqcrfs1,3,6,233,242,-3
Traj9,0,3,239,242,-3
Pkn1,4,7,231,242,-3
Susd5,0,3,239,242,-3
1700015G11Rik,6,9,227,242,-3
Uqcrc2,5,8,229,242,-3
Camta1,2,5,235,242,-3
Vrk1,4,7,231,242,-3
Zscan12,2,5,235,242,-3
Atmin,3,6,233,242,-3
Khdrbs3,5,8,229,242,-3
Snph,1,4,237,242,-3
G6pc2,1,4,237,242,-3
Gm39566,0,3,239,242,-3
Tmem255b,3,6,233,242,-3
Olfr479,1,4,237,242,-3
Araf,3,6,233,242,-3
Rtf2,2,5,235,242,-3
Ccnl2,2,5,235,242,-3
Rtca,3,6,233,242,-3
Atm,4,7,231,242,-3
Kcnn2,1,4,237,242,-3
Stx5a,3,6,233,242,-3
Lrrc3b,5,8,229,242,-3
Olfr47,1,4,237,242,-3
Camk2n2,5,8,229,242,-3
Zfp513,5,8,229,242,-3
Vstm2l,7,10,225,242,-3
AY358078,5,8,229,242,-3
Rspry1,2,5,235,242,-3
Camk2g,2,5,235,242,-3
Zfp507,4,7,231,242,-3
Prpf4,2,5,235,242,-3
Twnk,2,5,235,242,-3
1700003H04Rik,3,6,233,242,-3
Tmem240,5,8,229,242,-3
Rspo1,3,6,233,242,-3
Zscan5b,1,4,237,242,-3
Cxxc5,6,9,227,242,-3
Gm5773,0,3,239,242,-3
Prpf19,2,5,235,242,-3
Olfr487,0,3,239,242,-3
Smok3c,0,3,239,242,-3
Zscan4d,0,3,239,242,-3
Dpep2,3,6,233,242,-3
Ccni,2,5,235,242,-3
Stx8,2,5,235,242,-3
Tmem268,2,5,235,242,-3
Dpf2,3,6,233,242,-3
Axl,6,9,227,242,-3
Arf5,2,5,235,242,-3
Slc33a1,4,7,231,242,-3
Zfp541,0,3,239,242,-3
Prpf18,2,5,235,242,-3
Olfr509,2,5,235,242,-3
Dph3,2,5,235,242,-3
Unkl,3,6,233,242,-3
Zfp536,1,4,237,242,-3
Uqcc3,2,5,235,242,-3
Tmem26,3,6,233,242,-3
Gabarap,2,5,235,242,-3
Taf6l,2,5,235,242,-3
Guca2a,18,21,203,242,-3
Camkv,2,5,235,242,-3
Rtl6,1,4,237,242,-3
Dpp10,2,5,235,242,-3
Gab2,2,5,235,242,-3
Tmem256,8,11,223,242,-3
Dpp9,2,5,235,242,-3
Sdf4,2,5,235,242,-3
Lrrc24,7,10,225,242,-3
Limk2,2,5,235,242,-3
Atxn10,4,7,231,242,-3
Uri1,3,6,233,242,-3
Gde1,3,6,233,242,-3
Ppt2,2,5,235,242,-3
Pdzrn4,0,3,239,242,-3
Gdf5,1,4,237,242,-3
Gdf3,4,7,231,242,-3
Gm50318,21,24,197,242,-3
Parp4,5,8,229,242,-3
Ddx19b,2,5,235,242,-3
Gp5,8,11,223,242,-3
Ccdc6,5,8,229,242,-3
Krtap9-3,3,6,233,242,-3
4921524J17Rik,7,10,225,242,-3
Tor4a,5,8,229,242,-3
Ces2b,5,8,229,242,-3
Ascl5,6,9,227,242,-3
Senp5,3,6,233,242,-3
Klra10,1,4,237,242,-3
Sult3a2,1,4,237,242,-3
Gm50388,16,19,207,242,-3
Pecr,11,14,217,242,-3
Gda,3,6,233,242,-3
Gpank1,4,7,231,242,-3
Umad1,4,7,231,242,-3
Septin3,5,8,229,242,-3
Ces3a,1,4,237,242,-3
Scap,3,6,233,242,-3
Paqr4,3,6,233,242,-3
Paqr3,4,7,231,242,-3
Pou6f2,0,3,239,242,-3
Vmn2r89,1,4,237,242,-3
Kcnd2,1,4,237,242,-3
Pex13,3,6,233,242,-3
Gm9747,5,8,229,242,-3
Golm1,5,8,229,242,-3
Ppp2r5b,5,8,229,242,-3
Pbdc1,4,7,231,242,-3
Vmn2r58,0,3,239,242,-3
Usp12,3,6,233,242,-3
Pdss1,5,8,229,242,-3
Senp1,2,5,235,242,-3
Arpp21,0,3,239,242,-3
Pax9,0,3,239,242,-3
Klrc3,2,5,235,242,-3
1810049J17Rik,23,26,193,242,-3
Gon4l,3,6,233,242,-3
Tpcn1,2,5,235,242,-3
Gm10428,2,5,235,242,-3
Got1,4,7,231,242,-3
Gja8,0,3,239,242,-3
Gdpd1,0,3,239,242,-3
Ppp5c,2,5,235,242,-3
Patj,3,6,233,242,-3
Zfp959,6,9,227,242,-3
Snx9,2,5,235,242,-3
Jph2,2,5,235,242,-3
4833439L19Rik,3,6,233,242,-3
Josd2,2,5,235,242,-3
Arpc2,4,7,231,242,-3
Soat1,5,8,229,242,-3
Gosr1,2,5,235,242,-3
Gosr2,2,5,235,242,-3
Gcnt3,3,6,233,242,-3
Asf1a,5,8,229,242,-3
4930407I10Rik,1,4,237,242,-3
Sln,2,5,235,242,-3
Catsperg1,1,4,237,242,-3
Slc6a20b,3,6,233,242,-3
Padi1,0,3,239,242,-3
Zim1,0,3,239,242,-3
Gm94,1,4,237,242,-3
Sympk,3,6,233,242,-3
Slc6a20a,4,7,231,242,-3
Top1mt,2,5,235,242,-3
Pacs2,3,6,233,242,-3
Zfp868,4,7,231,242,-3
Zfp846,2,5,235,242,-3
Pou2f3,3,6,233,242,-3
Ceacam13,0,3,239,242,-3
Pabpc4,5,8,229,242,-3
Lacc1,5,8,229,242,-3
Pramel40,4,7,231,242,-3
4930523C07Rik,12,15,215,242,-3
Socs4,4,7,231,242,-3
Zfp830,2,5,235,242,-3
Tomm70a,2,5,235,242,-3
Pex11b,2,5,235,242,-3
Socs6,5,8,229,242,-3
Defa17,3,6,233,242,-3
Gm9048,3,6,233,242,-3
Vmn2r99,1,4,237,242,-3
P3h1,6,9,227,242,-3
Atp6v0a1,4,7,231,242,-3
Ulbp1,6,9,227,242,-3
Ctag2,0,3,239,242,-3
Vmn2r56,0,3,239,242,-3
Zik1,3,6,233,242,-3
Gcfc2,2,5,235,242,-3
Ddx46,3,6,233,242,-3
Ddx47,3,6,233,242,-3
Panx1,3,6,233,242,-3
Slc7a1,1,4,237,242,-3
Gpatch2l,3,6,233,242,-3
Lactb,3,6,233,242,-3
Lactb2,3,6,233,242,-3
Ulk2,4,7,231,242,-3
Zfp937,6,9,227,242,-3
Gpbp1l1,2,5,235,242,-3
Scamp1,4,7,231,242,-3
Gcm2,0,3,239,242,-3
Armcx3,5,8,229,242,-3
Cav1,12,15,215,242,-3
4930455H04Rik,1,4,237,242,-3
Sel1l,2,5,235,242,-3
Tuba1c,9,12,221,242,-3
Slmap,2,5,235,242,-3
Paip1,9,12,221,242,-3
Pou4f3,0,3,239,242,-3
Gm49366,8,11,223,242,-3
Pagr1b,39,42,161,242,-3
Pepd,2,5,235,242,-3
Ttc39c,3,6,233,242,-3
Usp36,2,5,235,242,-3
Ddx6,3,6,233,242,-3
1700125H20Rik,14,17,211,242,-3
Gemin2,3,6,233,242,-3
Atp5c1,4,7,231,242,-3
Dars,5,8,229,242,-3
Krt4,0,3,239,242,-3
Ppm1j,1,4,237,242,-3
Pde4b,2,5,235,242,-3
Pde4d,2,5,235,242,-3
Ggt6,5,8,229,242,-3
Zfyve1,3,6,233,242,-3
Sem1,2,5,235,242,-3
Gnat3,1,4,237,242,-3
Krt36,0,3,239,242,-3
Gnb1,3,6,233,242,-3
Pcif1,2,5,235,242,-3
Gmfb,5,8,229,242,-3
Sema3c,6,9,227,242,-3
2210016L21Rik,3,6,233,242,-3
Katna1,2,5,235,242,-3
Tpk1,3,6,233,242,-3
Pde6b,1,4,237,242,-3
Dclre1c,2,5,235,242,-3
Pced1b,6,9,227,242,-3
Pde6c,1,4,237,242,-3
Ppm1f,2,5,235,242,-3
Dcp1a,5,8,229,242,-3
Ppp1r2,5,8,229,242,-3
Dcpp1,5,8,229,242,-3
Zfx,3,6,233,242,-3
Artn,6,9,227,242,-3
Gm4952,5,8,229,242,-3
Ggact,2,5,235,242,-3
Zfr2,10,13,219,242,-3
Tpr,2,5,235,242,-3
Pcnp,7,10,225,242,-3
2210408I21Rik,5,8,229,242,-3
Pcnx2,0,3,239,242,-3
Snx3,3,6,233,242,-3
Krt13,3,6,233,242,-3
Ctns,3,6,233,242,-3
Gmppb,4,7,231,242,-3
Pdcd7,3,6,233,242,-3
Kbtbd12,3,6,233,242,-3
Asb13,4,7,231,242,-3
Pcyt1b,3,6,233,242,-3
Krr1,2,5,235,242,-3
Vmn2r18,1,4,237,242,-3
Pcyox1l,3,6,233,242,-3
Celf1,2,5,235,242,-3
Ppp1r11,5,8,229,242,-3
Gid4,2,5,235,242,-3
Cer1,8,11,223,242,-3
Cc2d2a,5,8,229,242,-3
Krt23,0,3,239,242,-3
Pcsk2,1,4,237,242,-3
Zfyve27,3,6,233,242,-3
Dcaf1,3,6,233,242,-3
Kcmf1,2,5,235,242,-3
2310022B05Rik,4,7,231,242,-3
Ctnnbip1,3,6,233,242,-3
Ppp1r14b,3,6,233,242,-3
Pcolce,3,6,233,242,-3
Asap2,2,5,235,242,-3
Ctnnb1,3,6,233,242,-3
Gmeb2,3,6,233,242,-3
Vmn2r78,2,5,235,242,-3
Vmn2r59,4,7,231,242,-3
Ppie,2,5,235,242,-3
Arrb1,2,5,235,242,-3
Gnptg,3,6,233,242,-3
Pdhb,5,8,229,242,-3
Ddah2,5,8,229,242,-3
Pcdh9,1,4,237,242,-3
Gm50092,3,6,233,242,-3
Pcdh8,1,4,237,242,-3
Cbr1,2,5,235,242,-3
2200002D01Rik,7,10,225,242,-3
Pdia4,5,8,229,242,-3
Kansl2,2,5,235,242,-3
Atp4a,4,7,231,242,-3
Pcdh15,1,4,237,242,-3
Ppid,4,7,231,242,-3
Gga1,2,5,235,242,-3
Asb6,2,5,235,242,-3
Ppib,3,6,233,242,-3
Ppp1r9b,2,5,235,242,-3
Zfp971,12,15,215,242,-3
Usp25,2,5,235,242,-3
Get4,2,5,235,242,-3
Kmo,8,11,223,242,-3
Gm49405,1,4,237,242,-3
Selenom,5,8,229,242,-3
Zfp969,10,13,219,242,-3
Golga7,5,8,229,242,-3
Slc8a1,4,7,231,242,-3
Tpcn2,3,6,233,242,-3
Supt6,2,5,235,242,-3
Knl1,1,4,237,242,-3
Dda1,2,5,235,242,-3
Gnpnat1,3,6,233,242,-3
Ccdc51,4,7,231,242,-3
Gng7,5,8,229,242,-3
Usp20,3,6,233,242,-3
Dctn5,2,5,235,242,-3
Kars,2,5,235,242,-3
Slc9a6,4,7,231,242,-3
Arsj,0,3,239,242,-3
Gipc1,3,6,233,242,-3
Pcdhb4,1,4,237,242,-3
2610044O15Rik8,5,8,229,242,-3
Pcdhb22,2,5,235,242,-3
Pcdhb21,1,4,237,242,-3
Kpna6,2,5,235,242,-3
Gfra4,7,10,225,242,-3
2610507B11Rik,2,5,235,242,-3
Atp2c1,3,6,233,242,-3
Cep95,4,7,231,242,-3
Vmn2r66,0,3,239,242,-3
Slc9a4,0,3,239,242,-3
Slc9a3,2,5,235,242,-3
2810004N23Rik,3,6,233,242,-3
Dbnl,2,5,235,242,-3
Gnpda1,5,8,229,242,-3
Pcdhac1,1,4,237,242,-3
Syndig1,2,5,235,242,-3
Pcdha8,2,5,235,242,-3
Pcdha7,1,4,237,242,-3
Uhrf1bp1l,2,5,235,242,-3
Pex16,5,8,229,242,-3
Olfr804,4,7,231,242,-3
Slc4a10,1,4,237,242,-3
Gli3,2,5,235,242,-3
Atpsckmt,4,7,231,242,-3
Kcnj1,3,6,233,242,-3
Carhsp1,3,6,233,242,-3
Letm1,3,6,233,242,-3
Gprin3,0,3,239,242,-3
Klhl12,2,5,235,242,-3
Itga10,0,3,239,242,-3
4933427D14Rik,9,12,221,242,-3
Klhl11,2,5,235,242,-3
Samd13,17,20,205,242,-3
Gar1,4,7,231,242,-3
Dffa,3,6,233,242,-3
Carf,2,5,235,242,-3
Trappc3l,4,7,231,242,-3
Glipr1l2,0,3,239,242,-3
Utp23,4,7,231,242,-3
Polr1b,3,6,233,242,-3
Lgi1,4,7,231,242,-3
Tubg2,0,3,239,242,-3
Sox11,1,4,237,242,-3
Phf21b,2,5,235,242,-3
Phf23,3,6,233,242,-3
Phf3,2,5,235,242,-3
Zfp644,3,6,233,242,-3
Arhgef40,6,9,227,242,-3
Prkcsh,3,6,233,242,-3
Gpx7,6,9,227,242,-3
Cdr1,0,3,239,242,-3
Tnr,0,3,239,242,-3
Vmn2r118,0,3,239,242,-3
Prkca,2,5,235,242,-3
Prkag1,2,5,235,242,-3
Casp2,4,7,231,242,-3
Casp14,3,6,233,242,-3
Olfr982,0,3,239,242,-3
Phb2,2,5,235,242,-3
Klhl22,5,8,229,242,-3
Olfr98,0,3,239,242,-3
Kcnip3,3,6,233,242,-3
Gli1,4,7,231,242,-3
Olfr976,3,6,233,242,-3
Prkar2a,2,5,235,242,-3
Cyth2,2,5,235,242,-3
Atp8b2,8,11,223,242,-3
Aspg,4,7,231,242,-3
Phf11c,1,4,237,242,-3
Dennd6a,2,5,235,242,-3
Txnl4a,3,6,233,242,-3
Zfp664,2,5,235,242,-3
Tnrc18,3,6,233,242,-3
Olfr957,0,3,239,242,-3
Samt3,1,4,237,242,-3
Olfr954,3,6,233,242,-3
Cdr2l,7,10,225,242,-3
Phf11a,8,11,223,242,-3
Zmym2,5,8,229,242,-3
Cdr2,4,7,231,242,-3
Gas1,7,10,225,242,-3
Derl2,3,6,233,242,-3
Phf5a,2,5,235,242,-3
Gm8267,2,5,235,242,-3
Olfr896-ps1,1,4,237,242,-3
Cdkn2aip,4,7,231,242,-3
Phpt1,3,6,233,242,-3
Ccl19,9,12,221,242,-3
Dhx57,2,5,235,242,-3
Olfr829,2,5,235,242,-3
Gria4,2,5,235,242,-3
Poldip3,2,5,235,242,-3
Poldip2,2,5,235,242,-3
Lilra6,2,5,235,242,-3
Olfr825,1,4,237,242,-3
1700030K09Rik,2,5,235,242,-3
Smc4,5,8,229,242,-3
Diaph1,2,5,235,242,-3
Dicer1,2,5,235,242,-3
Olfr816,3,6,233,242,-3
Zmym4,2,5,235,242,-3
Phyhipl,6,9,227,242,-3
Tnfrsf21,7,10,225,242,-3
Cyp4f37,1,4,237,242,-3
Tnfrsf1b,7,10,225,242,-3
Dip2b,2,5,235,242,-3
Pi15,3,6,233,242,-3
Dip2c,2,5,235,242,-3
Slc44a2,6,9,227,242,-3
Olfr810,0,3,239,242,-3
Cend1,6,9,227,242,-3
Grik3,0,3,239,242,-3
Pola2,3,6,233,242,-3
Tnfrsf14,8,11,223,242,-3
Dhx35,3,6,233,242,-3
Lig1,2,5,235,242,-3
Tstd3,3,6,233,242,-3
Aspscr1,3,6,233,242,-3
Lgr6,0,3,239,242,-3
Klhdc8a,3,6,233,242,-3
Olfr890,1,4,237,242,-3
Zmym5,4,7,231,242,-3
Tnks,2,5,235,242,-3
Ganab,3,6,233,242,-3
Slc46a3,6,9,227,242,-3
Dhfr,4,7,231,242,-3
Gm5155,0,3,239,242,-3
Cypt4,2,5,235,242,-3
Traj26,0,3,239,242,-3
Gramd4,2,5,235,242,-3
Slf1,4,7,231,242,-3
Cs,4,7,231,242,-3
Lhfpl5,5,8,229,242,-3
Klhdc3,2,5,235,242,-3
Dhrs7,6,9,227,242,-3
Grb10,2,5,235,242,-3
Zmynd19,2,5,235,242,-3
Smc1a,5,8,229,242,-3
Lhx2,7,10,225,242,-3
Klhdc10,2,5,235,242,-3
Cep164,5,8,229,242,-3
Utp4,2,5,235,242,-3
Lhx6,2,5,235,242,-3
Sec61a1,3,6,233,242,-3
Cep152,0,3,239,242,-3
Klhl24,2,5,235,242,-3
Togaram2,0,3,239,242,-3
Cyth3,6,9,227,242,-3
Ccdc80,4,7,231,242,-3
Saxo2,14,17,211,242,-3
Klk14,11,14,217,242,-3
Zfp771,3,6,233,242,-3
Lbr,3,6,233,242,-3
Gm5128,1,4,237,242,-3
Uhrf1bp1,2,5,235,242,-3
Pfn1,4,7,231,242,-3
4930595D18Rik,7,10,225,242,-3
Gm8926,2,5,235,242,-3
Gpr142,4,7,231,242,-3
Arl14ep,2,5,235,242,-3
Gbp10,6,9,227,242,-3
Trav14-3,3,6,233,242,-3
Satl1,0,3,239,242,-3
Asmt,8,11,223,242,-3
Satb2,4,7,231,242,-3
Asl,5,8,229,242,-3
Gm1113,0,3,239,242,-3
Zfp747,6,9,227,242,-3
Vmn2r117,1,4,237,242,-3
Zfp740,5,8,229,242,-3
Ostf1,5,8,229,242,-3
Pomk,5,8,229,242,-3
Atp11c,4,7,231,242,-3
Osr2,8,11,223,242,-3
Gm11146,0,3,239,242,-3
Cast,2,5,235,242,-3
4931408C20Rik,0,3,239,242,-3
4930583I09Rik,7,10,225,242,-3
Pomt2,2,5,235,242,-3
Traip,4,7,231,242,-3
Serinc5,2,5,235,242,-3
Pot1b,4,7,231,242,-3
Arl6ip6,2,5,235,242,-3
Sectm1a,6,9,227,242,-3
Klk1b27,5,8,229,242,-3
Cstdc6,3,6,233,242,-3
Pramel5,0,3,239,242,-3
Ltn1,2,5,235,242,-3
Larp1,3,6,233,242,-3
Larp1b,3,6,233,242,-3
Klk1b22,2,5,235,242,-3
Slc6a18,2,5,235,242,-3
4930568D16Rik,1,4,237,242,-3
Ccdc78,3,6,233,242,-3
Dab1,6,9,227,242,-3
Cstdc4,11,14,217,242,-3
Oxr1,3,6,233,242,-3
Arl6,3,6,233,242,-3
Surf2,2,5,235,242,-3
Ttc32,5,8,229,242,-3
Pfdn2,3,6,233,242,-3
Ttc30a1,1,4,237,242,-3
Zfp787,3,6,233,242,-3
Sbf1,2,5,235,242,-3
Vnn3,0,3,239,242,-3
Otx2,4,7,231,242,-3
Zfp781,15,18,209,242,-3
Otulin,3,6,233,242,-3
Zmat2,6,9,227,242,-3
Gpr157,2,5,235,242,-3
Tom1,3,6,233,242,-3
Sort1,2,5,235,242,-3
Gpr18,5,8,229,242,-3
Sec63,4,7,231,242,-3
Gpr180,2,5,235,242,-3
Prkaa1,2,5,235,242,-3
Tomm20l,22,25,195,242,-3
D130040H23Rik,8,11,223,242,-3
Casp8,7,10,225,242,-3
Oosp2,4,7,231,242,-3
Zfp704,2,5,235,242,-3
Gata5,0,3,239,242,-3
Traj24,3,6,233,242,-3
Lcor,2,5,235,242,-3
Klhl3,7,10,225,242,-3
Ooep,3,6,233,242,-3
Csrnp3,4,7,231,242,-3
Vps16,3,6,233,242,-3
Ccdc126,3,6,233,242,-3
4933402N03Rik,1,4,237,242,-3
Defb7,1,4,237,242,-3
Ldah,3,6,233,242,-3
Pgrmc2,2,5,235,242,-3
Prkaca,2,5,235,242,-3
Gpr35,9,12,221,242,-3
Sar1a,3,6,233,242,-3
Klhl29,0,3,239,242,-3
Gle1,2,5,235,242,-3
Gpr37l1,1,4,237,242,-3
Dele1,2,5,235,242,-3
Defb4,3,6,233,242,-3
Opn4,1,4,237,242,-3
Oprd1,1,4,237,242,-3
Atp6v1d,3,6,233,242,-3
Osbpl8,2,5,235,242,-3
Prep,6,9,227,242,-3
Defb18,2,5,235,242,-3
Csrnp2,3,6,233,242,-3
Slc5a4b,4,7,231,242,-3
Pomc,9,12,221,242,-3
Lce1m,3,6,233,242,-3
Pgap6,2,5,235,242,-3
Zfp719,2,5,235,242,-3
Osbp,2,5,235,242,-3
Gatd3a,2,5,235,242,-3
4931428L18Rik,2,5,235,242,-3
Szt2,3,6,233,242,-3
Defb21,1,4,237,242,-3
Zfp715,6,9,227,242,-3
Zfp711,1,4,237,242,-3
Sycp2l,2,5,235,242,-3
Usp51,2,5,235,242,-3
Csnk2a2,5,8,229,242,-3
1700074P13Rik,1,4,237,242,-3
Arih1,2,5,235,242,-3
Atp6v1b2,2,5,235,242,-3
Polr3g,4,7,231,242,-3
D230025D16Rik,4,7,231,242,-3
Gatc,2,5,235,242,-3
Usp53,4,7,231,242,-3
Klhl34,4,7,231,242,-3
Pramel50,6,9,227,242,-3
Reln,1,4,237,242,-3
Prrc1,2,5,235,242,-3
Rab23,2,5,235,242,-3
Rab11b,3,6,233,242,-3
Rab11a,5,8,229,242,-3
Sirt3,4,7,231,242,-3
Mien1,2,5,235,242,-3
Gm21897,7,10,225,242,-3
Zc3h15,2,5,235,242,-3
Chtop,3,6,233,242,-3
Igkv17-121,8,11,223,242,-3
Sirt4,3,6,233,242,-3
Stimate,3,6,233,242,-3
BC035044,7,10,225,242,-3
Micu3,3,6,233,242,-3
Tgfbr3,4,7,231,242,-3
Rita1,3,6,233,242,-3
BC034090,3,6,233,242,-3
Cmbl,9,12,221,242,-3
Nlrx1,7,10,225,242,-3
Rab11fip4,2,5,235,242,-3
Ciao3,2,5,235,242,-3
Tfg,6,9,227,242,-3
Hsd17b7,2,5,235,242,-3
Igkv12-98,6,9,227,242,-3
Hsd17b4,2,5,235,242,-3
Tbc1d32,2,5,235,242,-3
Mindy3,4,7,231,242,-3
Exosc1,3,6,233,242,-3
Cmas,6,9,227,242,-3
Vmn1r17,3,6,233,242,-3
Igkv13-85,7,10,225,242,-3
Trpm8,0,3,239,242,-3
Exoc7,7,10,225,242,-3
Nlrp4e,0,3,239,242,-3
Gm21886,8,11,223,242,-3
Noa1,2,5,235,242,-3
Zc4h2,4,7,231,242,-3
Tgfbrap1,4,7,231,242,-3
Qars,3,6,233,242,-3
Mgat5,3,6,233,242,-3
Etv5,5,8,229,242,-3
Srek1ip1,4,7,231,242,-3
Adad1,4,7,231,242,-3
Brwd1,4,7,231,242,-3
Hrct1,5,8,229,242,-3
Rmdn1,4,7,231,242,-3
Cmpk2,2,5,235,242,-3
Nox3,5,8,229,242,-3
Trim41,4,7,231,242,-3
Gm17455,9,12,221,242,-3
Hras,4,7,231,242,-3
Rmdn2,8,11,223,242,-3
Tgm3,2,5,235,242,-3
Adal,4,7,231,242,-3
Angptl3,7,10,225,242,-3
Sirt7,3,6,233,242,-3
Mical3,3,6,233,242,-3
Hs6st3,1,4,237,242,-3
Rlf,2,5,235,242,-3
Qrich2,5,8,229,242,-3
Micall2,2,5,235,242,-3
BC030500,0,3,239,242,-3
Cmc4,7,10,225,242,-3
Mia3,2,5,235,242,-3
Angptl1,1,4,237,242,-3
Nol9,3,6,233,242,-3
Tgif2,3,6,233,242,-3
Nono,5,8,229,242,-3
Brpf3,4,7,231,242,-3
Hs2st1,4,7,231,242,-3
Nop53,3,6,233,242,-3
Zbtb7c,2,5,235,242,-3
Adam39,0,3,239,242,-3
Npat,4,7,231,242,-3
Hsd3b7,8,11,223,242,-3
Nfkbie,2,5,235,242,-3
Steap4,3,6,233,242,-3
Nfrkb,2,5,235,242,-3
Brd4,2,5,235,242,-3
Bcap31,8,11,223,242,-3
Hspa4,2,5,235,242,-3
F830045P16Rik,3,6,233,242,-3
Rab5c,2,5,235,242,-3
Zbtb44,8,11,223,242,-3
Adamts2,2,5,235,242,-3
Brd9,4,7,231,242,-3
Bcap29,2,5,235,242,-3
Simc1,5,8,229,242,-3
F5,2,5,235,242,-3
Fgf11,1,4,237,242,-3
Mmab,6,9,227,242,-3
Rida,8,11,223,242,-3
Rictor,3,6,233,242,-3
Clns1a,4,7,231,242,-3
Adar,4,7,231,242,-3
Gm21773,2,5,235,242,-3
Neurog3,0,3,239,242,-3
Cic,3,6,233,242,-3
Nf1,2,5,235,242,-3
Fgb,7,10,225,242,-3
Amigo3,3,6,233,242,-3
Adamtsl4,0,3,239,242,-3
Ammecr1,3,6,233,242,-3
Fadd,2,5,235,242,-3
Gm21798,23,26,193,242,-3
Clp1,2,5,235,242,-3
Trim56,6,9,227,242,-3
Fgd1,5,8,229,242,-3
Mllt10,2,5,235,242,-3
Zbtb45,2,5,235,242,-3
Mllt1,3,6,233,242,-3
Wipi2,2,5,235,242,-3
Adam6b,1,4,237,242,-3
Rab38,7,10,225,242,-3
Rims2,1,4,237,242,-3
Tfb2m,3,6,233,242,-3
Amy2a1,2,5,235,242,-3
Mkln1,3,6,233,242,-3
Zbtb48,4,7,231,242,-3
Srms,6,9,227,242,-3
Sipa1l3,3,6,233,242,-3
Rab30,7,10,225,242,-3
Cluap1,3,6,233,242,-3
Tfeb,5,8,229,242,-3
Cluh,2,5,235,242,-3
Clvs2,1,4,237,242,-3
Mks1,3,6,233,242,-3
Wiz,3,6,233,242,-3
Trim44,4,7,231,242,-3
Adamdec1,2,5,235,242,-3
Nhp2,3,6,233,242,-3
Rimbp3,1,4,237,242,-3
Nhsl1,2,5,235,242,-3
Clstn1,2,5,235,242,-3
Mlh3,2,5,235,242,-3
Rab43,3,6,233,242,-3
Rab40c,5,8,229,242,-3
Cd59b,13,16,213,242,-3
Nif3l1,2,5,235,242,-3
Brf1,3,6,233,242,-3
Rab3gap2,2,5,235,242,-3
Fgf13,3,6,233,242,-3
Ninj2,8,11,223,242,-3
Stfa1,7,10,225,242,-3
Brwd3,3,6,233,242,-3
Tgm4,8,11,223,242,-3
Btbd35f29,0,3,239,242,-3
Rnf14,3,6,233,242,-3
Acot7,4,7,231,242,-3
Acot6,4,7,231,242,-3
Nuak1,5,8,229,242,-3
Ptp4a3,3,6,233,242,-3
Wdr83,3,6,233,242,-3
Hnrnpul2,2,5,235,242,-3
Baz2a,2,5,235,242,-3
Nucks1,5,8,229,242,-3
Cd320,2,5,235,242,-3
Stk25,3,6,233,242,-3
Erich6,5,8,229,242,-3
Meikin,0,3,239,242,-3
Flt3l,11,14,217,242,-3
Acot4,5,8,229,242,-3
Hnrnpm,3,6,233,242,-3
Ptpa,2,5,235,242,-3
Ptpn1,2,5,235,242,-3
Them4,4,7,231,242,-3
Vmn1r31,3,6,233,242,-3
Gm26741,0,3,239,242,-3
Nt5c1b,1,4,237,242,-3
Nt5c3b,5,8,229,242,-3
Ptpn23,3,6,233,242,-3
Mesd,3,6,233,242,-3
Hook2,5,8,229,242,-3
Cdh24,2,5,235,242,-3
Gm26992,18,21,203,242,-3
Chst13,0,3,239,242,-3
Meox1,4,7,231,242,-3
Ermp1,3,6,233,242,-3
Cnga2,2,5,235,242,-3
Memo1,4,7,231,242,-3
Tas2r140,0,3,239,242,-3
Hnrnpll,2,5,235,242,-3
Nudt16l1,2,5,235,242,-3
Hnrnpl,3,6,233,242,-3
Rnf20,2,5,235,242,-3
Ptgdr2,5,8,229,242,-3
Nup62,2,5,235,242,-3
Gm17019,7,10,225,242,-3
Nup98,3,6,233,242,-3
Gm16867,3,6,233,242,-3
Ackr1,4,7,231,242,-3
Nus1,2,5,235,242,-3
Ercc6l,0,3,239,242,-3
Btbd35f27,0,3,239,242,-3
Hmx2,5,8,229,242,-3
Hmx1,5,8,229,242,-3
Med12l,2,5,235,242,-3
Nxf1,2,5,235,242,-3
Med12,2,5,235,242,-3
Nup43,3,6,233,242,-3
Spx,17,20,205,242,-3
Megf6,0,3,239,242,-3
Nudt8,7,10,225,242,-3
Zfhx4,4,7,231,242,-3
Tas2r135,8,11,223,242,-3
Nudt3,2,5,235,242,-3
Mef2c,7,10,225,242,-3
Igkv8-27,5,8,229,242,-3
Med9,2,5,235,242,-3
Wdr76,3,6,233,242,-3
Nup205,3,6,233,242,-3
Btbd35f21,0,3,239,242,-3
Thra,5,8,229,242,-3
Bap1,3,6,233,242,-3
Nup107,3,6,233,242,-3
Hnrnpa2b1,3,6,233,242,-3
Med27,3,6,233,242,-3
Tasl,2,5,235,242,-3
Nsun4,4,7,231,242,-3
Skap1,6,9,227,242,-3
Nsun3,3,6,233,242,-3
Cmtr1,4,7,231,242,-3
Actn3,2,5,235,242,-3
Etaa1,3,6,233,242,-3
Esyt3,4,7,231,242,-3
Bbs5,5,8,229,242,-3
Speer4a,3,6,233,242,-3
Ankrd10,2,5,235,242,-3
Tbc1d1,3,6,233,242,-3
Esrrb,6,9,227,242,-3
Mfn2,2,5,235,242,-3
Esrra,4,7,231,242,-3
Chst9,1,4,237,242,-3
Vmn1r29,1,4,237,242,-3
Nr1i3,4,7,231,242,-3
Rnd1,3,6,233,242,-3
Hp1bp3,4,7,231,242,-3
Nptn,5,8,229,242,-3
Ankdd1b,4,7,231,242,-3
Etfdh,4,7,231,242,-3
Ets1,2,5,235,242,-3
Etnk1,2,5,235,242,-3
Igkv4-58,3,6,233,242,-3
Rmdn3,2,5,235,242,-3
Fibp,2,5,235,242,-3
Sgo1,4,7,231,242,-3
Tbc1d10c,6,9,227,242,-3
Fis1,3,6,233,242,-3
BC003965,2,5,235,242,-3
Hpgd,6,9,227,242,-3
Nppa,11,14,217,242,-3
Npr3,4,7,231,242,-3
Fip1l1,2,5,235,242,-3
Pxn,2,5,235,242,-3
Mfap3,2,5,235,242,-3
Wee1,2,5,235,242,-3
Mfap1a,3,6,233,242,-3
Skint7,2,5,235,242,-3
Skint5,0,3,239,242,-3
Acsbg3,7,10,225,242,-3
Nsd1,2,5,235,242,-3
Mettl14,3,6,233,242,-3
Nsdhl,6,9,227,242,-3
Igkv6-13,5,8,229,242,-3
Acrv1,5,8,229,242,-3
Btbd35f15,1,4,237,242,-3
Hoxa13,1,4,237,242,-3
Hoxa11,1,4,237,242,-3
Nsmce3,1,4,237,242,-3
Rnf138,4,7,231,242,-3
Acp6,2,5,235,242,-3
Rnf138rt1,1,4,237,242,-3
Fkbpl,11,14,217,242,-3
Ubac2,3,6,233,242,-3
Ubald1,3,6,233,242,-3
Wdsub1,4,7,231,242,-3
Mex3c,3,6,233,242,-3
Skint3,1,4,237,242,-3
Mettl9,4,7,231,242,-3
Nr5a2,2,5,235,242,-3
Fkbp5,7,10,225,242,-3
Pum3,7,10,225,242,-3
Pum2,2,5,235,242,-3
Btbd35f13,1,4,237,242,-3
Thap12,3,6,233,242,-3
Nrep,4,7,231,242,-3
Btbd35f1,1,4,237,242,-3
Nrg3,2,5,235,242,-3
Btbd35f11,0,3,239,242,-3
Acss2,3,6,233,242,-3
Rabl2,10,13,219,242,-3
Adat1,2,5,235,242,-3
Fahd1,3,6,233,242,-3
Agtrap,3,6,233,242,-3
Vmn1r20,2,5,235,242,-3
Mrps14,2,5,235,242,-3
Ybey,3,6,233,242,-3
Ago2,2,5,235,242,-3
Mrps11,2,5,235,242,-3
Ifnl2,1,4,237,242,-3
Fbxo30,3,6,233,242,-3
Bdp1,2,5,235,242,-3
Yipf2,4,7,231,242,-3
Shc3,0,3,239,242,-3
Cdc42ep1,4,7,231,242,-3
Fam3a,4,7,231,242,-3
Tecpr2,1,4,237,242,-3
Tecr,3,6,233,242,-3
Myl6b,3,6,233,242,-3
Mrps15,3,6,233,242,-3
Rgl1,2,5,235,242,-3
Cldn34c1,2,5,235,242,-3
Trmt44,4,7,231,242,-3
Akirin1,2,5,235,242,-3
Begain,0,3,239,242,-3
Xxylt1,4,7,231,242,-3
Rbmx2,1,4,237,242,-3
Rbms3,6,9,227,242,-3
Tdpoz3,4,7,231,242,-3
Stac3,10,13,219,242,-3
Fam71f1,3,6,233,242,-3
Trmt2b,6,9,227,242,-3
Agps,5,8,229,242,-3
Mybph,3,6,233,242,-3
Rfx7,4,7,231,242,-3
Gm20737,0,3,239,242,-3
Mrps18b,4,7,231,242,-3
Rbm41,4,7,231,242,-3
Bloc1s4,2,5,235,242,-3
Yipf3,3,6,233,242,-3
Afap1,2,5,235,242,-3
Mrpl30,4,7,231,242,-3
Mrpl3,2,5,235,242,-3
Aff2,2,5,235,242,-3
Fam222b,3,6,233,242,-3
Ube2g1,3,6,233,242,-3
Tekt5,2,5,235,242,-3
Rbm25,2,5,235,242,-3
Ypel3,7,10,225,242,-3
Mrpl20,4,7,231,242,-3
Ube2f,4,7,231,242,-3
AF067063,5,8,229,242,-3
Fbxo6,4,7,231,242,-3
N4bp1,3,6,233,242,-3
Mrpl11,2,5,235,242,-3
Myo9b,2,5,235,242,-3
Mrpl34,4,7,231,242,-3
Yipf5,3,6,233,242,-3
Ighv1-75,5,8,229,242,-3
Mylk4,3,6,233,242,-3
Tectb,2,5,235,242,-3
Fbxo41,1,4,237,242,-3
Ykt6,3,6,233,242,-3
Akt1,2,5,235,242,-3
Myo18a,3,6,233,242,-3
Rbm34,3,6,233,242,-3
Blvra,3,6,233,242,-3
Mrpl40,2,5,235,242,-3
Clec2d,8,11,223,242,-3
Ylpm1,2,5,235,242,-3
Mrpl39,2,5,235,242,-3
Fbxo44,4,7,231,242,-3
Myo3a,1,4,237,242,-3
Mvd,3,6,233,242,-3
Tdpoz1,2,5,235,242,-3
Zbtb25,2,5,235,242,-3
Akip1,3,6,233,242,-3
Mtfr1l,2,5,235,242,-3
AI597479,3,6,233,242,-3
Tcf25,3,6,233,242,-3
Rdh5,4,7,231,242,-3
Mthfsd,2,5,235,242,-3
Fastkd3,3,6,233,242,-3
Msh6,4,7,231,242,-3
Fastkd1,3,6,233,242,-3
Rdh14,3,6,233,242,-3
Mtm1,4,7,231,242,-3
Bicd2,2,5,235,242,-3
Xrcc1,2,5,235,242,-3
Vmn1r216,2,5,235,242,-3
Fasn,6,9,227,242,-3
Mtmr14,3,6,233,242,-3
Xndc1,4,7,231,242,-3
Recql5,2,5,235,242,-3
Gm20826,1,4,237,242,-3
Vmn1r213,0,3,239,242,-3
St7l,2,5,235,242,-3
Relch,2,5,235,242,-3
Xpnpep1,2,5,235,242,-3
Ighj1,0,3,239,242,-3
Fbp1,9,12,221,242,-3
Xpo4,5,8,229,242,-3
St8sia1,4,7,231,242,-3
Msrb3,7,10,225,242,-3
Fbn1,3,6,233,242,-3
Reg3a,2,5,235,242,-3
Fbxl15,2,5,235,242,-3
Reg2,10,13,219,242,-3
Gm20814,0,3,239,242,-3
Xntrpc,5,8,229,242,-3
Mtmr3,2,5,235,242,-3
Mtmr9,3,6,233,242,-3
Fbxl4,7,10,225,242,-3
Mup22,4,7,231,242,-3
Tctn1,4,7,231,242,-3
Rbx1,4,7,231,242,-3
Mup10,6,9,227,242,-3
Rfc4,3,6,233,242,-3
Igf2bp1,1,4,237,242,-3
Tdp2,3,6,233,242,-3
Sh3kbp1,2,5,235,242,-3
Clba1,2,5,235,242,-3
Mrps7,2,5,235,242,-3
Mrps5,6,9,227,242,-3
Ift88,3,6,233,242,-3
Trmt6,3,6,233,242,-3
Mup9,4,7,231,242,-3
Sh3pxd2b,3,6,233,242,-3
Stac,0,3,239,242,-3
Gm20878,12,15,215,242,-3
Mtr,3,6,233,242,-3
Rcc1,4,7,231,242,-3
Mtres1,3,6,233,242,-3
Xlr,12,15,215,242,-3
Clca3b,2,5,235,242,-3
Mtrf1l,6,9,227,242,-3
Fbxo10,2,5,235,242,-3
Vmn1r210,1,4,237,242,-3
Vmn1r218,0,3,239,242,-3
Tcstv3,5,8,229,242,-3
Igfbp6,9,12,221,242,-3
Cldn12,3,6,233,242,-3
Rex1bd,2,5,235,242,-3
Ahnak,4,7,231,242,-3
Xkr9,0,3,239,242,-3
Bicral,3,6,233,242,-3
Stard10,3,6,233,242,-3
N6amt1,3,6,233,242,-3
Ighv12-3,1,4,237,242,-3
Cks1brt,6,9,227,242,-3
Trim66,2,5,235,242,-3
I0C0044D17Rik,1,4,237,242,-3
Ranbp3,2,5,235,242,-3
Ran,3,6,233,242,-3
Shroom4,4,7,231,242,-3
Clic6,6,9,227,242,-3
Fdft1,2,5,235,242,-3
Ndufb2,3,6,233,242,-3
Ighv8-11,0,3,239,242,-3
Hydin,0,3,239,242,-3
Ndufb6,2,5,235,242,-3
Ralgapb,2,5,235,242,-3
Fdxr,4,7,231,242,-3
Tex19.2,0,3,239,242,-3
Fam131c,3,6,233,242,-3
Ndufab1,4,7,231,242,-3
Fam160b1,2,5,235,242,-3
Rap1a,5,8,229,242,-3
Trim7,10,13,219,242,-3
Trp73,3,6,233,242,-3
Rapgef6,2,5,235,242,-3
Tbx21,4,7,231,242,-3
Stat1,2,5,235,242,-3
Ndfip1,3,6,233,242,-3
Fcho2,5,8,229,242,-3
Ica1,5,8,229,242,-3
Iah1,4,7,231,242,-3
Tbx20,1,4,237,242,-3
Cipc,2,5,235,242,-3
Ndufa10,2,5,235,242,-3
Shroom3,3,6,233,242,-3
Tbx19,0,3,239,242,-3
Rhox3g,1,4,237,242,-3
Mocs1,4,7,231,242,-3
Fam131b,3,6,233,242,-3
Cdca4,2,5,235,242,-3
Nelfe,2,5,235,242,-3
Fam117a,4,7,231,242,-3
Nek4,2,5,235,242,-3
Adcy1,2,5,235,242,-3
Nek6,3,6,233,242,-3
Htr7,1,4,237,242,-3
Mms19,4,7,231,242,-3
Rad17,2,5,235,242,-3
Adcy3,2,5,235,242,-3
Ambra1,2,5,235,242,-3
Tex47,0,3,239,242,-3
Vmn1r18,1,4,237,242,-3
Htr2c,0,3,239,242,-3
Wnt2,2,5,235,242,-3
Zbtb24,2,5,235,242,-3
Cd7,6,9,227,242,-3
Mnat1,2,5,235,242,-3
Fam124b,2,5,235,242,-3
Nectin1,2,5,235,242,-3
Siglecf,0,3,239,242,-3
Alpi,3,6,233,242,-3
Bcdin3d,2,5,235,242,-3
Necab3,7,10,225,242,-3
Bcat2,7,10,225,242,-3
Rad9a,2,5,235,242,-3
Rad54l2,3,6,233,242,-3
Clk2,4,7,231,242,-3
Hus1,3,6,233,242,-3
Fer1l6,1,4,237,242,-3
Nedd4,5,8,229,242,-3
Hunk,3,6,233,242,-3
Adcy5,1,4,237,242,-3
Mnd1,4,7,231,242,-3
Raph1,3,6,233,242,-3
Mpeg1,7,10,225,242,-3
Bcl10,3,6,233,242,-3
Mrgpra2b,1,4,237,242,-3
Nanos3,6,9,227,242,-3
Nans,3,6,233,242,-3
Terf2,3,6,233,242,-3
Vmn1r233,1,4,237,242,-3
Iffo2,3,6,233,242,-3
Nap1l5,6,9,227,242,-3
Gm21409,1,4,237,242,-3
Ifi206,6,9,227,242,-3
Narf,2,5,235,242,-3
Bcl2l10,5,8,229,242,-3
Nat10,4,7,231,242,-3
Rasl10a,12,15,215,242,-3
Adnp2,2,5,235,242,-3
Wwp2,4,7,231,242,-3
Adra1b,1,4,237,242,-3
Stard5,5,8,229,242,-3
Bnip3,7,10,225,242,-3
Adrb2,7,10,225,242,-3
Aldh1b1,7,10,225,242,-3
Fam214b,5,8,229,242,-3
Mroh3,3,6,233,242,-3
Fam210a,3,6,233,242,-3
Rhno1,2,5,235,242,-3
Gm2115,1,4,237,242,-3
Trnt1,2,5,235,242,-3
Ssb,5,8,229,242,-3
Bmper,6,9,227,242,-3
Sh2d1a,9,12,221,242,-3
Ube2e1,4,7,231,242,-3
Tepsin,2,5,235,242,-3
Rhobtb3,3,6,233,242,-3
Naip1,5,8,229,242,-3
Nat8f2,4,7,231,242,-3
Aldh9a1,3,6,233,242,-3
Gm20458,23,26,193,242,-3
Nck2,6,9,227,242,-3
Rasal2,3,6,233,242,-3
Bod1l,3,6,233,242,-3
Ncdn,3,6,233,242,-3
Shld2,3,6,233,242,-3
Wsb2,3,6,233,242,-3
Zbbx,1,4,237,242,-3
Mpnd,5,8,229,242,-3
Fam174a,4,7,231,242,-3
Nckap5,5,8,229,242,-3
Fam171a2,0,3,239,242,-3
Bola1,3,6,233,242,-3
Ube2b,6,9,227,242,-3
Ncln,2,5,235,242,-3
Ncmap,6,9,227,242,-3
Ncaph2,2,5,235,242,-3
Bod1,2,5,235,242,-3
Fbxw28,2,5,235,242,-3
Tesmin,4,7,231,242,-3
Aldoa,5,8,229,242,-3
Rhoj,6,9,227,242,-3
Fam184b,2,5,235,242,-3
Fbxw7,2,5,235,242,-3
Wwp1,5,8,229,242,-3
Sgta,3,6,233,242,-3
Fcamr,4,7,231,242,-3
Fam174c,3,6,233,242,-3
Ube2c,6,9,227,242,-3
Fam181b,0,3,239,242,-3
Rasgrp1,1,4,237,242,-3
Fam181a,4,7,231,242,-3
Wtip,3,6,233,242,-3
Mpp4,1,4,237,242,-3
Btbd35f28,0,3,239,242,-3
Ankle2,2,5,235,242,-3
Iglon5,2,5,235,242,-3
Vmn1r6,0,3,239,242,-3
Prss58,0,3,239,242,-3
Olfr1283,0,3,239,242,-3
Tars2,2,5,235,242,-3
Abhd16a,2,5,235,242,-3
Frat2,4,7,231,242,-3
Aox2,2,5,235,242,-3
Zfp280b,8,11,223,242,-3
Abhd2,2,5,235,242,-3
Chmp1b,2,5,235,242,-3
Olfr126,2,5,235,242,-3
Hdac7,3,6,233,242,-3
Eif3a,4,7,231,242,-3
Eif3e,7,10,225,242,-3
Spp2,9,12,221,242,-3
Hddc3,3,6,233,242,-3
Eif3g,3,6,233,242,-3
Fpgt,4,7,231,242,-3
Vmn1r61,1,4,237,242,-3
Eif3j1,4,7,231,242,-3
Map2k3,3,6,233,242,-3
Gm15023,2,5,235,242,-3
Eif3m,3,6,233,242,-3
Slc22a23,3,6,233,242,-3
Rpl24,7,10,225,242,-3
Tas2r103,0,3,239,242,-3
Heatr3,4,7,231,242,-3
Map3k12,2,5,235,242,-3
Rpl21,4,7,231,242,-3
Il23r,2,5,235,242,-3
Spock3,1,4,237,242,-3
Ap1ar,6,9,227,242,-3
Gm31160,0,3,239,242,-3
C2cd4a,5,8,229,242,-3
Olfr1346,0,3,239,242,-3
Frs2,3,6,233,242,-3
Zfp316,3,6,233,242,-3
Slc25a12,3,6,233,242,-3
Spink2,18,21,203,242,-3
C330007P06Rik,3,6,233,242,-3
B3galt5,2,5,235,242,-3
Frmpd2,2,5,235,242,-3
C2cd4d,11,14,217,242,-3
Wbp1l,3,6,233,242,-3
Col6a2,3,6,233,242,-3
Eif1ad13,7,10,225,242,-3
Gm14496,0,3,239,242,-3
C2cd3,2,5,235,242,-3
Abhd14b,3,6,233,242,-3
Trdv2-2,4,7,231,242,-3
Zfp3,4,7,231,242,-3
Zfp296,9,12,221,242,-3
Abhd11,3,6,233,242,-3
Tspan12,5,8,229,242,-3
Rpl36al,2,5,235,242,-3
Prss53,7,10,225,242,-3
Ap1g1,2,5,235,242,-3
Rpl36a,7,10,225,242,-3
Eif1ax,2,5,235,242,-3
Frmd3,1,4,237,242,-3
Tspan11,2,5,235,242,-3
Maml2,4,7,231,242,-3
Slc22a18,3,6,233,242,-3
Abhd8,4,7,231,242,-3
Prss47,3,6,233,242,-3
Rpl19,6,9,227,242,-3
Gm29423,7,10,225,242,-3
Foxl3,11,14,217,242,-3
Eloa,2,5,235,242,-3
Stoml2,5,8,229,242,-3
Il1b,2,5,235,242,-3
Marchf3,4,7,231,242,-3
Ano9,3,6,233,242,-3
Olfr1150-ps1,1,4,237,242,-3
Hes5,6,9,227,242,-3
Elovl4,0,3,239,242,-3
Trgv1,4,7,231,242,-3
Gm15155,0,3,239,242,-3
Foxk1,2,5,235,242,-3
Psma6,5,8,229,242,-3
Elp5,3,6,233,242,-3
Cog1,2,5,235,242,-3
Cd22,5,8,229,242,-3
Emc1,3,6,233,242,-3
Mark2,3,6,233,242,-3
Foxj3,3,6,233,242,-3
Abl2,2,5,235,242,-3
Emc8,3,6,233,242,-3
Ropn1,3,6,233,242,-3
Olfr1116,1,4,237,242,-3
Emd,4,7,231,242,-3
Eme2,4,7,231,242,-3
Olfr111,0,3,239,242,-3
Rogdi,3,6,233,242,-3
Cd244a,0,3,239,242,-3
Rpa1,2,5,235,242,-3
Gm15127,7,10,225,242,-3
Elmo3,2,5,235,242,-3
Olfr1198,5,8,229,242,-3
Olfr1219,4,7,231,242,-3
Hectd1,2,5,235,242,-3
Rpl18a,3,6,233,242,-3
Col23a1,4,7,231,242,-3
Il21r,7,10,225,242,-3
Abi1,6,9,227,242,-3
Abi2,3,6,233,242,-3
Eif5a,4,7,231,242,-3
Eif5b,2,5,235,242,-3
Abi3,8,11,223,242,-3
Anxa2,3,6,233,242,-3
Rpl12,3,6,233,242,-3
Foxp3,15,18,209,242,-3
Rpl11,4,7,231,242,-3
Anp32a,4,7,231,242,-3
Sfi1,4,7,231,242,-3
Rpl10a,5,8,229,242,-3
Mapk14,4,7,231,242,-3
Mapk1ip1l,5,8,229,242,-3
Psg27,0,3,239,242,-3
Trgc1,7,10,225,242,-3
Rpap3,3,6,233,242,-3
Psip1,3,6,233,242,-3
Rpa3,5,8,229,242,-3
Chmp7,3,6,233,242,-3
Psma3,4,7,231,242,-3
Tlk1,5,8,229,242,-3
Olfr1173,3,6,233,242,-3
Haus7,4,7,231,242,-3
Gm32742,0,3,239,242,-3
Tkt,3,6,233,242,-3
Tspan14,4,7,231,242,-3
H2bc23,25,28,189,242,-3
Aatk,4,7,231,242,-3
Cherp,3,6,233,242,-3
Fthl17e,8,11,223,242,-3
Uchl1,5,8,229,242,-3
Ebf3,0,3,239,242,-3
Ebna1bp2,4,7,231,242,-3
Ebpl,1,4,237,242,-3
Wac,3,6,233,242,-3
Slc25a46,2,5,235,242,-3
Olfr152,10,13,219,242,-3
Lypd8,3,6,233,242,-3
Rps20,4,7,231,242,-3
Olfr1508,0,3,239,242,-3
Echs1,6,9,227,242,-3
Olfr1505,1,4,237,242,-3
Vegfd,6,9,227,242,-3
H3c13,20,23,199,242,-3
Cdk15,6,9,227,242,-3
Apbb3,9,12,221,242,-3
Ing1,2,5,235,242,-3
Cops9,5,8,229,242,-3
Cacna1e,1,4,237,242,-3
Trbv2,6,9,227,242,-3
Setbp1,2,5,235,242,-3
Lysmd3,5,8,229,242,-3
H3c6,15,18,209,242,-3
Zfp384,5,8,229,242,-3
H3f3a,4,7,231,242,-3
Rps29,11,14,217,242,-3
Ear10,4,7,231,242,-3
Tmem14a,7,10,225,242,-3
Rps6,4,7,231,242,-3
Dyrk3,9,12,221,242,-3
H2al1g,4,7,231,242,-3
Chd5,1,4,237,242,-3
Slc26a10,7,10,225,242,-3
Chd7,4,7,231,242,-3
Dzip3,4,7,231,242,-3
Lxn,6,9,227,242,-3
Cox10,3,6,233,242,-3
H2al3,5,8,229,242,-3
Coro7,3,6,233,242,-3
Aamp,2,5,235,242,-3
Ino80d,3,6,233,242,-3
Zfp428,3,6,233,242,-3
Slc26a1,5,8,229,242,-3
Apex2,4,7,231,242,-3
Zfp420,7,10,225,242,-3
Coq7,3,6,233,242,-3
Vwf,1,4,237,242,-3
Api5,2,5,235,242,-3
mt-Nd2,13,16,213,242,-3
Serpini2,2,5,235,242,-3
Fubp3,3,6,233,242,-3
Sertad2,3,6,233,242,-3
E330034G19Rik,5,8,229,242,-3
E4f1,3,6,233,242,-3
Ccrl2,7,10,225,242,-3
Eaf2,2,5,235,242,-3
Inhbe,2,5,235,242,-3
Cops6,3,6,233,242,-3
Olfr147,1,4,237,242,-3
Tarbp1,0,3,239,242,-3
Ap5s1,4,7,231,242,-3
Setd2,5,8,229,242,-3
Slc25a30,6,9,227,242,-3
Vipas39,3,6,233,242,-3
Mafa,4,7,231,242,-3
C8a,2,5,235,242,-3
Trdj2,0,3,239,242,-3
Slc25a24,3,6,233,242,-3
Mafb,8,11,223,242,-3
C6,3,6,233,242,-3
Imp4,2,5,235,242,-3
Gm3286,0,3,239,242,-3
Olfr1380,2,5,235,242,-3
Hars2,3,6,233,242,-3
C5ar2,9,12,221,242,-3
Fsd2,1,4,237,242,-3
Fsd1l,3,6,233,242,-3
Abcd3,5,8,229,242,-3
Eftud2,5,8,229,242,-3
Fsd1,2,5,235,242,-3
Sez6l2,3,6,233,242,-3
Egfem1,4,7,231,242,-3
Gm14412,11,14,217,242,-3
Egln2,2,5,235,242,-3
Olfr1358,3,6,233,242,-3
Sf3a1,2,5,235,242,-3
Fryl,3,6,233,242,-3
Gm14418,8,11,223,242,-3
Olfr1351,0,3,239,242,-3
Ehbp1l1,2,5,235,242,-3
Rpl9,4,7,231,242,-3
Vim,8,11,223,242,-3
Abcc10,2,5,235,242,-3
Olfr1432,2,5,235,242,-3
Cabp7,2,5,235,242,-3
Olfr1459,2,5,235,242,-3
Tank,5,8,229,242,-3
Edrf1,2,5,235,242,-3
Tmem129,2,5,235,242,-3
Copb1,2,5,235,242,-3
Rpp21,5,8,229,242,-3
Eef1b2,4,7,231,242,-3
Vgll2,1,4,237,242,-3
Eef1g,4,7,231,242,-3
Eef2,4,7,231,242,-3
Olfr1437,0,3,239,242,-3
Tmem120b,7,10,225,242,-3
Eepd1,4,7,231,242,-3
Tap2,9,12,221,242,-3
Rpn1,3,6,233,242,-3
Tmem108,4,7,231,242,-3
Macir,3,6,233,242,-3
Slc25a38,4,7,231,242,-3
Maco1,2,5,235,242,-3
Hace1,3,6,233,242,-3
Tmem106a,3,6,233,242,-3
Hacl1,4,7,231,242,-3
Impg1,0,3,239,242,-3
Taok1,5,8,229,242,-3
Setd1b,2,5,235,242,-3
Mad2l1,5,8,229,242,-3
Slc25a33,5,8,229,242,-3
Btnl6,3,6,233,242,-3
C1qtnf3,5,8,229,242,-3
Serpini1,3,6,233,242,-3
Psmb3,4,7,231,242,-3
Il12rb1,8,11,223,242,-3
Pstpip1,4,7,231,242,-3
Cd2ap,7,10,225,242,-3
Mcm3,2,5,235,242,-3
Cnot11,4,7,231,242,-3
Olfr1051,0,3,239,242,-3
Pstk,5,8,229,242,-3
Cd247,11,14,217,242,-3
Acd,2,5,235,242,-3
Trim23,2,5,235,242,-3
Tsks,6,9,227,242,-3
Psmb4,3,6,233,242,-3
Mdm4,4,7,231,242,-3
Rnf222,4,7,231,242,-3
Timm13,3,6,233,242,-3
Focad,3,6,233,242,-3
Fnip2,2,5,235,242,-3
Rnf216,3,6,233,242,-3
Enoph1,3,6,233,242,-3
Me3,2,5,235,242,-3
Hk3,9,12,221,242,-3
Mbd6,5,8,229,242,-3
Zfp217,3,6,233,242,-3
Chp2,4,7,231,242,-3
Wdr3,4,7,231,242,-3
Babam2,2,5,235,242,-3
Mea1,3,6,233,242,-3
Psmc3,2,5,235,242,-3
Btg4,7,10,225,242,-3
Olfm1,3,6,233,242,-3
Pstpip2,4,7,231,242,-3
Zfp263,2,5,235,242,-3
Mbnl3,4,7,231,242,-3
Mdh2,3,6,233,242,-3
Wdr59,2,5,235,242,-3
Acbd3,2,5,235,242,-3
Rnf34,6,9,227,242,-3
Mccc1,8,11,223,242,-3
Fndc1,1,4,237,242,-3
Mcts1,8,11,223,242,-3
Timd2,3,6,233,242,-3
Fndc10,5,8,229,242,-3
Hint3,4,7,231,242,-3
Rnf24,2,5,235,242,-3
Bag1,2,5,235,242,-3
Cnot6,5,8,229,242,-3
Olfr101,2,5,235,242,-3
Epb41,2,5,235,242,-3
Mcm2,3,6,233,242,-3
Rnf5,2,5,235,242,-3
Slc16a3,7,10,225,242,-3
Mcrip2,3,6,233,242,-3
Zfp180,2,5,235,242,-3
Entpd7,4,7,231,242,-3
Igsf8,2,5,235,242,-3
Ociad1,2,5,235,242,-3
Folr2,15,18,209,242,-3
Tshr,1,4,237,242,-3
Psmb6,3,6,233,242,-3
Timm44,2,5,235,242,-3
Hmgb4,4,7,231,242,-3
Wdr45,5,8,229,242,-3
Ik,3,6,233,242,-3
Rnft2,3,6,233,242,-3
Abraxas2,2,5,235,242,-3
Olfr1065,1,4,237,242,-3
Cnot8,2,5,235,242,-3
Mcts2,5,8,229,242,-3
Gm28043,4,7,231,242,-3
Mcph1,1,4,237,242,-3
Rnf31,3,6,233,242,-3
Ikzf1,6,9,227,242,-3
Sfswap,3,6,233,242,-3
Ogfod3,4,7,231,242,-3
Slc10a3,3,6,233,242,-3
Chn2,4,7,231,242,-3
Gm28870,2,5,235,242,-3
Abr,4,7,231,242,-3
Ogfod1,2,5,235,242,-3
Il16,9,12,221,242,-3
Psmd1,5,8,229,242,-3
Hk2,3,6,233,242,-3
Hmgn5,7,10,225,242,-3
Psmb1,4,7,231,242,-3
Olfr1087,1,4,237,242,-3
Slc17a8,3,6,233,242,-3
Uba6,4,7,231,242,-3
Hhipl1,1,4,237,242,-3
Ogt,7,10,225,242,-3
Vmn1r4,3,6,233,242,-3
Mcoln1,2,5,235,242,-3
Cntnap5a,1,4,237,242,-3
Acadm,7,10,225,242,-3
Rnf212b,4,7,231,242,-3
Cnnm3,2,5,235,242,-3
Banf2,5,8,229,242,-3
Acadsb,6,9,227,242,-3
Gm28360,1,4,237,242,-3
Rnf214,4,7,231,242,-3
Utp3,2,6,234,242,-4
Sptlc2,2,6,234,242,-4
Zfp626,3,7,232,242,-4
Ptov1,3,7,232,242,-4
Ugt1a7c,9,13,220,242,-4
Uck2,3,7,232,242,-4
Poc5,2,6,234,242,-4
Rbm31y,0,4,238,242,-4
Scp2,3,7,232,242,-4
Pnpla3,3,7,232,242,-4
Yrdc,4,8,230,242,-4
Smdt1,4,8,230,242,-4
Trappc11,2,6,234,242,-4
Wasf2,3,7,232,242,-4
Smim15,6,10,226,242,-4
Taf7,2,6,234,242,-4
Txlng,5,9,228,242,-4
Rnf26,3,7,232,242,-4
Smim22,13,17,212,242,-4
Vezt,2,6,234,242,-4
Ssr1,4,8,230,242,-4
Snupn,5,9,228,242,-4
Poc1a,2,6,234,242,-4
Tomm40,4,8,230,242,-4
Zfp202,0,4,238,242,-4
Yju2,4,8,230,242,-4
Polr3c,2,6,234,242,-4
Vmn2r100,3,7,232,242,-4
Vps13a,3,7,232,242,-4
Vasn,5,9,228,242,-4
Sec23ip,4,8,230,242,-4
Smad5,2,6,234,242,-4
Trbv3,11,15,216,242,-4
Tufm,3,7,232,242,-4
Tmem127,2,6,234,242,-4
Rbm39,4,8,230,242,-4
Spin4,5,9,228,242,-4
Rtkn2,1,5,236,242,-4
Znhit1,3,7,232,242,-4
Slc2a4,10,14,218,242,-4
Snx12,6,10,226,242,-4
Spata16,2,6,234,242,-4
Znfx1,2,6,234,242,-4
Ss18,5,9,228,242,-4
Smg8,2,6,234,242,-4
Tmem126a,4,8,230,242,-4
Smad9,1,5,236,242,-4
Prss38,2,6,234,242,-4
Skint9,1,5,236,242,-4
Rsph10b,3,7,232,242,-4
Ttc28,2,6,234,242,-4
Tes3-ps,6,10,226,242,-4
Ubn2,4,8,230,242,-4
Szrd1,2,6,234,242,-4
Son,3,7,232,242,-4
Tubgcp3,4,8,230,242,-4
Sptan1,4,8,230,242,-4
Trim12c,6,10,226,242,-4
Rhbdl3,1,5,236,242,-4
Tnfsfm13,6,10,226,242,-4
Vmn1r197,2,6,234,242,-4
Prss36,4,8,230,242,-4
Zfhx2,2,6,234,242,-4
Rbm11,5,9,228,242,-4
Xab2,2,6,234,242,-4
Psmd5,4,8,230,242,-4
Rbbp5,4,8,230,242,-4
Sox17,4,8,230,242,-4
Shf,3,7,232,242,-4
Poln,1,5,236,242,-4
Sh2d1b2,4,8,230,242,-4
Psmd6,2,6,234,242,-4
Vmn1r227,3,7,232,242,-4
Rbbp6,3,7,232,242,-4
Stx19,2,6,234,242,-4
Tcaf1,4,8,230,242,-4
Smarcd2,2,6,234,242,-4
Stard13,4,8,230,242,-4
Vstm4,3,7,232,242,-4
Slc30a5,2,6,234,242,-4
Tmed4,3,7,232,242,-4
Rsrc2,6,10,226,242,-4
Rbbp8,5,9,228,242,-4
Tmed3,4,8,230,242,-4
Polr1e,4,8,230,242,-4
Tomm34,2,6,234,242,-4
Swap70,2,6,234,242,-4
Polr2i,5,9,228,242,-4
Psme2b,22,26,194,242,-4
Tekt1,2,6,234,242,-4
Tmem120a,3,7,232,242,-4
Tnks1bp1,3,7,232,242,-4
Rbbp9,5,9,228,242,-4
Snta1,2,6,234,242,-4
Vmn1r198,1,5,236,242,-4
Tmed10,2,6,234,242,-4
Psme3,2,6,234,242,-4
Smchd1,4,8,230,242,-4
Trcg1,0,4,238,242,-4
Vmn2r116,0,4,238,242,-4
Sh2d4a,8,12,222,242,-4
Telo2,2,6,234,242,-4
Rnf144b,0,4,238,242,-4
Smc3,2,6,234,242,-4
Prpf40a,2,6,234,242,-4
Rbm22,2,6,234,242,-4
Shcbp1l,6,10,226,242,-4
Tcaim,3,7,232,242,-4
Vmn1r44,2,6,234,242,-4
Vmn1r193,0,4,238,242,-4
Pole4,2,6,234,242,-4
Rsph3b,3,7,232,242,-4
Trappc2l,2,6,234,242,-4
Timm10b,2,6,234,242,-4
Vmn1r226,0,4,238,242,-4
Slc25a31,6,10,226,242,-4
Rgsl1,1,5,236,242,-4
Uba1y,0,4,238,242,-4
Polr2a,3,7,232,242,-4
Slc14a2,6,10,226,242,-4
Tdrd12,4,8,230,242,-4
Setd1a,3,7,232,242,-4
Toe1,2,6,234,242,-4
Retreg1,4,8,230,242,-4
Rchy1,2,6,234,242,-4
St8sia3,0,4,238,242,-4
Zfp120,5,9,228,242,-4
Retnla,14,18,210,242,-4
Xlr5a,8,12,222,242,-4
Rdh1,3,7,232,242,-4
Snf8,2,6,234,242,-4
Prr23a1,10,14,218,242,-4
Rps5,4,8,230,242,-4
Uchl3,6,10,226,242,-4
Vcp,2,6,234,242,-4
Rrm1,2,6,234,242,-4
Sap30,3,7,232,242,-4
Sdhc,3,7,232,242,-4
Samt1d,2,6,234,242,-4
Slc25a53,2,6,234,242,-4
Prkar1a,3,7,232,242,-4
Tvp23a,1,5,236,242,-4
Samd8,3,7,232,242,-4
Vmn1r76,2,6,234,242,-4
Rfc1,2,6,234,242,-4
Thsd7a,2,6,234,242,-4
Thumpd1,4,8,230,242,-4
Twf2,4,8,230,242,-4
Tcp11x2,0,4,238,242,-4
Rcbtb2,4,8,230,242,-4
Ptgdr,0,4,238,242,-4
Samd9l,6,10,226,242,-4
Upf2,2,6,234,242,-4
Xrcc3,1,5,236,242,-4
Ttc22,2,6,234,242,-4
Plscr3,5,9,228,242,-4
Tmem150a,7,11,224,242,-4
Rps3,4,8,230,242,-4
Tal1,2,6,234,242,-4
Tmem165,4,8,230,242,-4
Suv39h1,3,7,232,242,-4
Slc27a1,2,6,234,242,-4
Rps8,4,8,230,242,-4
Suv39h2,2,6,234,242,-4
Vmn2r30,1,5,236,242,-4
Plk5,2,6,234,242,-4
Tcf4,3,7,232,242,-4
Snca,9,13,220,242,-4
Tmem178b,1,5,236,242,-4
Reg3d,1,5,236,242,-4
Thyn1,4,8,230,242,-4
Trnau1ap,3,7,232,242,-4
St6galnac4,4,8,230,242,-4
Trmt61a,2,6,234,242,-4
Sap130,2,6,234,242,-4
Sec11a,4,8,230,242,-4
Tia1,2,6,234,242,-4
Sec11c,2,6,234,242,-4
Snapc2,2,6,234,242,-4
Rps6kb1,3,7,232,242,-4
Zfp444,5,9,228,242,-4
Suz12,2,6,234,242,-4
Vwa5b2,3,7,232,242,-4
Slc10a4-ps,4,8,230,242,-4
Vwa3a,5,9,228,242,-4
Zfp668,2,6,234,242,-4
Upp1,5,9,228,242,-4
Ube2l3,4,8,230,242,-4
Resp18,12,16,214,242,-4
Speg,9,13,220,242,-4
Ube2i,3,7,232,242,-4
Plp1,3,7,232,242,-4
Vmn2r107,0,4,238,242,-4
Ttc1,4,8,230,242,-4
Tmem175,3,7,232,242,-4
Plod3,3,7,232,242,-4
Tns1,4,8,230,242,-4
Vwa5b1,1,5,236,242,-4
Zfp459,3,7,232,242,-4
Rfc2,3,7,232,242,-4
Thoc1,4,8,230,242,-4
Zfp385a,4,8,230,242,-4
Vstm5,6,10,226,242,-4
Ttbk2,2,6,234,242,-4
Vsig8,1,5,236,242,-4
Samd11,5,9,228,242,-4
Rgl2,3,7,232,242,-4
Vmn1r203,1,5,236,242,-4
Tagln2,5,9,228,242,-4
Trmt10c,3,7,232,242,-4
Sfxn1,3,7,232,242,-4
Prps1l3,3,7,232,242,-4
Trmt1l,4,8,230,242,-4
Pmpcb,3,7,232,242,-4
Ube2t,6,10,226,242,-4
Tusc1,3,7,232,242,-4
Rsad1,2,6,234,242,-4
Susd4,4,8,230,242,-4
Sec23a,2,6,234,242,-4
Tdrd5,3,7,232,242,-4
Slc25a48,4,8,230,242,-4
Yeats2,3,7,232,242,-4
Slc5a12,3,7,232,242,-4
Rsf1,3,7,232,242,-4
Trip10,2,6,234,242,-4
Prima1,9,13,220,242,-4
Scpep1,2,6,234,242,-4
Sult2a3,1,5,236,242,-4
Slc25a40,4,8,230,242,-4
Tmem205,8,12,222,242,-4
Pnisr,4,8,230,242,-4
Scrn2,5,9,228,242,-4
Trip4,2,6,234,242,-4
Vmn2r26,1,5,236,242,-4
Smim43,0,4,238,242,-4
Rgma,3,7,232,242,-4
Snrpe,4,8,230,242,-4
Tsen34,3,7,232,242,-4
Ube2q2,4,8,230,242,-4
Spata31d1b,0,4,238,242,-4
Zfp652,2,6,234,242,-4
Rbpms2,7,11,224,242,-4
Vmn1r207,2,6,234,242,-4
Prr12,3,7,232,242,-4
Rfk,4,8,230,242,-4
Plxnb2,2,6,234,242,-4
Vps25,3,7,232,242,-4
Smok2b,0,4,238,242,-4
Ssu72,3,7,232,242,-4
Smok3a,1,5,236,242,-4
Rfx6,1,5,236,242,-4
Zfp398,2,6,234,242,-4
Txnl1,5,9,228,242,-4
Spg11,2,6,234,242,-4
Tdg,4,8,230,242,-4
Plxna2,4,8,230,242,-4
Serpina3a,6,10,226,242,-4
Spertl,1,5,236,242,-4
Slc50a1,5,9,228,242,-4
Zfp68,5,9,228,242,-4
Sphkap,3,7,232,242,-4
Samd14,2,6,234,242,-4
Smlr1,8,12,222,242,-4
Smn1,7,11,224,242,-4
Rnf180,1,5,236,242,-4
Rftn2,4,8,230,242,-4
Ube2q1,2,6,234,242,-4
Pmm1,2,6,234,242,-4
Slc25a42,2,6,234,242,-4
Sh3rf2,0,4,238,242,-4
Rrp9,2,6,234,242,-4
Vmn1r39,8,12,222,242,-4
Zfp397,4,8,230,242,-4
Zfp697,6,10,226,242,-4
Tmem200c,2,6,234,242,-4
Rps24,5,9,228,242,-4
Zrsr2,6,10,226,242,-4
Smad1,3,7,232,242,-4
Tbc1d20,4,8,230,242,-4
Polr3h,2,6,234,242,-4
Tbx4,1,5,236,242,-4
S1pr5,0,4,238,242,-4
Tlr3,12,16,214,242,-4
Rab3ip,2,6,234,242,-4
Zfp874a,6,10,226,242,-4
Ubiad1,2,6,234,242,-4
Stmn3,4,8,230,242,-4
Prodh,7,11,224,242,-4
Rimkla,1,5,236,242,-4
Rpl13a,4,8,230,242,-4
Zbtb46,3,7,232,242,-4
Ubr5,3,7,232,242,-4
V1ra8,1,5,236,242,-4
Tmem9,3,7,232,242,-4
Zfp871,4,8,230,242,-4
Ttc39b,2,6,234,242,-4
Zfp993,9,13,220,242,-4
Rwdd2b,3,7,232,242,-4
Slc43a2,4,8,230,242,-4
Tbccd1,4,8,230,242,-4
Tada3,3,7,232,242,-4
Tfb1m,6,10,226,242,-4
Scaf4,2,6,234,242,-4
Tsnax,3,7,232,242,-4
Tsr1,2,6,234,242,-4
Tlr11,0,4,238,242,-4
Zfp975,9,13,220,242,-4
Rmnd5b,2,6,234,242,-4
Rxrg,1,5,236,242,-4
Tmod4,7,11,224,242,-4
Trav6-7-dv9,5,9,228,242,-4
Zfp619,2,6,234,242,-4
Rpl10-ps3,18,22,202,242,-4
Zdhhc17,3,7,232,242,-4
Tmod2,3,7,232,242,-4
Tpd52l2,3,7,232,242,-4
Usp22,5,9,228,242,-4
Srp14,2,6,234,242,-4
Slc9a8,2,6,234,242,-4
Tlr5,0,4,238,242,-4
Vmn2r121,0,4,238,242,-4
Ppp1r13l,6,10,226,242,-4
Unc119b,3,7,232,242,-4
Rnft1,4,8,230,242,-4
Ric8a,2,6,234,242,-4
Sik2,2,6,234,242,-4
Rpl26,5,9,228,242,-4
Tmem68,4,8,230,242,-4
Rabac1,4,8,230,242,-4
Taz,5,9,228,242,-4
Sil1,4,8,230,242,-4
Psen1,3,7,232,242,-4
Tmem67,4,8,230,242,-4
Thada,2,6,234,242,-4
Suox,3,7,232,242,-4
Tpra1,5,9,228,242,-4
Pvrig,7,11,224,242,-4
Tm4sf20,3,7,232,242,-4
Synj2bp,4,8,230,242,-4
Zfp26,4,8,230,242,-4
Tpm2,5,9,228,242,-4
Snx33,5,9,228,242,-4
Tpm3,2,6,234,242,-4
Timp4,0,4,238,242,-4
Serac1,2,6,234,242,-4
Vmn2r73,0,4,238,242,-4
Wmp,0,4,238,242,-4
Tbce,4,8,230,242,-4
Vmn1r175,3,7,232,242,-4
Tbc1d10b,2,6,234,242,-4
Tomm7,3,7,232,242,-4
Synpo,2,6,234,242,-4
Wdr43,3,7,232,242,-4
Rab6b,2,6,234,242,-4
Rpl23,3,7,232,242,-4
Wfdc15a,14,18,210,242,-4
Rif1,5,9,228,242,-4
Th,3,7,232,242,-4
Sirpa,4,8,230,242,-4
Rab28,3,7,232,242,-4
Pramel33,4,8,230,242,-4
Qsox2,2,6,234,242,-4
Slc17a7,0,4,238,242,-4
Vmn2r13,0,4,238,242,-4
S100a4,19,23,200,242,-4
Slc19a1,3,7,232,242,-4
Wdr18,2,6,234,242,-4
Vmn1r83,3,7,232,242,-4
Sprr2i,1,5,236,242,-4
Ttll10,3,7,232,242,-4
Qrich1,2,6,234,242,-4
Zfp957,1,5,236,242,-4
Wdr12,4,8,230,242,-4
Zc3hc1,3,7,232,242,-4
Slc7a10,5,9,228,242,-4
Tlcd5,7,11,224,242,-4
Trav13-4-dv7,11,15,216,242,-4
Zfp944,4,8,230,242,-4
Zcchc10,5,9,228,242,-4
Six4,1,5,236,242,-4
S100a16,5,9,228,242,-4
Ulk4,3,7,232,242,-4
Scand1,4,8,230,242,-4
Prl7c1,0,4,238,242,-4
Tgm1,7,11,224,242,-4
Rmc1,4,8,230,242,-4
Srfbp1,3,7,232,242,-4
Tjp2,3,7,232,242,-4
Tor1b,3,7,232,242,-4
Qrfp,2,6,234,242,-4
Prl8a6,0,4,238,242,-4
Suco,4,8,230,242,-4
Tmx2,4,8,230,242,-4
Tti2,2,6,234,242,-4
Zfp946,5,9,228,242,-4
Zfp953,3,7,232,242,-4
Qrfpr,1,5,236,242,-4
Rlim,2,6,234,242,-4
Slc7a7,4,8,230,242,-4
Tjap1,2,6,234,242,-4
Trpv4,3,7,232,242,-4
Tnfaip2,13,17,212,242,-4
Septin8,3,7,232,242,-4
Ppp2r2d,3,7,232,242,-4
Tnfaip1,3,7,232,242,-4
Tbc1d4,7,11,224,242,-4
Trav7-2,4,8,230,242,-4
Rab1b,2,6,234,242,-4
Zfp91,4,8,230,242,-4
Tbc1d8b,4,8,230,242,-4
Rp9,4,8,230,242,-4
Riok1,2,6,234,242,-4
Rab22a,4,8,230,242,-4
Usp34,4,8,230,242,-4
Vps52,2,6,234,242,-4
Ppp1r42,13,17,212,242,-4
Ring1,2,6,234,242,-4
Tbc1d14,2,6,234,242,-4
Zc3h12b,2,6,234,242,-4
Prmt1,5,9,228,242,-4
Zcchc2,8,12,222,242,-4
Stfa3,7,11,224,242,-4
R3hdm1,5,9,228,242,-4
R3hdm4,4,8,230,242,-4
Tbc1d22b,2,6,234,242,-4
Vmn2r95,0,4,238,242,-4
Ppp3r2,0,4,238,242,-4
Tmx3,6,10,226,242,-4
Tgfb3,5,9,228,242,-4
Ppp3cc,5,9,228,242,-4
Trim42,0,4,238,242,-4
Uts2b,7,11,224,242,-4
Tyrobp,10,14,218,242,-4
Rab11fip5,2,6,234,242,-4
Ros1,2,6,234,242,-4
Rp1,0,4,238,242,-4
Srek1,3,7,232,242,-4
Zfp93,4,8,230,242,-4
Wnt10b,2,6,234,242,-4
Ttll8,3,7,232,242,-4
Rabgef1,2,6,234,242,-4
Ptprt,0,4,238,242,-4
Spag7,3,7,232,242,-4
Vkorc1,4,8,230,242,-4
Tmcc2,1,5,236,242,-4
Psmb9,9,13,220,242,-4
Pou4f2,1,5,236,242,-4
Pou4f1,0,4,238,242,-4
Slc35b3,4,8,230,242,-4
Wdr92,2,6,234,242,-4
Rpl5,3,7,232,242,-4
Uba2,2,6,234,242,-4
Wrap73,3,7,232,242,-4
Zkscan1,2,6,234,242,-4
Zbed3,3,7,232,242,-4
Ush1g,1,5,236,242,-4
Stard9,0,4,238,242,-4
Snx19,2,6,234,242,-4
Sgsm3,5,9,228,242,-4
Taf4,2,6,234,242,-4
Tet2,5,9,228,242,-4
Tarbp2,3,7,232,242,-4
Rnf113a1,5,9,228,242,-4
Wdr93,1,5,236,242,-4
Tmem35b,2,6,234,242,-4
Rangrf,12,16,214,242,-4
Scgb2b19,1,5,236,242,-4
Trdv2-1,5,9,228,242,-4
Txndc15,4,8,230,242,-4
Vmn1r46,1,5,236,242,-4
Zdhhc6,3,7,232,242,-4
Rap1gap,2,6,234,242,-4
Trpc4ap,3,7,232,242,-4
Rap1gap2,5,9,228,242,-4
Trim11,2,6,234,242,-4
Vmn2r2,0,4,238,242,-4
Stxbp1,2,6,234,242,-4
Prdm11,1,5,236,242,-4
Trp53tg5,4,8,230,242,-4
Thap7,2,6,234,242,-4
Ranbp2,2,6,234,242,-4
Slu7,3,7,232,242,-4
Shisal1,2,6,234,242,-4
Rpl7a,4,8,230,242,-4
Psmd2,2,6,234,242,-4
Vmn2r1,0,4,238,242,-4
Tmem263,4,8,230,242,-4
Scimp,16,20,206,242,-4
Sez6l,0,4,238,242,-4
Zfp735,0,4,238,242,-4
Psmd11,3,7,232,242,-4
Rpl8,4,8,230,242,-4
Slc25a19,4,8,230,242,-4
Slx,1,5,236,242,-4
Tmem259,2,6,234,242,-4
Zmat5,3,7,232,242,-4
Srsy,2,6,234,242,-4
Slc44a5,1,5,236,242,-4
Zfand2b,5,9,228,242,-4
Usf3,4,8,230,242,-4
Wdr91,5,9,228,242,-4
Unc5b,2,6,234,242,-4
Slc35a5,10,14,218,242,-4
Vmn2r55,1,5,236,242,-4
Taf5l,3,7,232,242,-4
Slc5a9,2,6,234,242,-4
Safb,3,7,232,242,-4
Utrn,2,6,234,242,-4
Vmn2r53,3,7,232,242,-4
Psmc4,2,6,234,242,-4
Rasal3,4,8,230,242,-4
Prdm4,2,6,234,242,-4
Pop7,3,7,232,242,-4
Vps29,4,8,230,242,-4
Pop4,2,6,234,242,-4
Shkbp1,2,6,234,242,-4
Trdv1,0,4,238,242,-4
Traf7,2,6,234,242,-4
Trappc9,3,7,232,242,-4
Ube2a,4,8,230,242,-4
Uba3,2,6,234,242,-4
Slfn9,1,5,236,242,-4
Syne3,2,6,234,242,-4
Ptcd3,3,7,232,242,-4
Rad50,2,6,234,242,-4
Vmn1r180,0,4,238,242,-4
Srr,3,7,232,242,-4
Prune1,2,6,234,242,-4
Rad51d,2,6,234,242,-4
Tex36,5,9,228,242,-4
Tsfm,2,6,234,242,-4
Ppm1g,2,6,234,242,-4
Pus10,2,6,234,242,-4
Stk16,2,6,234,242,-4
Zfp281,4,8,230,242,-4
Rufy1,2,6,234,242,-4
Taf1b,3,7,232,242,-4
Ppm1e,1,5,236,242,-4
Tarsl2,3,7,232,242,-4
Rad23b,2,6,234,242,-4
Ubqln5,0,4,238,242,-4
Trav6-4,0,4,238,242,-4
Slc16a12,2,6,234,242,-4
Ttc37,3,7,232,242,-4
Sigmar1,2,6,234,242,-4
Tmem60,4,8,230,242,-4
Trav13d-2,9,13,220,242,-4
Slc22a5,4,8,230,242,-4
Srprb,4,8,230,242,-4
Rpl29,5,9,228,242,-4
Rhpn1,3,7,232,242,-4
Rpl30,6,10,226,242,-4
Wnt3,1,5,236,242,-4
Tm7sf2,4,8,230,242,-4
Tm9sf2,3,7,232,242,-4
Trim6,6,10,226,242,-4
Slc37a4,3,7,232,242,-4
Sell,7,11,224,242,-4
Vangl2,0,4,238,242,-4
Rpl36,4,8,230,242,-4
Tex13c1,0,4,238,242,-4
Pttg1ip,2,6,234,242,-4
Scgb2b12,3,7,232,242,-4
Rnf111,4,8,230,242,-4
Rhox4d,0,4,238,242,-4
Serinc4,8,12,222,242,-4
Slc35f1,4,8,230,242,-4
Spag17,0,4,238,242,-4
Slit2,5,9,228,242,-4
Zgrf1,2,6,234,242,-4
Trabd,2,6,234,242,-4
Selenoi,3,7,232,242,-4
Rpl37a,3,7,232,242,-4
Usp47,2,6,234,242,-4
Wnt9a,2,6,234,242,-4
Rtp3,6,10,226,242,-4
Slitrk2,4,8,230,242,-4
Traf2,2,6,234,242,-4
Zfp292,4,8,230,242,-4
Srrm2,2,6,234,242,-4
Sbno1,2,6,234,242,-4
Spink8,12,16,214,242,-4
Sac3d1,3,7,232,242,-4
Sae1,3,7,232,242,-4
Zg16,19,23,200,242,-4
Ttll9,11,15,216,242,-4
Zfp788,5,9,228,242,-4
Ppil1,2,6,234,242,-4
Tbrg1,2,6,234,242,-4
Ttn,4,8,230,242,-4
Prss52,1,5,236,242,-4
Prss54,1,5,236,242,-4
Tbrg4,3,7,232,242,-4
Raf1,2,6,234,242,-4
Ppig,6,10,226,242,-4
Pum1,4,8,230,242,-4
Pudp,0,4,238,242,-4
Tmbim7,4,8,230,242,-4
Prss45,5,9,228,242,-4
0610009B22Rik,2,6,234,242,-4
Zzz3,3,7,232,242,-4
Amph,0,4,238,242,-4
Gxylt2,1,5,236,242,-4
Angpt4,2,6,234,242,-4
Gucy1a2,4,8,230,242,-4
Cnot1,2,6,234,242,-4
Cnot4,5,9,228,242,-4
Gtpbp6,3,7,232,242,-4
Gtpbp3,3,7,232,242,-4
Amy2a5,4,8,230,242,-4
Gtf2ird2,3,7,232,242,-4
Gzmb,2,6,234,242,-4
Cnot9,2,6,234,242,-4
Gtf2h3,2,6,234,242,-4
Cnpy2,6,10,226,242,-4
Gtf2e1,3,7,232,242,-4
Cnr1,0,4,238,242,-4
Amer2,0,4,238,242,-4
Cntln,3,7,232,242,-4
Ndnf,0,4,238,242,-4
Cnn1,13,17,212,242,-4
Cngb3,0,4,238,242,-4
Amd2,12,16,214,242,-4
Clint1,5,9,228,242,-4
Naaa,7,11,224,242,-4
Clec18a,2,6,234,242,-4
H2bc3,26,30,186,242,-4
Clec4b2,0,4,238,242,-4
Naglu,2,6,234,242,-4
Naip2,3,7,232,242,-4
Clec4g,1,5,236,242,-4
Nanos1,1,5,236,242,-4
Clip1,2,6,234,242,-4
Ankib1,2,6,234,242,-4
Clvs1,4,8,230,242,-4
H2-T3,7,11,224,242,-4
Ankrd13c,3,7,232,242,-4
H2-Q4,4,8,230,242,-4
Cmah,3,7,232,242,-4
H2-Ke6,2,6,234,242,-4
Cmtm6,3,7,232,242,-4
Ankk1,2,6,234,242,-4
Amdhd1,0,4,238,242,-4
Ndst4,1,5,236,242,-4
Naa38,4,8,230,242,-4
Comtd1,4,8,230,242,-4
Col25a1,1,5,236,242,-4
Aldh3b1,2,6,234,242,-4
Col26a1,2,6,234,242,-4
Col6a1,5,9,228,242,-4
Commd2,2,6,234,242,-4
Commd7,2,6,234,242,-4
Comp,6,10,226,242,-4
Akr7a5,2,6,234,242,-4
Akr1e1,5,9,228,242,-4
Necab2,7,11,224,242,-4
Copb2,3,7,232,242,-4
Nelfcd,2,6,234,242,-4
Cops2,3,7,232,242,-4
Akap5,0,4,238,242,-4
Akap3,0,4,238,242,-4
Cops8,3,7,232,242,-4
Coq2,3,7,232,242,-4
Akap10,2,6,234,242,-4
Grcc10,7,11,224,242,-4
Necab1,3,7,232,242,-4
Alyref,2,6,234,242,-4
Col12a1,2,6,234,242,-4
Gss,2,6,234,242,-4
Gsdme,2,6,234,242,-4
Gsdmc3,4,8,230,242,-4
Alppl2,0,4,238,242,-4
Ndufaf4,5,9,228,242,-4
Alox5,0,4,238,242,-4
Alg9,2,6,234,242,-4
Gsdma,0,4,238,242,-4
Alg12,4,8,230,242,-4
Greb1l,2,6,234,242,-4
Gripap1,2,6,234,242,-4
Aldoart2,0,4,238,242,-4
Grina,2,6,234,242,-4
Ndufs2,3,7,232,242,-4
Col1a2,2,6,234,242,-4
Aldoart1,0,4,238,242,-4
Ndufs6,3,7,232,242,-4
Ndufv2,3,7,232,242,-4
Cldn9,12,16,214,242,-4
Hand1,2,6,234,242,-4
Mrtfa,2,6,234,242,-4
Aplf,2,6,234,242,-4
Chgb,4,8,230,242,-4
Mta1,2,6,234,242,-4
Apol10a,2,6,234,242,-4
Mtcp1,9,13,220,242,-4
Hook3,3,7,232,242,-4
Apof,11,15,216,242,-4
Apobec2,6,10,226,242,-4
Apobec1,6,10,226,242,-4
Chml,1,5,236,242,-4
Hps5,3,7,232,242,-4
Hnrnpdl,2,6,234,242,-4
Apbb1,5,9,228,242,-4
Chmp1a,3,7,232,242,-4
Mthfd1,2,6,234,242,-4
Hmgxb3,3,7,232,242,-4
Mtif2,3,7,232,242,-4
Mtln,3,7,232,242,-4
Mtmr11,3,7,232,242,-4
Chd4,2,6,234,242,-4
Chd3,2,6,234,242,-4
Chpt1,4,8,230,242,-4
Hspb3,7,11,224,242,-4
Hyal5,2,6,234,242,-4
Cfap54,3,7,232,242,-4
Ms4a3,4,8,230,242,-4
Arg1,6,10,226,242,-4
Hspbap1,4,8,230,242,-4
Arfgap3,4,8,230,242,-4
Cfap61,7,11,224,242,-4
Ms4a8a,1,5,236,242,-4
Msh2,4,8,230,242,-4
Hpse,2,6,234,242,-4
Hsd17b10,6,10,226,242,-4
Cfhr4,0,4,238,242,-4
Arf2,2,6,234,242,-4
Msmp,9,13,220,242,-4
Msrb1,6,10,226,242,-4
Hs3st2,1,5,236,242,-4
Cggbp1,3,7,232,242,-4
Hpse2,0,4,238,242,-4
Ap1m2,3,7,232,242,-4
Mtmr4,2,6,234,242,-4
Ankrd45,7,11,224,242,-4
Myo6,5,9,228,242,-4
Hdac2,2,6,234,242,-4
Myh7b,1,5,236,242,-4
Hcst,28,32,182,242,-4
Ckap4,2,6,234,242,-4
Mylk3,8,12,222,242,-4
Hcfc2,4,8,230,242,-4
Hcar2,7,11,224,242,-4
Anks3,3,7,232,242,-4
Ckmt2,2,6,234,242,-4
Hecw1,3,7,232,242,-4
Clasp2,2,6,234,242,-4
Haus4,3,7,232,242,-4
Clcc1,2,6,234,242,-4
Clcn2,2,6,234,242,-4
Hapln2,3,7,232,242,-4
N4bp2,2,6,234,242,-4
Ankrd46,3,7,232,242,-4
Hand2,1,5,236,242,-4
Cir1,2,6,234,242,-4
Ankzf1,2,6,234,242,-4
Hmgb3,5,9,228,242,-4
Muc3,3,7,232,242,-4
Hmg20a,4,8,230,242,-4
Hmcn2,0,4,238,242,-4
Antxr2,1,5,236,242,-4
Hmbs,4,8,230,242,-4
Hmbox1,2,6,234,242,-4
Mtor,2,6,234,242,-4
Mtrex,2,6,234,242,-4
Hint1,2,6,234,242,-4
Muc5ac,0,4,238,242,-4
Hepacam,0,4,238,242,-4
Chtf18,5,9,228,242,-4
Hhla1,3,7,232,242,-4
Mup21,3,7,232,242,-4
Chuk,4,8,230,242,-4
Mus81,2,6,234,242,-4
Churc1,8,12,222,242,-4
Mvk,3,7,232,242,-4
Hephl1,1,5,236,242,-4
Neurl4,3,7,232,242,-4
Coq3,2,6,234,242,-4
Gpr15,1,5,236,242,-4
Adam25,0,4,238,242,-4
Cyyr1,2,6,234,242,-4
Nsf,5,9,228,242,-4
Nsg1,5,9,228,242,-4
D5Ertd579e,2,6,234,242,-4
Nsl1,1,5,236,242,-4
D8Ertd738e,3,7,232,242,-4
Adam28,2,6,234,242,-4
Gm6465,2,6,234,242,-4
Nsun6,2,6,234,242,-4
Cypt15,0,4,238,242,-4
Gm6358,1,5,236,242,-4
Nt5c,2,6,234,242,-4
Daxx,2,6,234,242,-4
Gm609,0,4,238,242,-4
Nt5dc2,4,8,230,242,-4
Gm5930,4,8,230,242,-4
Ntn3,2,6,234,242,-4
Gm5890,0,4,238,242,-4
Gm6657,8,12,222,242,-4
Nrip1,3,7,232,242,-4
Gm5796,15,19,208,242,-4
Nrap,0,4,238,242,-4
Gm8113,6,10,226,242,-4
Add2,1,5,236,242,-4
Add1,5,9,228,242,-4
Nr1i2,2,6,234,242,-4
Cyb5d2,3,7,232,242,-4
Cyfip1,5,9,228,242,-4
Cyhr1,2,6,234,242,-4
Cyp1a1,5,9,228,242,-4
Cyp1a2,1,5,236,242,-4
Cyp8b1,2,6,234,242,-4
Cyp2u1,2,6,234,242,-4
Gm7489,1,5,236,242,-4
Gm7356,2,6,234,242,-4
Gm7247,8,12,222,242,-4
Adamts17,5,9,228,242,-4
Adam6a,0,4,238,242,-4
Cyp3a25,2,6,234,242,-4
Cyp4f13,6,10,226,242,-4
Dcaf7,2,6,234,242,-4
Dclk3,2,6,234,242,-4
Coro2b,12,16,214,242,-4
Dennd5a,2,6,234,242,-4
Nxpe5,1,5,236,242,-4
Gm49384,21,25,196,242,-4
Gm49380,13,17,212,242,-4
Oaz2,2,6,234,242,-4
Defb20,6,10,226,242,-4
Gm49353,11,15,216,242,-4
Gm49336,2,6,234,242,-4
Gm4791,10,14,218,242,-4
Gm45844,4,8,230,242,-4
Actr1a,2,6,234,242,-4
Ogdh,2,6,234,242,-4
Aco1,5,9,228,242,-4
Dgat1,3,7,232,242,-4
Gm4513,2,6,234,242,-4
Dgka,3,7,232,242,-4
Dgkd,3,7,232,242,-4
Gm4491,1,5,236,242,-4
Ola1,4,8,230,242,-4
Nvl,2,6,234,242,-4
Gm50478,18,22,202,242,-4
Adam18,2,6,234,242,-4
Nudt17,6,10,226,242,-4
Adam15,3,7,232,242,-4
Nubp2,3,7,232,242,-4
Dcpp2,4,8,230,242,-4
Gm5678,7,11,224,242,-4
Gm5624,5,9,228,242,-4
Nudcd2,3,7,232,242,-4
Nudt14,6,10,226,242,-4
Gm5565,5,9,228,242,-4
Ada,6,10,226,242,-4
Ddx54,3,7,232,242,-4
Nudt5,4,8,230,242,-4
Gm5475,1,5,236,242,-4
Gm53046,2,6,234,242,-4
Nufip1,2,6,234,242,-4
Gm5244,16,20,206,242,-4
Gm5150,10,14,218,242,-4
Nup50,2,6,234,242,-4
Ddx52,2,6,234,242,-4
Npvf,2,6,234,242,-4
Cul4a,3,7,232,242,-4
Adgre1,5,9,228,242,-4
Creld2,4,8,230,242,-4
Gpa33,4,8,230,242,-4
Gorasp1,2,6,234,242,-4
Golgb1,2,6,234,242,-4
Golga5,2,6,234,242,-4
Golga3,3,7,232,242,-4
Crbn,5,9,228,242,-4
Gnl3,2,6,234,242,-4
Gnl2,2,6,234,242,-4
Gng2,4,8,230,242,-4
Cpsf4,3,7,232,242,-4
Crisp2,2,6,234,242,-4
Crispld1,2,6,234,242,-4
Crocc,3,7,232,242,-4
Ago1,2,6,234,242,-4
Gnao1,4,8,230,242,-4
Crtc2,2,6,234,242,-4
Nlrc4,2,6,234,242,-4
Gnai2,6,10,226,242,-4
Gpam,4,8,230,242,-4
Agtr1b,3,7,232,242,-4
Cul3,4,8,230,242,-4
Gpr108,3,7,232,242,-4
AK157302,7,11,224,242,-4
Neurog1,0,4,238,242,-4
Cox14,2,6,234,242,-4
Nfam1,4,8,230,242,-4
Ak1,6,10,226,242,-4
Cox18,2,6,234,242,-4
Gpr135,0,4,238,242,-4
Nfkb1,2,6,234,242,-4
Aida,3,7,232,242,-4
Cpb1,1,5,236,242,-4
Gpr1,5,9,228,242,-4
Nfyc,3,7,232,242,-4
Gper1,4,8,230,242,-4
Cox6a1,3,7,232,242,-4
AI987944,3,7,232,242,-4
AI837181,2,6,234,242,-4
Cox6c,4,8,230,242,-4
Nid1,3,7,232,242,-4
Gna15,3,7,232,242,-4
Gna14,9,13,220,242,-4
Nlrp2,2,6,234,242,-4
Ctnnd1,2,6,234,242,-4
Cthrc1,5,9,228,242,-4
Adrm1,2,6,234,242,-4
Ctnna3,0,4,238,242,-4
Npas4,0,4,238,242,-4
Adrb3,1,5,236,242,-4
Ctnnbl1,2,6,234,242,-4
Gm826,6,10,226,242,-4
Npff,31,35,176,242,-4
Ctnnd2,0,4,238,242,-4
Crx,5,9,228,242,-4
Nploc4,2,6,234,242,-4
Ctps2,3,7,232,242,-4
Ctr9,2,6,234,242,-4
Adk,4,8,230,242,-4
Ctsm,1,5,236,242,-4
Ctsw,9,13,220,242,-4
Ctu2,6,10,226,242,-4
Cuedc2,2,6,234,242,-4
Afdn,2,6,234,242,-4
Ctag2l2,1,5,236,242,-4
Nop2,3,7,232,242,-4
Gm8369,10,14,218,242,-4
Gmpr,2,6,234,242,-4
Nmb,2,6,234,242,-4
Gmnn,3,7,232,242,-4
Cryga,11,15,216,242,-4
Gmfg,10,14,218,242,-4
Crygd,9,13,220,242,-4
Csdc2,6,10,226,242,-4
Csde1,4,8,230,242,-4
Gm960,1,5,236,242,-4
Gm9495,0,4,238,242,-4
Afg3l2,2,6,234,242,-4
Csnk2b,7,11,224,242,-4
Noc3l,2,6,234,242,-4
Cst13,2,6,234,242,-4
Cst6,9,13,220,242,-4
Nol4,3,7,232,242,-4
Cst7,12,16,214,242,-4
Cfap52,4,8,230,242,-4
Iba57,3,7,232,242,-4
Dgke,0,4,238,242,-4
Bcl7b,3,7,232,242,-4
Magoh,3,7,232,242,-4
Klk1b8,3,7,232,242,-4
Klk15,6,10,226,242,-4
Klk13,4,8,230,242,-4
Ccdc185,0,4,238,242,-4
Mamdc2,0,4,238,242,-4
Bcl9l,4,8,230,242,-4
Man1a2,4,8,230,242,-4
Klhdc8b,3,7,232,242,-4
Magi3,2,6,234,242,-4
Maneal,3,7,232,242,-4
Klf17,1,5,236,242,-4
Map2k2,2,6,234,242,-4
Klf1,9,13,220,242,-4
Map2k7,4,8,230,242,-4
Bcas1,1,5,236,242,-4
BC053393,1,5,236,242,-4
Ccdc58,5,9,228,242,-4
Bdkrb2,2,6,234,242,-4
Klkb1,8,12,222,242,-4
Map4,3,7,232,242,-4
Krt76,2,6,234,242,-4
Kyat3,5,9,228,242,-4
Ksr2,2,6,234,242,-4
Ccdc116,8,12,222,242,-4
Ccdc120,6,10,226,242,-4
Blcap,3,7,232,242,-4
Krtap10-4,1,5,236,242,-4
Krt77,0,4,238,242,-4
Bin3,2,6,234,242,-4
Mab21l2,1,5,236,242,-4
Klra3,2,6,234,242,-4
Krt71,0,4,238,242,-4
Krt222,2,6,234,242,-4
Krba1,4,8,230,242,-4
Kpna4,4,8,230,242,-4
Klrk1,2,6,234,242,-4
Bex6,3,7,232,242,-4
Bet1l,5,9,228,242,-4
Becn1,3,7,232,242,-4
Ccdc61,5,9,228,242,-4
Kir3dl2,3,7,232,242,-4
Lamb3,6,10,226,242,-4
Barhl2,1,5,236,242,-4
Ccnyl1,4,8,230,242,-4
Bbox1,2,6,234,242,-4
Bbip1,2,6,234,242,-4
Kctd4,5,9,228,242,-4
Ccr3,1,5,236,242,-4
Mast1,1,5,236,242,-4
Kctd21,2,6,234,242,-4
Batf,6,10,226,242,-4
Mbd1,2,6,234,242,-4
Kdm3a,3,7,232,242,-4
Mbd2,2,6,234,242,-4
Mbl1,2,6,234,242,-4
Cd200r1,6,10,226,242,-4
Mboat4,1,5,236,242,-4
Cd300c2,8,12,222,242,-4
Kcnj15,9,13,220,242,-4
Cd33,4,8,230,242,-4
Kcnh8,0,4,238,242,-4
Marf1,7,11,224,242,-4
Marchf6,2,6,234,242,-4
Kif9,6,10,226,242,-4
Ccdc84,3,7,232,242,-4
BC051142,10,14,218,242,-4
Map4k2,2,6,234,242,-4
Map4k3,2,6,234,242,-4
Map6,0,4,238,242,-4
Map6d1,3,7,232,242,-4
Map7d3,3,7,232,242,-4
Ccdc8,3,7,232,242,-4
Ccdc82,2,6,234,242,-4
BC048403,2,6,234,242,-4
Marchf4,0,4,238,242,-4
Kif3c,2,6,234,242,-4
Kif2b,0,4,238,242,-4
Ccdc96,4,8,230,242,-4
Kif19a,2,6,234,242,-4
Ccer1,0,4,238,242,-4
Mapk8,6,10,226,242,-4
Bbs7,4,8,230,242,-4
Ccny,2,6,234,242,-4
Lamb2,7,11,224,242,-4
Ccar2,2,6,234,242,-4
Cfap410,3,7,232,242,-4
Btbd35f3,0,4,238,242,-4
Lrrc49,3,7,232,242,-4
Lipo4,2,6,234,242,-4
Btbd35f9,0,4,238,242,-4
Btbd35f8,1,5,236,242,-4
Btbd35f7,0,4,238,242,-4
Camta2,2,6,234,242,-4
Lingo2,1,5,236,242,-4
Btbd35f6,1,5,236,242,-4
Btbd35f25,0,4,238,242,-4
Camk1d,0,4,238,242,-4
Btbd35f24,0,4,238,242,-4
Lrrc66,16,20,206,242,-4
Btbd35f23,0,4,238,242,-4
Btbd35f22,0,4,238,242,-4
Btbd35f2,0,4,238,242,-4
Btbd35f18,0,4,238,242,-4
Btbd35f17,0,4,238,242,-4
Btbd35f16,0,4,238,242,-4
Lipt1,4,8,230,242,-4
Lrrc41,2,6,234,242,-4
Btbd35f14,0,4,238,242,-4
Lnx2,2,6,234,242,-4
Lrch2,1,5,236,242,-4
Caap1,2,6,234,242,-4
Cacfd1,4,8,230,242,-4
Lpcat3,5,9,228,242,-4
C9orf72,3,7,232,242,-4
Cacna1g,3,7,232,242,-4
Lonp2,2,6,234,242,-4
Lrrc10b,4,8,230,242,-4
Lmx1b,0,4,238,242,-4
Btk,5,9,228,242,-4
Lrrc18,1,5,236,242,-4
C2cd4b,4,8,230,242,-4
Calcrl,4,8,230,242,-4
C1galt1c1,4,8,230,242,-4
Lmntd1,3,7,232,242,-4
Lmbrd2,3,7,232,242,-4
Lrrc36,2,6,234,242,-4
Calr3,3,7,232,242,-4
Lrrc9,0,4,238,242,-4
Lrrfip2,3,7,232,242,-4
Lamtor1,3,7,232,242,-4
Cbll1,4,8,230,242,-4
Brd7,2,6,234,242,-4
Luzp2,2,6,234,242,-4
Casp9,3,7,232,242,-4
Cass4,2,6,234,242,-4
Ly6c2,18,22,202,242,-4
Lect2,7,11,224,242,-4
Bpifb3,2,6,234,242,-4
Lcp1,13,17,212,242,-4
Lce1h,3,7,232,242,-4
Leng9,1,5,236,242,-4
Cbln1,1,5,236,242,-4
Lbhd1,2,6,234,242,-4
Cc2d1a,2,6,234,242,-4
Las1l,5,9,228,242,-4
Lars,2,6,234,242,-4
Larp6,3,7,232,242,-4
Large1,2,6,234,242,-4
Lypla2,3,7,232,242,-4
Casd1,3,7,232,242,-4
Cars2,3,7,232,242,-4
Cant1,3,7,232,242,-4
Bsph1,1,5,236,242,-4
Btbd35f12,0,4,238,242,-4
Canx,3,7,232,242,-4
Lrrk2,4,8,230,242,-4
Lime1,5,9,228,242,-4
Lrtm1,0,4,238,242,-4
Limd1,3,7,232,242,-4
Capn13,0,4,238,242,-4
Lsm14b,2,6,234,242,-4
Bsn,0,4,238,242,-4
Bri3bp,3,7,232,242,-4
Brk1,2,6,234,242,-4
Lsm7,4,8,230,242,-4
Brip1,0,4,238,242,-4
Brinp3,4,8,230,242,-4
Carlr,1,5,236,242,-4
Carmil3,0,4,238,242,-4
Lta4h,3,7,232,242,-4
Ltv1,4,8,230,242,-4
Mcee,6,10,226,242,-4
Mcf2l,4,8,230,242,-4
Kcnh3,2,6,234,242,-4
Asb8,3,7,232,242,-4
Cep104,2,6,234,242,-4
Mon1b,2,6,234,242,-4
Il17d,1,5,236,242,-4
Morc3,5,9,228,242,-4
Il15ra,11,15,216,242,-4
Il15,8,12,222,242,-4
Ascc3,2,6,234,242,-4
Asb9,4,8,230,242,-4
Il11ra1,3,7,232,242,-4
Mob3c,3,7,232,242,-4
Mpdu1,3,7,232,242,-4
Ikbke,3,7,232,242,-4
Asb2,2,6,234,242,-4
Asb18,2,6,234,242,-4
Iglc3,10,14,218,242,-4
Cep170,5,9,228,242,-4
Asap1,2,6,234,242,-4
Mpst,7,11,224,242,-4
Celsr1,8,12,222,242,-4
Il6st,8,12,222,242,-4
Mpv17l,6,10,226,242,-4
Ate1,3,7,232,242,-4
Atg4d,2,6,234,242,-4
Ceacam19,1,5,236,242,-4
Mllt11,5,9,228,242,-4
Mlph,4,8,230,242,-4
Mlst8,2,6,234,242,-4
Atf7ip2,3,7,232,242,-4
Atf7ip,14,18,210,242,-4
Impdh2,3,7,232,242,-4
Atat1,4,8,230,242,-4
Asprv1,6,10,226,242,-4
Cebpa,2,6,234,242,-4
Atad3a,4,8,230,242,-4
Impa1,6,10,226,242,-4
Immt,2,6,234,242,-4
Celf4,5,9,228,242,-4
Ilrun,2,6,234,242,-4
Ilf3,4,8,230,242,-4
Ilf2,3,7,232,242,-4
Igkv8-18,4,8,230,242,-4
Igkv4-69,4,8,230,242,-4
Bach2,0,4,238,242,-4
Cfap206,3,7,232,242,-4
Arid2,2,6,234,242,-4
Arid1a,2,6,234,242,-4
Ifngr1,4,8,230,242,-4
Cetn1,0,4,238,242,-4
Ifitm6,17,21,204,242,-4
Ifi44l,4,8,230,242,-4
Mrps17,2,6,234,242,-4
Ifi208,2,6,234,242,-4
Mrps2,3,7,232,242,-4
Mrpl48,3,7,232,242,-4
Cfap20dc,1,5,236,242,-4
Arhgef18,3,7,232,242,-4
Arhgef10,3,7,232,242,-4
Arhgdia,2,6,234,242,-4
Arhgap40,2,6,234,242,-4
Cfap299,9,13,220,242,-4
Icam5,4,8,230,242,-4
Arhgap28,3,7,232,242,-4
Ift122,3,7,232,242,-4
Ift27,3,7,232,242,-4
Mrgprb2,0,4,238,242,-4
Ighv1-62-3,0,4,238,242,-4
Igkv12-89,7,11,224,242,-4
Art2b,1,5,236,242,-4
Mrm2,4,8,230,242,-4
Igkj5,1,5,236,242,-4
Ighv4-1,6,10,226,242,-4
Cep63,4,8,230,242,-4
Ighv15-2,4,8,230,242,-4
Cep85,4,8,230,242,-4
Ighv1-5,2,6,234,242,-4
Ces2f,3,7,232,242,-4
Cert1,2,6,234,242,-4
Mrpl2,2,6,234,242,-4
Armc2,4,8,230,242,-4
Armc10,2,6,234,242,-4
Arl6ip1,3,7,232,242,-4
Arl4a,3,7,232,242,-4
Mrpl42,7,11,224,242,-4
Mrpl45,3,7,232,242,-4
Cds1,3,7,232,242,-4
Cdon,5,9,228,242,-4
Cdnf,0,4,238,242,-4
Jagn1,3,7,232,242,-4
Jkamp,8,12,222,242,-4
Jhy,5,9,228,242,-4
Metrn,3,7,232,242,-4
Jarid2,4,8,230,242,-4
Jam3,2,6,234,242,-4
Aven,4,8,230,242,-4
Cdc42se1,2,6,234,242,-4
Aup1,2,6,234,242,-4
Jade2,3,7,232,242,-4
Jmjd7,4,8,230,242,-4
Izumo3,0,4,238,242,-4
Mettl25,3,7,232,242,-4
Cdca8,5,9,228,242,-4
AU018091,1,5,236,242,-4
Itsn1,3,7,232,242,-4
Atxn2l,5,9,228,242,-4
Cdh12,0,4,238,242,-4
Atrn,2,6,234,242,-4
Cdc42,4,8,230,242,-4
B3galt6,2,6,234,242,-4
Ino80b,2,6,234,242,-4
Cdan1,3,7,232,242,-4
Mctp1,2,6,234,242,-4
Mcu,2,6,234,242,-4
Kcnd1,0,4,238,242,-4
Cd3eap,2,6,234,242,-4
Kcnab1,2,6,234,242,-4
Kbtbd6,1,5,236,242,-4
B930094E09Rik,10,14,218,242,-4
B4gat1,8,12,222,242,-4
B4galt5,4,8,230,242,-4
Jtb,3,7,232,242,-4
Med18,4,8,230,242,-4
Kat7,2,6,234,242,-4
Med30,3,7,232,242,-4
Cdc16,2,6,234,242,-4
Kat6a,2,6,234,242,-4
B4galnt1,5,9,228,242,-4
Cdc23,4,8,230,242,-4
Kank1,4,8,230,242,-4
Mfap4,7,11,224,242,-4
Cdh13,2,6,234,242,-4
Itpr3,0,4,238,242,-4
Ip6k1,3,7,232,242,-4
Cdk2ap1,2,6,234,242,-4
Iqch,2,6,234,242,-4
Cdk5rap2,10,14,218,242,-4
Ipo7,2,6,234,242,-4
Ipo11,2,6,234,242,-4
Ipmk,3,7,232,242,-4
Mier3,3,7,232,242,-4
Atp5j2,2,6,234,242,-4
Cdkl2,3,7,232,242,-4
Mfsd11,2,6,234,242,-4
Ints7,2,6,234,242,-4
Ints5,2,6,234,242,-4
Ints14,2,6,234,242,-4
Ints13,4,8,230,242,-4
Cdkl4,2,6,234,242,-4
Inpp5j,4,8,230,242,-4
Atp10d,6,10,226,242,-4
Inpp5e,3,7,232,242,-4
Cdk18,3,7,232,242,-4
Cdk12,3,7,232,242,-4
Mical2,2,6,234,242,-4
Atp6v0a2,3,7,232,242,-4
Itpr1,4,8,230,242,-4
Itpkc,1,5,236,242,-4
Itgb7,10,14,218,242,-4
Cdh23,0,4,238,242,-4
Cdhr4,10,14,218,242,-4
Atp8b4,1,5,236,242,-4
Itga4,0,4,238,242,-4
Itga2,5,9,228,242,-4
Atp6v1g1,2,6,234,242,-4
Isg20l2,2,6,234,242,-4
Atp6v1fnb,16,20,206,242,-4
Irs4,0,4,238,242,-4
Mgam,2,6,234,242,-4
Irgm1,7,11,224,242,-4
Cdk10,4,8,230,242,-4
Irak4,2,6,234,242,-4
Atp6v0e,5,9,228,242,-4
Olfm2,2,6,234,242,-4
Nlrp4a,0,4,238,242,-4
Cab39,2,6,234,242,-4
Pdgfrl,6,10,226,242,-4
Gm21962,9,13,220,242,-4
Phf20l1,4,8,230,242,-4
2200002J24Rik,12,16,214,242,-4
Gabrg3,0,4,238,242,-4
Gm21981,2,6,234,242,-4
Phf8,2,6,234,242,-4
Gabrd,1,5,236,242,-4
1810065E05Rik,1,5,236,242,-4
Aadacl2fm2,4,8,230,242,-4
Pag1,5,9,228,242,-4
1810058I24Rik,4,8,230,242,-4
Glp1r,0,4,238,242,-4
Pak3,3,7,232,242,-4
Aar2,2,6,234,242,-4
Dusp21,0,4,238,242,-4
Phox2a,9,13,220,242,-4
Olfr66,4,8,230,242,-4
Etv1,3,7,232,242,-4
Pak2,3,7,232,242,-4
Gm26620,12,16,214,242,-4
Gabpb1,5,9,228,242,-4
Olfr653,0,4,238,242,-4
Dus3l,2,6,234,242,-4
Gabbr1,4,8,230,242,-4
Gm21958,11,15,216,242,-4
Gm21921,0,4,238,242,-4
Fam149b,3,7,232,242,-4
Gm21913,2,6,234,242,-4
A930002H24Rik,14,18,210,242,-4
Gm17304,6,10,226,242,-4
A930033H14Rik,3,7,232,242,-4
Galnt12,2,6,234,242,-4
Galnt10,2,6,234,242,-4
4933436I01Rik,0,4,238,242,-4
E130114P18Rik,6,10,226,242,-4
Eif2ak1,2,6,234,242,-4
Evi5l,3,7,232,242,-4
Dzip1,0,4,238,242,-4
Gm21762,6,10,226,242,-4
Olfr735,1,5,236,242,-4
Fam149a,9,13,220,242,-4
Dynlt1f,8,12,222,242,-4
2310061I04Rik,3,7,232,242,-4
2310034G01Rik,6,10,226,242,-4
Gadd45gip1,2,6,234,242,-4
Olfr720,2,6,234,242,-4
Olfr716,3,7,232,242,-4
2310011J03Rik,2,6,234,242,-4
Gm21885,8,12,222,242,-4
Gm21891,2,6,234,242,-4
Glis2,3,7,232,242,-4
Etfb,2,6,234,242,-4
Pak4,2,6,234,242,-4
Evx2,1,5,236,242,-4
Errfi1,6,10,226,242,-4
4930469K13Rik,17,21,204,242,-4
Palm3,5,9,228,242,-4
Fam193a,3,7,232,242,-4
Pan2,2,6,234,242,-4
Dtnb,2,6,234,242,-4
Abcc2,2,6,234,242,-4
Fv1,8,12,222,242,-4
Olfr418,1,5,236,242,-4
Per3,2,6,234,242,-4
Dstyk,4,8,230,242,-4
Dsg1c,0,4,238,242,-4
Abcd4,3,7,232,242,-4
Olfr628,1,5,236,242,-4
Gm29276,1,5,236,242,-4
Fam207a,2,6,234,242,-4
Gm29609,11,15,216,242,-4
4930522H14Rik,0,4,238,242,-4
Olfr344,4,8,230,242,-4
Olfr338,0,4,238,242,-4
Gm29866,2,6,234,242,-4
Eif2d,2,6,234,242,-4
Paox,7,11,224,242,-4
Eif2s1,4,8,230,242,-4
Fam214a,3,7,232,242,-4
Olfm3,2,6,234,242,-4
Pias1,5,9,228,242,-4
Olfr46,6,10,226,242,-4
Fzd2,2,6,234,242,-4
Olfr622,2,6,234,242,-4
Dupd1,6,10,226,242,-4
Abat,5,9,228,242,-4
Gab3,6,10,226,242,-4
Phtf2,3,7,232,242,-4
Etf1,2,6,234,242,-4
Gm281,0,4,238,242,-4
Phxr2,10,14,218,242,-4
Gm16506,2,6,234,242,-4
Dtx2,3,7,232,242,-4
Ess2,2,6,234,242,-4
Abca2,2,6,234,242,-4
Fam170b,0,4,238,242,-4
Esrp2,5,9,228,242,-4
Esp31,0,4,238,242,-4
Gm2832,3,7,232,242,-4
Esp23,0,4,238,242,-4
Eif2b4,5,9,228,242,-4
Olfr482,2,6,234,242,-4
Gm28372,4,8,230,242,-4
Olfr472,0,4,238,242,-4
Olfr466,0,4,238,242,-4
Fam186b,12,16,214,242,-4
Pabpc1l,2,6,234,242,-4
Eny2,5,9,228,242,-4
Olfr323,1,5,236,242,-4
Ect2,7,11,224,242,-4
Pex5l,0,4,238,242,-4
Ehmt1,3,7,232,242,-4
Otud7b,3,7,232,242,-4
3110040N11Rik,7,11,224,242,-4
9930111J21Rik2,4,8,230,242,-4
Pebp4,5,9,228,242,-4
Opn3,2,6,234,242,-4
Gm20855,0,4,238,242,-4
Opn1sw,8,12,222,242,-4
Edc3,2,6,234,242,-4
Fads2b,0,4,238,242,-4
Opalin,0,4,238,242,-4
Exog,2,6,234,242,-4
Otulinl,13,17,212,242,-4
Opa3,2,6,234,242,-4
Pfdn1,2,6,234,242,-4
Pear1,9,13,220,242,-4
3110001I22Rik,4,8,230,242,-4
Exosc2,2,6,234,242,-4
Ovca2,2,6,234,242,-4
Ece1,13,17,212,242,-4
Olfr986,2,6,234,242,-4
Gdap1,0,4,238,242,-4
Olfr983,0,4,238,242,-4
Fabp12,8,12,222,242,-4
Orai2,2,6,234,242,-4
Orc3,5,9,228,242,-4
3830406C13Rik,4,8,230,242,-4
Ggt1,6,10,226,242,-4
Exph5,3,7,232,242,-4
Ggn,6,10,226,242,-4
Efcab10,2,6,234,242,-4
Efcab5,2,6,234,242,-4
Ginm1,2,6,234,242,-4
Gm20767,5,9,228,242,-4
Gm20795,0,4,238,242,-4
Gfm2,3,7,232,242,-4
Faah,2,6,234,242,-4
Pef1,2,6,234,242,-4
Faap20,4,8,230,242,-4
Otub2,5,9,228,242,-4
Ehhadh,6,10,226,242,-4
4921509C19Rik,0,4,238,242,-4
Gemin8,3,7,232,242,-4
Gemin7,5,9,228,242,-4
Gm20403,16,20,206,242,-4
Pex2,5,9,228,242,-4
Osbpl1a,2,6,234,242,-4
7420426K07Rik,0,4,238,242,-4
Ormdl1,5,9,228,242,-4
Gm20837,4,8,230,242,-4
Gm20888,0,4,238,242,-4
A330070K13Rik,3,7,232,242,-4
Ewsr1,3,7,232,242,-4
Galntl5,0,4,238,242,-4
Olfr859,0,4,238,242,-4
P2rx5,9,13,220,242,-4
E2f1,3,7,232,242,-4
Gm21292,3,7,232,242,-4
4930438A08Rik,3,7,232,242,-4
P2rx6,1,5,236,242,-4
Gas2,3,7,232,242,-4
Gart,5,9,228,242,-4
Olfr802,2,6,234,242,-4
Pgk1,4,8,230,242,-4
Gkn2,1,5,236,242,-4
Pglyrp2,3,7,232,242,-4
Fam107a,3,7,232,242,-4
Exoc3l2,4,8,230,242,-4
Galnt7,3,7,232,242,-4
Pgm1,4,8,230,242,-4
A530032D15Rik,12,16,214,242,-4
Pgm2,6,10,226,242,-4
A630010A05Rik,8,12,222,242,-4
Glcci1,9,13,220,242,-4
Olfr774,7,11,224,242,-4
P2ry4,1,5,236,242,-4
5031439G07Rik,2,6,234,242,-4
Fam136a,3,7,232,242,-4
Pds5b,2,6,234,242,-4
E2f3,3,7,232,242,-4
Olfr875,1,5,236,242,-4
E2f4,2,6,234,242,-4
Olfr975,3,7,232,242,-4
Eid2,4,8,230,242,-4
Gm2004,22,26,194,242,-4
Gjb4,3,7,232,242,-4
Pdzd7,3,7,232,242,-4
Gba2,4,8,230,242,-4
Gm19410,0,4,238,242,-4
Gm20911,2,6,234,242,-4
4930430F08Rik,2,6,234,242,-4
P2rx1,3,7,232,242,-4
Olfr906,2,6,234,242,-4
Eaf1,2,6,234,242,-4
Olfr904,1,5,236,242,-4
Gje1,3,7,232,242,-4
Olfr901,0,4,238,242,-4
Gm20920,1,5,236,242,-4
Gatd1,2,6,234,242,-4
Fam120b,3,7,232,242,-4
Gk2,2,6,234,242,-4
Olfr9,1,5,236,242,-4
Pgap4,6,10,226,242,-4
Gm21028,13,17,212,242,-4
Gm17655,14,18,210,242,-4
Gm15448,2,6,234,242,-4
9130401M01Rik,3,7,232,242,-4
Eif3d,3,7,232,242,-4
Ell2,6,10,226,242,-4
Olfr1269,2,6,234,242,-4
Dlc1,4,8,230,242,-4
Fhdc1,1,5,236,242,-4
Fgr,1,5,236,242,-4
Pkn2,3,7,232,242,-4
Gm14147,0,4,238,242,-4
Fgfr1op2,4,8,230,242,-4
Pkp4,3,7,232,242,-4
Gm3755,17,21,204,242,-4
Paxbp1,2,6,234,242,-4
1700012P22Rik,1,5,236,242,-4
Gm382,0,4,238,242,-4
Gm11565,0,4,238,242,-4
Fgf20,13,17,212,242,-4
4930579G24Rik,2,6,234,242,-4
Plaat1,4,8,230,242,-4
Fgf14,1,5,236,242,-4
Acin1,3,7,232,242,-4
Fgf12,2,6,234,242,-4
Olfr1209,2,6,234,242,-4
Dhx9,3,7,232,242,-4
Plac9a,6,10,226,242,-4
Pcdhga4,2,6,234,242,-4
Pkhd1l1,0,4,238,242,-4
Fancc,3,7,232,242,-4
Emx1,6,10,226,242,-4
Fjx1,2,6,234,242,-4
Olfr131,4,8,230,242,-4
4930578G10Rik,16,20,206,242,-4
1700020N15Rik,3,7,232,242,-4
Fam53a,2,6,234,242,-4
Fkrp,5,9,228,242,-4
4932415D10Rik,1,5,236,242,-4
Dnaaf6,0,4,238,242,-4
Fam98a,2,6,234,242,-4
Elmod1,1,5,236,242,-4
Dnaaf2,0,4,238,242,-4
Fam98b,4,8,230,242,-4
Eps8l2,4,8,230,242,-4
Ercc4,3,7,232,242,-4
Dmtn,4,8,230,242,-4
Dmrtb1,3,7,232,242,-4
Dpys,6,10,226,242,-4
1700019A02Rik,10,14,218,242,-4
Gm11020,2,6,234,242,-4
Fign,1,5,236,242,-4
Pcgf6,3,7,232,242,-4
Ercc3,2,6,234,242,-4
Gm14296,7,11,224,242,-4
Fat1,2,6,234,242,-4
1700003F12Rik,14,18,210,242,-4
Eps15l1,3,7,232,242,-4
Gm43738,7,11,224,242,-4
Fbxo7,5,9,228,242,-4
Dhrs11,4,8,230,242,-4
Pbxip1,5,9,228,242,-4
Gm13030,2,6,234,242,-4
Epb41l2,3,7,232,242,-4
Enpp4,3,7,232,242,-4
Enthd1,5,9,228,242,-4
Fbxo48,4,8,230,242,-4
Olfr109,0,4,238,242,-4
Entpd4,3,7,232,242,-4
Dhps,2,6,234,242,-4
Olfr1137,1,5,236,242,-4
Fbxo25,3,7,232,242,-4
Fbxo45,3,7,232,242,-4
1110017D15Rik,11,15,216,242,-4
Olfr105-ps,0,4,238,242,-4
Olfr1047,1,5,236,242,-4
Ep400,3,7,232,242,-4
Fbxo4,3,7,232,242,-4
Gm44502,5,9,228,242,-4
Gm44503,6,10,226,242,-4
Olfr1028,3,7,232,242,-4
Enox1,1,5,236,242,-4
Fbxw20,0,4,238,242,-4
1500009C09Rik,2,6,234,242,-4
Dhx30,3,7,232,242,-4
Fbf1,2,6,234,242,-4
Plcd4,4,8,230,242,-4
Ackr3,6,10,226,242,-4
Epn3,8,12,222,242,-4
Olfr1183,0,4,238,242,-4
Epha7,3,7,232,242,-4
Fer,2,6,234,242,-4
Pcdha5,2,6,234,242,-4
Fech,2,6,234,242,-4
Fbxl12,3,7,232,242,-4
Plek,9,13,220,242,-4
Fbxw4,2,6,234,242,-4
Plekha1,6,10,226,242,-4
Pcdha3,2,6,234,242,-4
Fbxl5,3,7,232,242,-4
Dhx16,3,7,232,242,-4
Gm13539,5,9,228,242,-4
Pbx2,3,7,232,242,-4
Pbx3,2,6,234,242,-4
Dhrs3,4,8,230,242,-4
Olfr1175,1,5,236,242,-4
Olfr1156,4,8,230,242,-4
Ell3,8,12,222,242,-4
Dmap1,3,7,232,242,-4
Pisd,3,7,232,242,-4
Foxb2,0,4,238,242,-4
Eri3,2,6,234,242,-4
Pih1d2,8,12,222,242,-4
Dnajc4,2,6,234,242,-4
Dnajc3,2,6,234,242,-4
Frat1,7,11,224,242,-4
Dohh,4,8,230,242,-4
Olfr169,0,4,238,242,-4
Foxd3,2,6,234,242,-4
Olfr161,1,5,236,242,-4
Eif3k,4,8,230,242,-4
1700093K21Rik,15,19,208,242,-4
Olfr153,2,6,234,242,-4
Elf2,2,6,234,242,-4
Fnbp4,2,6,234,242,-4
Fam241a,5,9,228,242,-4
Fam243,0,4,238,242,-4
Abhd17b,2,6,234,242,-4
Elf5,9,13,220,242,-4
Gm3373,14,18,210,242,-4
Olfr281,0,4,238,242,-4
Gm33543,1,5,236,242,-4
Dnajc5b,4,8,230,242,-4
Olfr25,3,7,232,242,-4
Gm3183,3,7,232,242,-4
Dnlz,2,6,234,242,-4
Parl,3,7,232,242,-4
Olfr24,2,6,234,242,-4
Eif4a2,3,7,232,242,-4
Pcyt1a,2,6,234,242,-4
Olfr23,0,4,238,242,-4
Pigx,5,9,228,242,-4
Gm3149,5,9,228,242,-4
Eif4a3,3,7,232,242,-4
Olfr204,2,6,234,242,-4
Abhd10,5,9,228,242,-4
Olfr273,3,7,232,242,-4
Olfr199,1,5,236,242,-4
Foxn4,2,6,234,242,-4
Pinx1,4,8,230,242,-4
Parp8,2,6,234,242,-4
Olfr1489,0,4,238,242,-4
4933400A11Rik,4,8,230,242,-4
4932438H23Rik,5,9,228,242,-4
Dnajc11,2,6,234,242,-4
Olfr305,0,4,238,242,-4
Eif3h,2,6,234,242,-4
Dnajc10,2,6,234,242,-4
Abitram,6,10,226,242,-4
Abl1,2,6,234,242,-4
Pate12,0,4,238,242,-4
Dnajc1,2,6,234,242,-4
Ablim1,3,7,232,242,-4
Olfr1384,1,5,236,242,-4
Olfr31,1,5,236,242,-4
Dpp8,2,6,234,242,-4
Gm10778,14,18,210,242,-4
Abt1,2,6,234,242,-4
Flrt2,2,6,234,242,-4
Ercc6,2,6,234,242,-4
Olfr315,1,5,236,242,-4
Elk3,2,6,234,242,-4
Fam216a,2,6,234,242,-4
Eif4a1,3,7,232,242,-4
Pdcd6,3,7,232,242,-4
Olfr1396,0,4,238,242,-4
1700031L13Rik,0,4,238,242,-4
Frmd5,0,4,238,242,-4
Olfr1444,0,4,238,242,-4
4930524B15Rik,0,4,238,242,-4
Olfr1440,0,4,238,242,-4
Gm10271,13,18,211,242,-5
Septin5,4,9,229,242,-5
Cep126,5,10,227,242,-5
Cdh11,2,7,233,242,-5
Sub1,2,7,233,242,-5
Septin12,0,5,237,242,-5
Gm10471,4,9,229,242,-5
Gins2,0,5,237,242,-5
Syndig1l,5,10,227,242,-5
Timm50,2,7,233,242,-5
Exosc3,3,8,231,242,-5
Extl2,2,7,233,242,-5
Ube2dnl2,1,6,235,242,-5
Ube2cbp,3,8,231,242,-5
Erich3,0,5,237,242,-5
Cdc42ep3,4,9,229,242,-5
Insl6,11,16,215,242,-5
Igsf6,6,11,225,242,-5
Thbs1,8,13,221,242,-5
Epc2,5,10,227,242,-5
Erlec1,5,10,227,242,-5
Gm10217,27,32,183,242,-5
Gip,9,14,219,242,-5
Sertad1,2,7,233,242,-5
Ints6l,7,12,223,242,-5
Tfec,5,10,227,242,-5
Erlin1,10,15,217,242,-5
Tubgcp6,1,6,235,242,-5
Serpinb9f,0,5,237,242,-5
Exosc6,5,10,227,242,-5
Gid8,3,8,231,242,-5
Ino80,2,7,233,242,-5
Gjd3,10,15,217,242,-5
Ikbkb,2,7,233,242,-5
Ist1,3,8,231,242,-5
Txlna,2,7,233,242,-5
Inca1,2,7,233,242,-5
Ercc6l2,4,9,229,242,-5
Glod4,3,8,231,242,-5
Itga11,0,5,237,242,-5
Gm11084,9,14,219,242,-5
Gm10775,11,16,215,242,-5
Itch,4,9,229,242,-5
Sult3a1,1,6,235,242,-5
Sumo1,3,8,231,242,-5
Impdh1,2,7,233,242,-5
Epgn,9,14,219,242,-5
Exo1,1,6,235,242,-5
Syce2,4,9,229,242,-5
Gli2,0,5,237,242,-5
Sult6b1,6,11,225,242,-5
Ercc5,2,7,233,242,-5
Ceacam9,3,8,231,242,-5
Evl,2,7,233,242,-5
Irak1bp1,4,9,229,242,-5
Irak3,3,8,231,242,-5
Glis1,8,13,221,242,-5
Gkap1,3,8,231,242,-5
Itga9,4,9,229,242,-5
Erf,3,8,231,242,-5
Ing2,2,7,233,242,-5
Ints8,3,8,231,242,-5
Itsn2,2,7,233,242,-5
Gipr,5,10,227,242,-5
Sfta2,18,23,201,242,-5
Sesn1,3,8,231,242,-5
Gm10130,3,8,231,242,-5
Gm12689,6,11,225,242,-5
Thap4,3,8,231,242,-5
Il12rb2,2,7,233,242,-5
Exoc8,2,7,233,242,-5
Eps15,3,8,231,242,-5
Itpr2,2,7,233,242,-5
Supt5,3,8,231,242,-5
Gm11733,1,6,235,242,-5
Sesn3,2,7,233,242,-5
Ergic2,5,10,227,242,-5
Cdh20,0,5,237,242,-5
Thoc6,2,7,233,242,-5
Gm10521,1,6,235,242,-5
Cenpw,0,5,237,242,-5
Cenps,5,10,227,242,-5
Erv3,1,6,235,242,-5
Ccnc,2,7,233,242,-5
Septin10,4,9,229,242,-5
Ldb3,0,5,237,242,-5
Lancl1,2,7,233,242,-5
Larp4,2,7,233,242,-5
Fndc9,2,7,233,242,-5
Fam228a,4,9,229,242,-5
Fndc3a,3,8,231,242,-5
Lce1d,1,6,235,242,-5
Fmo1,5,10,227,242,-5
Sars2,4,9,229,242,-5
Lcmt2,4,9,229,242,-5
Catspere2,4,9,229,242,-5
Flywch2,4,9,229,242,-5
Foxe3,3,8,231,242,-5
Usp42,1,6,235,242,-5
Usp44,0,5,237,242,-5
Tead4,4,9,229,242,-5
Tead3,3,8,231,242,-5
Usp5,2,7,233,242,-5
Catip,5,10,227,242,-5
Fam50b,2,7,233,242,-5
Flot1,3,8,231,242,-5
Flii,2,7,233,242,-5
Casc1,2,7,233,242,-5
Usp16,2,7,233,242,-5
Fam220a,2,7,233,242,-5
Tasor,2,7,233,242,-5
Ccdc134,1,6,235,242,-5
Ccdc15,1,6,235,242,-5
Fthl17a,6,11,225,242,-5
Ccdc148,4,9,229,242,-5
Tango6,2,7,233,242,-5
Kremen2,3,8,231,242,-5
Taok2,2,7,233,242,-5
Tapbp,3,8,231,242,-5
Scg5,4,9,229,242,-5
Frmd6,2,7,233,242,-5
Tardbp,2,7,233,242,-5
Scd1,4,9,229,242,-5
Usp10,2,7,233,242,-5
Fam217b,0,5,237,242,-5
Ccdc122,5,10,227,242,-5
Uros,4,9,229,242,-5
Frem1,0,5,237,242,-5
Ccdc115,2,7,233,242,-5
Foxred1,2,7,233,242,-5
Kynu,5,10,227,242,-5
L1cam,7,12,223,242,-5
Lactbl1,0,5,237,242,-5
Usp1,5,10,227,242,-5
Leprot,5,10,227,242,-5
Fam71b,0,5,237,242,-5
Ggnbp1,10,15,217,242,-5
Fbxw14,9,14,219,242,-5
Llgl1,3,8,231,242,-5
S100a2,23,28,191,242,-5
Lmntd2,6,11,225,242,-5
S100a1,7,12,223,242,-5
Vax2,5,10,227,242,-5
Fcf1,5,10,227,242,-5
Rybp,4,9,229,242,-5
Rxylt1,4,9,229,242,-5
Tcf19,2,7,233,242,-5
Rxrb,2,7,233,242,-5
Tcam1,3,8,231,242,-5
Fbn2,0,5,237,242,-5
Vcan,4,9,229,242,-5
Rxfp1,2,7,233,242,-5
Ruvbl2,5,10,227,242,-5
Cacna2d4,0,5,237,242,-5
Cacna1s,0,5,237,242,-5
Vegfb,2,7,233,242,-5
Runx3,3,8,231,242,-5
Veph1,2,7,233,242,-5
Lpcat2b,0,5,237,242,-5
Tceanc,3,8,231,242,-5
Fem1b,2,7,233,242,-5
Vash2,0,5,237,242,-5
Utp14b,3,8,231,242,-5
Vamp8,6,11,225,242,-5
Capza2,4,9,229,242,-5
Uxt,6,11,225,242,-5
Fitm1,6,11,225,242,-5
Lhx5,0,5,237,242,-5
Fanca,2,7,233,242,-5
Lig3,2,7,233,242,-5
Fhod3,2,7,233,242,-5
Vamp3,3,8,231,242,-5
Fhl5,4,9,229,242,-5
Tctn3,1,6,235,242,-5
Lims1,3,8,231,242,-5
Fbln5,3,8,231,242,-5
Fggy,10,15,217,242,-5
Fancg,1,6,235,242,-5
Tcp11l1,1,6,235,242,-5
Far1,2,7,233,242,-5
Farsb,3,8,231,242,-5
Tbc1d9b,3,8,231,242,-5
Fastkd2,3,8,231,242,-5
S1pr3,2,7,233,242,-5
Fat3,0,5,237,242,-5
Fev,0,5,237,242,-5
Kmt2b,2,7,233,242,-5
Tamm41,2,7,233,242,-5
Fam205a1,4,9,229,242,-5
Cd300ld4,9,14,219,242,-5
Gdi2,3,8,231,242,-5
Gdf7,2,7,233,242,-5
Sel1l2,1,6,235,242,-5
Faiml,6,11,225,242,-5
Cd3d,12,17,213,242,-5
Kcnh7,0,5,237,242,-5
Fam110a,1,6,235,242,-5
Fam110b,1,6,235,242,-5
Gbp4,8,13,221,242,-5
Cd300lg,7,12,223,242,-5
Sec31a,4,9,229,242,-5
Cd52,15,20,207,242,-5
Fam114a2,2,7,233,242,-5
Kcnj3,0,5,237,242,-5
Sec24b,3,8,231,242,-5
Kcnj4,2,7,233,242,-5
Kcnk10,2,7,233,242,-5
Sec16a,2,7,233,242,-5
Cd177,3,8,231,242,-5
Ubxn1,3,8,231,242,-5
Sec14l2,2,7,233,242,-5
Kctd1,3,8,231,242,-5
Ubl5,6,11,225,242,-5
Fabp7,9,14,219,242,-5
Klrb1c,7,12,223,242,-5
Kat14,3,8,231,242,-5
Cdc37l1,4,9,229,242,-5
Ube2j1,5,10,227,242,-5
Jmjd1c,2,7,233,242,-5
Ube2l6,5,10,227,242,-5
Jph4,0,5,237,242,-5
Ezh1,2,7,233,242,-5
Jpt1,3,8,231,242,-5
Cdc25b,3,8,231,242,-5
Jrkl,3,8,231,242,-5
Kank3,3,8,231,242,-5
Kat2a,2,7,233,242,-5
Kbtbd4,2,7,233,242,-5
Fabp1,14,19,209,242,-5
Ube2r2,2,7,233,242,-5
Ube2s,3,8,231,242,-5
Cdc14b,2,7,233,242,-5
Sema3d,0,5,237,242,-5
Ube2v2,4,9,229,242,-5
Cd96,3,8,231,242,-5
Cd8a,6,11,225,242,-5
Syt17,20,25,197,242,-5
Kbtbd3,3,8,231,242,-5
Fam126b,5,10,227,242,-5
Ubxn11,4,9,229,242,-5
Kctd2,3,8,231,242,-5
G3bp1,2,7,233,242,-5
Taf2,2,7,233,242,-5
Klb,3,8,231,242,-5
Fam160a2,2,7,233,242,-5
Fam170a,1,6,235,242,-5
Ccdc34,2,7,233,242,-5
Ccdc32,3,8,231,242,-5
Ccdc192,5,10,227,242,-5
Unc80,0,5,237,242,-5
Klhl10,2,7,233,242,-5
Ccdc191,3,8,231,242,-5
Taf7l2,0,5,237,242,-5
Gapdh,3,8,231,242,-5
Ccdc189,2,7,233,242,-5
Tesl1,1,6,235,242,-5
Klhl35,7,12,223,242,-5
Fzr1,4,9,229,242,-5
Fzd10,0,5,237,242,-5
Fyttd1,3,8,231,242,-5
Klk4,0,5,237,242,-5
Fxr2,2,7,233,242,-5
Klra4,4,9,229,242,-5
Klrb1,2,7,233,242,-5
Gabra5,2,7,233,242,-5
Uhrf2,2,7,233,242,-5
Kiss1,8,13,221,242,-5
Taf12,4,9,229,242,-5
Sdr39u1,7,12,223,242,-5
Galnt9,3,8,231,242,-5
Ccp110,2,7,233,242,-5
Tex24,0,5,237,242,-5
Tab3,6,11,225,242,-5
Tac1,4,9,229,242,-5
Galnt17,0,5,237,242,-5
Galnt16,10,15,217,242,-5
Ucp1,9,14,219,242,-5
Keap1,3,8,231,242,-5
Sdhaf1,2,7,233,242,-5
Tacc3,2,7,233,242,-5
Ufd1,4,9,229,242,-5
Ccn4,2,7,233,242,-5
Kif1c,2,7,233,242,-5
Tada1,2,7,233,242,-5
Ccdc90b,4,9,229,242,-5
Ccdc9,5,10,227,242,-5
Kif2a,4,9,229,242,-5
Tada2b,2,7,233,242,-5
Gad1,1,6,235,242,-5
Igkv9-120,8,13,221,242,-5
Dgkq,3,8,231,242,-5
Entpd5,2,7,233,242,-5
Dsg1b,4,9,229,242,-5
Csnk1g2,3,8,231,242,-5
Gm8906,5,10,227,242,-5
Spopfm1,1,6,235,242,-5
Sppl2a,2,7,233,242,-5
Slfn2,7,12,223,242,-5
Gm30083,0,5,237,242,-5
Slf2,2,7,233,242,-5
Tmem242,2,7,233,242,-5
Cryba1,7,12,223,242,-5
Rufy2,8,13,221,242,-5
Drc7,1,6,235,242,-5
Drd5,0,5,237,242,-5
Crtap,5,10,227,242,-5
Cep20,2,7,233,242,-5
Crp,9,14,219,242,-5
Trav6n-5,1,6,235,242,-5
Sprr4,2,7,233,242,-5
Gm28845,8,13,221,242,-5
Creb1,3,8,231,242,-5
Gnpat,2,7,233,242,-5
Tmem214,3,8,231,242,-5
Slc9a1,2,7,233,242,-5
Crb2,1,6,235,242,-5
Gm28635,11,16,215,242,-5
Gm28510,1,6,235,242,-5
Crb1,0,5,237,242,-5
Dph1,2,7,233,242,-5
Dpagt1,2,7,233,242,-5
Trav14d-2,10,15,217,242,-5
Dolpp1,2,7,233,242,-5
Cwc27,3,8,231,242,-5
Gm8104,5,10,227,242,-5
Spice1,2,7,233,242,-5
Dnajc2,3,8,231,242,-5
Dnajc24,3,8,231,242,-5
Dnajc25,2,7,233,242,-5
Ctxn1,3,8,231,242,-5
Tmem63c,4,9,229,242,-5
Gm8212,3,8,231,242,-5
Gm8220,12,17,213,242,-5
Ctps,3,8,231,242,-5
Gm3278,3,8,231,242,-5
Smarce1,3,8,231,242,-5
Dnajc7,2,7,233,242,-5
Gm3269,0,5,237,242,-5
Ctcfl,7,12,223,242,-5
Dnph1,3,8,231,242,-5
Ctcf,2,7,233,242,-5
Smarca5,2,7,233,242,-5
Tmem40,6,11,225,242,-5
Smad6,3,8,231,242,-5
Spns2,4,9,229,242,-5
Spo11,1,6,235,242,-5
Csrp3,10,15,217,242,-5
Sly,7,12,223,242,-5
Spsb4,3,8,231,242,-5
Got1l1,11,16,215,242,-5
Cpsf6,4,9,229,242,-5
Gpr26,0,5,237,242,-5
Gpr37,1,6,235,242,-5
Dync1li2,2,7,233,242,-5
Slc4a5,1,6,235,242,-5
Srgap2,2,7,233,242,-5
Gpx2,5,10,227,242,-5
Slc46a2,1,6,235,242,-5
Tmem192,2,7,233,242,-5
Grap,4,9,229,242,-5
Dynlt1c,2,7,233,242,-5
Dynlt2a1,30,35,177,242,-5
Col22a1,5,10,227,242,-5
Gm21761,4,9,229,242,-5
E030030I06Rik,5,10,227,242,-5
Trerf1,0,5,237,242,-5
Col19a1,3,8,231,242,-5
E130116L18Rik,21,26,195,242,-5
E130218I03Rik,9,14,219,242,-5
Grip2,4,9,229,242,-5
Slc3a1,7,12,223,242,-5
Gm21650,0,5,237,242,-5
Col10a1,2,7,233,242,-5
Grm5,0,5,237,242,-5
Grxcr1,0,5,237,242,-5
Slc39a14,3,8,231,242,-5
Cog4,3,8,231,242,-5
Dync1i2,2,7,233,242,-5
Cops5,2,7,233,242,-5
Gpat4,3,8,231,242,-5
Gpr173,0,5,237,242,-5
Cpped1,3,8,231,242,-5
Cpne1,5,10,227,242,-5
Cpb2,2,7,233,242,-5
Gpatch4,3,8,231,242,-5
Cox7a2l,2,7,233,242,-5
Sptb,0,5,237,242,-5
Gm28305,23,28,191,242,-5
Tmem211,1,6,235,242,-5
Gpd2,2,7,233,242,-5
Dtymk,2,7,233,242,-5
Duox1,0,5,237,242,-5
Gpr107,2,7,233,242,-5
Slc6a12,13,18,211,242,-5
Slc6a11,1,6,235,242,-5
Gm28038,19,24,199,242,-5
Dus2,2,7,233,242,-5
Dusp10,2,7,233,242,-5
Dusp19,6,11,225,242,-5
Gpr141b,0,5,237,242,-5
Gpr155,2,7,233,242,-5
Tmem200a,9,14,219,242,-5
Dym,2,7,233,242,-5
Gpr160,9,14,219,242,-5
Tmem198b,3,8,231,242,-5
Gm21983,6,11,225,242,-5
Dnajc19,2,7,233,242,-5
Cwf19l1,2,7,233,242,-5
Cxadr,4,9,229,242,-5
Snx4,2,7,233,242,-5
Tomt,2,7,233,242,-5
Decr1,4,9,229,242,-5
Spag1,4,9,229,242,-5
Gm50253,5,10,227,242,-5
Snx24,6,11,225,242,-5
Gm42688,2,7,233,242,-5
Ddx55,1,6,235,242,-5
Snx15,2,7,233,242,-5
Dhx33,5,10,227,242,-5
Ddx42,2,7,233,242,-5
Snx11,3,8,231,242,-5
Ddx31,2,7,233,242,-5
Snurf,13,18,211,242,-5
Gm5142,2,7,233,242,-5
Dhx8,3,8,231,242,-5
Sntn,0,5,237,242,-5
Tox4,2,7,233,242,-5
Sntb2,2,7,233,242,-5
Ddx1,3,8,231,242,-5
Ddt,4,9,229,242,-5
Ddrgk1,2,7,233,242,-5
Spag6l,1,6,235,242,-5
Tnfrsf22,2,7,233,242,-5
Dimt1,5,10,227,242,-5
Tpgs1,2,7,233,242,-5
Gm49630,4,9,229,242,-5
Gm49510,14,19,209,242,-5
Spata17,6,11,225,242,-5
Snx8,3,8,231,242,-5
Tnk2,4,9,229,242,-5
Dgcr8,3,8,231,242,-5
Gm45692,10,15,217,242,-5
Sox15,9,14,219,242,-5
Gm45753,0,5,237,242,-5
Gm45783,16,21,205,242,-5
Tnp2,16,21,205,242,-5
Gm4707,28,33,181,242,-5
Sostdc1,2,7,233,242,-5
Dhrs1,2,7,233,242,-5
Sp8,0,5,237,242,-5
Dennd2c,0,5,237,242,-5
Dennd1a,5,10,227,242,-5
Gm4922,3,8,231,242,-5
Tollip,2,7,233,242,-5
Tomm20,3,8,231,242,-5
Sod2,2,7,233,242,-5
Gm49337,17,22,203,242,-5
Defb33,0,5,237,242,-5
Spaca3,2,7,233,242,-5
Gm49359,5,10,227,242,-5
Gm49387,7,12,223,242,-5
Gm49391,18,23,201,242,-5
Gm49395,27,32,183,242,-5
Gm49396,5,10,227,242,-5
Dis3,2,7,233,242,-5
Snrnp70,3,8,231,242,-5
Cxcl15,3,8,231,242,-5
Gm6408,5,10,227,242,-5
Tmprss11b,1,6,235,242,-5
Dnah5,0,5,237,242,-5
Spdye4c,7,12,223,242,-5
Dnai2,5,10,227,242,-5
D3Ertd751e,4,9,229,242,-5
Smpdl3b,2,7,233,242,-5
Gm35060,8,13,221,242,-5
D130043K22Rik,1,6,235,242,-5
D10Wsu102e,0,5,237,242,-5
Spef1,3,8,231,242,-5
Cyrib,4,9,229,242,-5
Spef2,2,7,233,242,-5
Tmem86b,4,9,229,242,-5
Gm7073,0,5,237,242,-5
Traj31,1,6,235,242,-5
Spen,2,7,233,242,-5
Gm7347,5,10,227,242,-5
Cyp2w1,1,6,235,242,-5
Tmem72,4,9,229,242,-5
Dnajc15,4,9,229,242,-5
Spi1,8,13,221,242,-5
Cybrd1,1,6,235,242,-5
Cyb5rl,4,9,229,242,-5
Cyb5r2,5,10,227,242,-5
Smim19,4,9,229,242,-5
Dnaaf6b,1,6,235,242,-5
Smug1,2,7,233,242,-5
Dctn1,2,7,233,242,-5
Spcs1,4,9,229,242,-5
Snrnp35,2,7,233,242,-5
Dcps,2,7,233,242,-5
Tnfrsf13b,5,10,227,242,-5
Gm3727,1,6,235,242,-5
Dixdc1,2,7,233,242,-5
Tpmt,4,9,229,242,-5
Dclre1b,3,8,231,242,-5
Dkc1,4,9,229,242,-5
Dlgap2,0,5,237,242,-5
Dclk1,4,9,229,242,-5
Dlx3,5,10,227,242,-5
Dcdc2c,8,13,221,242,-5
Tmtc4,2,7,233,242,-5
Dcaf5,2,7,233,242,-5
Dmac1,3,8,231,242,-5
Dmac2,4,9,229,242,-5
Snapc4,3,8,231,242,-5
Dcaf12,2,7,233,242,-5
Tmsb4x,5,10,227,242,-5
Dbi,4,9,229,242,-5
Gm597,0,5,237,242,-5
Daw1,4,9,229,242,-5
Tmprss15,0,5,237,242,-5
Dapp1,3,8,231,242,-5
Dapk3,3,8,231,242,-5
Gm21637,1,6,235,242,-5
Slc39a1,7,12,223,242,-5
Cog3,2,7,233,242,-5
Skint4,0,5,237,242,-5
Hps1,2,7,233,242,-5
Gm17018,3,8,231,242,-5
Chchd4,2,7,233,242,-5
Cgref1,6,11,225,242,-5
Tspyl3,1,6,235,242,-5
Hrh3,2,7,233,242,-5
Cga,6,11,225,242,-5
Hrob,3,8,231,242,-5
Six1,0,5,237,242,-5
Siva1,2,7,233,242,-5
Hsbp1,2,7,233,242,-5
Cfl1,4,9,229,242,-5
Stk4,3,8,231,242,-5
Gm16286,3,8,231,242,-5
Sirpb1c,4,9,229,242,-5
Hsf2,4,9,229,242,-5
Hsf5,1,6,235,242,-5
Gm16223,2,7,233,242,-5
Sipa1,3,8,231,242,-5
Cfap73,8,13,221,242,-5
Cfap65,1,6,235,242,-5
Htr1f,0,5,237,242,-5
Siglech,4,9,229,242,-5
Htr2a,3,8,231,242,-5
Cfap57,1,6,235,242,-5
Stk33,4,9,229,242,-5
Eif2b1,4,9,229,242,-5
Tm2d2,2,7,233,242,-5
Hoxa3,8,13,221,242,-5
Tshb,10,15,217,242,-5
Chrm4,4,9,229,242,-5
Hmgcr,2,7,233,242,-5
Gm17660,10,15,217,242,-5
Slc10a7,1,6,235,242,-5
Eif1ad19,6,11,225,242,-5
Hmgcs1,2,7,233,242,-5
Tshz3,0,5,237,242,-5
Gm17654,3,8,231,242,-5
Hmgxb4,5,10,227,242,-5
Slc10a2,3,8,231,242,-5
Tmbim4,5,10,227,242,-5
Hmox2,3,8,231,242,-5
Chmp4b,3,8,231,242,-5
Chmp2a,2,7,233,242,-5
Hnrnpd,3,8,231,242,-5
Gm17604,27,32,183,242,-5
Gm17555,11,16,215,242,-5
Hnrnph1,3,8,231,242,-5
Stk17b,2,7,233,242,-5
Chid1,2,7,233,242,-5
Tma16,2,7,233,242,-5
Eif2ak2,2,7,233,242,-5
Skint8,0,5,237,242,-5
Hoxa2,2,7,233,242,-5
Ttc21b,2,7,233,242,-5
Gm15128,5,10,227,242,-5
Tmc7,2,7,233,242,-5
Emilin3,3,8,231,242,-5
Stx1a,4,9,229,242,-5
Ces1h,1,6,235,242,-5
Ift81,7,12,223,242,-5
Tirap,3,8,231,242,-5
Igbp1b,0,5,237,242,-5
Stx2,3,8,231,242,-5
Sh3d21,3,8,231,242,-5
Ighv1-47,4,9,229,242,-5
Gm14124,3,8,231,242,-5
Ighv1-52,3,8,231,242,-5
Ighv1-56,2,7,233,242,-5
Sh3bp1,4,9,229,242,-5
Tiprl,4,9,229,242,-5
Ighv1-7,4,9,229,242,-5
Enho,2,7,233,242,-5
Ttyh1,7,12,223,242,-5
Ighv11-2,4,9,229,242,-5
Tub,8,13,221,242,-5
Tuba1b,4,9,229,242,-5
Cep57,2,7,233,242,-5
Gm1330,1,6,235,242,-5
Tuba8,1,6,235,242,-5
Igkv3-9,3,8,231,242,-5
Igkv4-50,6,11,225,242,-5
Cep295,6,11,225,242,-5
Ift46,3,8,231,242,-5
Sh3tc2,4,9,229,242,-5
Gm15114,2,7,233,242,-5
Eme1,1,6,235,242,-5
Iapp,5,10,227,242,-5
Cfap36,3,8,231,242,-5
Shprh,3,8,231,242,-5
Stpg1,2,7,233,242,-5
Shoc2,2,7,233,242,-5
Eif4enif1,2,7,233,242,-5
Tlr7,9,14,219,242,-5
Eif4g3,2,7,233,242,-5
Cfap298,4,9,229,242,-5
Cfap221,5,10,227,242,-5
Idh3g,5,10,227,242,-5
Gm14443,0,5,237,242,-5
Elfn2,0,5,237,242,-5
Ttc39d,3,8,231,242,-5
Ifi202b,6,11,225,242,-5
Ttc6,3,8,231,242,-5
Ifit2,7,12,223,242,-5
Ifit3,12,17,213,242,-5
Strn4,2,7,233,242,-5
Ttc9b,2,7,233,242,-5
Ttc9c,3,8,231,242,-5
Ttf2,2,7,233,242,-5
Tti1,3,8,231,242,-5
Elovl6,2,7,233,242,-5
Emc2,3,8,231,242,-5
Hmga1b,25,30,187,242,-5
Stau1,3,8,231,242,-5
Gm21627,1,6,235,242,-5
Slc30a7,2,7,233,242,-5
Gm20909,1,6,235,242,-5
Slc30a3,7,12,223,242,-5
Sstr3,4,9,229,242,-5
Eapp,2,7,233,242,-5
Gm20897,2,7,233,242,-5
H1f10,5,10,227,242,-5
Cnga4,1,6,235,242,-5
Cnbd2,2,7,233,242,-5
Gm20890,0,5,237,242,-5
Cmya5,0,5,237,242,-5
Trim37,2,7,233,242,-5
Ebf2,1,6,235,242,-5
Ecel1,2,7,233,242,-5
Clrn1,6,11,225,242,-5
H2ac18,7,12,223,242,-5
Clmp,0,5,237,242,-5
Ssxb10,8,13,221,242,-5
Ecsit,4,9,229,242,-5
Clic4,2,7,233,242,-5
H2al1m,26,31,185,242,-5
Clec4f,0,5,237,242,-5
H2bc11,19,24,199,242,-5
Slc25a44,2,7,233,242,-5
Triqk,6,11,225,242,-5
H3f3b,3,8,231,242,-5
Gulp1,6,11,225,242,-5
Gtpbp8,3,8,231,242,-5
Hacd3,4,9,229,242,-5
Cnot6l,8,13,221,242,-5
Gsdma2,0,5,237,242,-5
Srsf3,3,8,231,242,-5
Gsdmc2,3,8,231,242,-5
Gsdmd,4,9,229,242,-5
Srsf7,4,9,229,242,-5
Tmem167b,2,7,233,242,-5
Gm21440,1,6,235,242,-5
Gstcd,3,8,231,242,-5
Gstm7,10,15,217,242,-5
Cntrob,1,6,235,242,-5
Cntnap5c,0,5,237,242,-5
Sry,1,6,235,242,-5
Gm21411,12,17,213,242,-5
Cntn5,0,5,237,242,-5
Ss18l2,5,10,227,242,-5
Ssbp2,5,10,227,242,-5
Slc35g3,4,9,229,242,-5
Gm21294,1,6,235,242,-5
Gtf2e2,3,8,231,242,-5
Slc35f2,7,12,223,242,-5
Trim15,4,9,229,242,-5
Gtf3c4,2,7,233,242,-5
Trim16,2,7,233,242,-5
Cnot7,3,8,231,242,-5
Gtf3c6,2,7,233,242,-5
Edem3,2,7,233,242,-5
Hacd4,2,7,233,242,-5
Gm2030,2,7,233,242,-5
Hdgfl1,1,6,235,242,-5
Ciz1,3,8,231,242,-5
Hdlbp,2,7,233,242,-5
Stambp,5,10,227,242,-5
Hells,3,8,231,242,-5
Efcab14,2,7,233,242,-5
Hemk1,3,8,231,242,-5
Star,6,11,225,242,-5
Gm20662,23,28,191,242,-5
Ciao2a,2,7,233,242,-5
Herc3,4,9,229,242,-5
Slc18b1,9,14,219,242,-5
Efemp2,4,9,229,242,-5
Hey2,4,9,229,242,-5
Tmco5b,0,5,237,242,-5
Chtf8,5,10,227,242,-5
Chsy1,2,7,233,242,-5
Chst5,0,5,237,242,-5
Slc16a7,5,10,227,242,-5
Chst10,5,10,227,242,-5
Higd1a,2,7,233,242,-5
Hinfp,3,8,231,242,-5
Hipk1,3,8,231,242,-5
Tsg101,3,8,231,242,-5
Slc13a4,2,7,233,242,-5
Stat5b,2,7,233,242,-5
Ckap2,5,10,227,242,-5
Hdgf,2,7,233,242,-5
Cldn34d,1,6,235,242,-5
Slc22a3,0,5,237,242,-5
Gm20850,0,5,237,242,-5
Cldn34b4,3,8,231,242,-5
Gm20843,0,5,237,242,-5
Slc25a26,3,8,231,242,-5
Hapln1,0,5,237,242,-5
Trmt13,3,8,231,242,-5
Cldn34a,1,6,235,242,-5
Cldn24,10,15,217,242,-5
Eea1,3,8,231,242,-5
Eef1a1,6,11,225,242,-5
Gm20820,1,6,235,242,-5
Slc25a15,6,11,225,242,-5
Gm20817,1,6,235,242,-5
Eef1akmt2,2,7,233,242,-5
Eef1akmt4,4,9,229,242,-5
Slc25a11,3,8,231,242,-5
Trp53i13,3,8,231,242,-5
Tmem123,4,9,229,242,-5
St8sia4,0,5,237,242,-5
Efcab1,0,5,237,242,-5
Trp53rka,2,7,233,242,-5
Tmem115,3,8,231,242,-5
Hdac11,6,11,225,242,-5
Tmem109,2,7,233,242,-5
Hdac6,6,11,225,242,-5
Eif2b5,3,8,231,242,-5
Klra1,1,6,235,242,-5
Vhl,3,8,231,242,-5
Xpo5,2,7,233,242,-5
Nin,9,14,219,242,-5
Ninl,4,9,229,242,-5
Nipbl,3,8,231,242,-5
Nipsnap1,5,10,227,242,-5
Nipsnap2,7,12,223,242,-5
Rab35,3,8,231,242,-5
Nisch,4,9,229,242,-5
Nkain4,11,16,215,242,-5
Rab2b,5,10,227,242,-5
Agpat2,5,10,227,242,-5
Yars2,3,8,231,242,-5
Nkx2-4,4,9,229,242,-5
Ybx1,5,10,227,242,-5
Nkx2-6,0,5,237,242,-5
Nlgn2,2,7,233,242,-5
Ydjc,3,8,231,242,-5
Rab14,3,8,231,242,-5
Yes1,4,9,229,242,-5
Nlrp9c,2,7,233,242,-5
Rab11fip2,2,7,233,242,-5
Yif1a,3,8,231,242,-5
Nme3,5,10,227,242,-5
R3hcc1l,2,7,233,242,-5
Noct,3,8,231,242,-5
Ypel5,6,11,225,242,-5
Nop56,4,9,229,242,-5
Afg1l,2,7,233,242,-5
Pyy,7,12,223,242,-5
Npas1,3,8,231,242,-5
Rab4b,3,8,231,242,-5
Rab5b,2,7,233,242,-5
Ramp2,8,13,221,242,-5
Nfya,3,8,231,242,-5
Wrn,2,7,233,242,-5
Alg14,9,14,219,242,-5
Ralgps2,4,9,229,242,-5
Ralgapa2,2,7,233,242,-5
Ndufs1,3,8,231,242,-5
Rala,6,11,225,242,-5
Ndufs7,5,10,227,242,-5
Aldh7a1,4,9,229,242,-5
Radil,9,14,219,242,-5
Rad9b,3,8,231,242,-5
Aldh6a1,7,12,223,242,-5
Aldh16a1,4,9,229,242,-5
Nedd1,5,10,227,242,-5
Nedd8,2,7,233,242,-5
Albfm1,0,5,237,242,-5
Alad,3,8,231,242,-5
Aktip,2,7,233,242,-5
Nek3,1,6,235,242,-5
Akp3,0,5,237,242,-5
Xkr8,2,7,233,242,-5
Rack1,4,9,229,242,-5
Akap11,3,8,231,242,-5
Akap1,4,9,229,242,-5
Ak9,4,9,229,242,-5
Neurod4,0,5,237,242,-5
Rab9b,1,6,235,242,-5
Aipl1,1,6,235,242,-5
Rab7,3,8,231,242,-5
Nfx1,3,8,231,242,-5
Adra2c,2,7,233,242,-5
Npdc1,2,7,233,242,-5
Adra1d,6,11,225,242,-5
Npm3,3,8,231,242,-5
Ntm,5,10,227,242,-5
Ntpcr,5,10,227,242,-5
Ptpmt1,2,7,233,242,-5
Adam2,1,6,235,242,-5
Nubpl,2,7,233,242,-5
Adam12,2,7,233,242,-5
Ptk6,2,7,233,242,-5
Ptk2,4,9,229,242,-5
Nudt1,5,10,227,242,-5
Adam10,6,11,225,242,-5
Zcchc24,4,9,229,242,-5
Nup160,4,9,229,242,-5
Acvrl1,6,11,225,242,-5
Zcrb1,4,9,229,242,-5
Nup214,2,7,233,242,-5
Ptger1,3,8,231,242,-5
Zdhhc1,3,8,231,242,-5
Nup54,4,9,229,242,-5
Nup85,2,7,233,242,-5
Actr1b,2,7,233,242,-5
Nusap1,5,10,227,242,-5
Ptchd3,0,5,237,242,-5
Nxn,2,7,233,242,-5
Actn4,2,7,233,242,-5
Nxpe4,3,8,231,242,-5
Oas3,2,7,233,242,-5
Pspc1,2,7,233,242,-5
Zdhhc5,3,8,231,242,-5
Psmg4,2,7,233,242,-5
Nthl1,5,10,227,242,-5
Zc3h8,3,8,231,242,-5
Ntan1,3,8,231,242,-5
Nr3c2,4,9,229,242,-5
Pxylp1,5,10,227,242,-5
Nprl3,3,8,231,242,-5
Adh7,2,7,233,242,-5
Nptx2,0,5,237,242,-5
Adgrl2,4,9,229,242,-5
Zbed4,3,8,231,242,-5
Adgrb3,1,6,235,242,-5
Adgra1,0,5,237,242,-5
Zbtb17,3,8,231,242,-5
Nr2c2,2,7,233,242,-5
Adck1,2,7,233,242,-5
Zbtb26,4,9,229,242,-5
Pus7,4,9,229,242,-5
Adamts6,1,6,235,242,-5
Zc3h4,2,7,233,242,-5
Nradd,4,9,229,242,-5
Adamts20,0,5,237,242,-5
Zbtb49,3,8,231,242,-5
Adam5,2,7,233,242,-5
Adam34,1,6,235,242,-5
Nrip2,4,9,229,242,-5
Adam29,0,5,237,242,-5
Zc2hc1c,7,12,223,242,-5
Ptprm,2,7,233,242,-5
Zc3h11a,4,9,229,242,-5
Ptpn9,3,8,231,242,-5
Ptpn6,12,17,213,242,-5
Zc3h3,3,8,231,242,-5
Ndufb3,4,9,229,242,-5
Alms1,2,7,233,242,-5
Asah2,7,12,223,242,-5
Rfc5,3,8,231,242,-5
Ms4a19,1,6,235,242,-5
Vps8,4,9,229,242,-5
Arfip2,2,7,233,242,-5
Rex2,6,11,225,242,-5
Ms4a7,9,14,219,242,-5
Retreg2,2,7,233,242,-5
Msantd2,4,9,229,242,-5
Vsig1,0,5,237,242,-5
Rer1,2,7,233,242,-5
Arcn1,2,7,233,242,-5
Aqr,2,7,233,242,-5
Aqp1,6,11,225,242,-5
Vti1a,2,7,233,242,-5
mt-Nd3,10,15,217,242,-5
Apool,6,11,225,242,-5
Rel,1,6,235,242,-5
Vwa3b,5,10,227,242,-5
Vwa5a,5,10,227,242,-5
Mtch2,3,8,231,242,-5
Reep5,2,7,233,242,-5
Apcdd1,3,8,231,242,-5
Apc2,5,10,227,242,-5
Apba3,3,8,231,242,-5
Apba1,1,6,235,242,-5
Rdm1,10,15,217,242,-5
Ap5m1,5,10,227,242,-5
Mtg2,4,9,229,242,-5
Ap3m2,0,5,237,242,-5
Washc3,7,12,223,242,-5
Arhgap23,3,8,231,242,-5
Rffl,3,8,231,242,-5
Ranbp3l,3,8,231,242,-5
Mrps35,6,11,225,242,-5
Rhog,5,10,227,242,-5
Mras,3,8,231,242,-5
Mrgprb3,0,5,237,242,-5
Arrdc1,8,13,221,242,-5
Arpp19,5,10,227,242,-5
Rhbdl2,6,11,225,242,-5
Mrpl1,2,7,233,242,-5
Mrpl10,2,7,233,242,-5
Armcx2,5,10,227,242,-5
Armc8,2,7,233,242,-5
Mrpl15,5,10,227,242,-5
Mrpl17,2,7,233,242,-5
Mrpl21,4,9,229,242,-5
Mrpl36,3,8,231,242,-5
Arl2bp,2,7,233,242,-5
Rgs13,1,6,235,242,-5
Arl10,5,10,227,242,-5
Mrpl55,2,7,233,242,-5
Arhgef9,6,11,225,242,-5
Mrpl58,3,8,231,242,-5
Mrpl9,2,7,233,242,-5
Mrps18a,2,7,233,242,-5
Mrps21,5,10,227,242,-5
Vps35l,2,7,233,242,-5
Rfx3,1,6,235,242,-5
Arhgef11,2,7,233,242,-5
Rft1,3,8,231,242,-5
Mrps30,2,7,233,242,-5
Mrps31,2,7,233,242,-5
Ap1m1,2,7,233,242,-5
Mto1,3,8,231,242,-5
Rcor2,2,7,233,242,-5
Rcor1,2,7,233,242,-5
Nap1l2,1,6,235,242,-5
Rassf9,2,7,233,242,-5
Ankrd17,2,7,233,242,-5
Ankrd13d,2,7,233,242,-5
Napb,1,6,235,242,-5
Rassf3,3,8,231,242,-5
Wfdc1,5,10,227,242,-5
Wfdc12,8,13,221,242,-5
Wfdc16,4,9,229,242,-5
Ank1,4,9,229,242,-5
Angptl7,2,7,233,242,-5
Ncapd2,1,6,235,242,-5
Angpt1,4,9,229,242,-5
Ang5,2,7,233,242,-5
Ncaph,2,7,233,242,-5
Anapc15-ps,24,29,189,242,-5
Anapc1,2,7,233,242,-5
Ncoa4,2,7,233,242,-5
Ampd2,2,7,233,242,-5
Ncr1,2,7,233,242,-5
Amn,4,9,229,242,-5
Amer1,4,9,229,242,-5
Ndfip2,5,10,227,242,-5
Amd1,2,7,233,242,-5
Ndufa4l2,12,17,213,242,-5
Ndufa8,3,8,231,242,-5
Als2cl,4,9,229,242,-5
Wnt7a,1,6,235,242,-5
Ranbp6,2,7,233,242,-5
Ankrd22,5,10,227,242,-5
Naif1,1,6,235,242,-5
Ankrd36,2,7,233,242,-5
Wdr35,3,8,231,242,-5
Rcn3,2,7,233,242,-5
Rcn1,5,10,227,242,-5
Rcl1,3,8,231,242,-5
Mtrr,4,9,229,242,-5
Mttp,4,9,229,242,-5
Rbsn,2,7,233,242,-5
Mup19,7,12,223,242,-5
Ano10,3,8,231,242,-5
Wdr24,2,7,233,242,-5
Rbmxl1,5,10,227,242,-5
Wdr27,4,9,229,242,-5
Rbmx,6,11,225,242,-5
Mybl1,4,9,229,242,-5
Rbm7,3,8,231,242,-5
Ankrd39,1,6,235,242,-5
Wdr36,2,7,233,242,-5
Wdr41,2,7,233,242,-5
Myl9,8,13,221,242,-5
Wdr44,6,11,225,242,-5
Myo5a,5,10,227,242,-5
Myo7a,9,14,219,242,-5
Myoz3,1,6,235,242,-5
Ankrd50,2,7,233,242,-5
Mysm1,2,7,233,242,-5
Mzf1,0,5,237,242,-5
Rbm15b,2,7,233,242,-5
Rbm12b1,4,9,229,242,-5
Rbl1,1,6,235,242,-5
Obox8,1,6,235,242,-5
Odad2,3,8,231,242,-5
Psme2,6,11,225,242,-5
Pde5a,1,6,235,242,-5
Pde8a,3,8,231,242,-5
Pde8b,3,8,231,242,-5
Zfp933,3,8,231,242,-5
Pdlim1,5,10,227,242,-5
Ppia,4,9,229,242,-5
Pdlim7,2,7,233,242,-5
Pdpk1,4,9,229,242,-5
Pdss2,2,7,233,242,-5
4930402K13Rik,1,6,235,242,-5
Peak1,2,7,233,242,-5
4930402F06Rik,6,11,225,242,-5
Pebp1,3,8,231,242,-5
Zfp951,2,7,233,242,-5
4921524L21Rik,0,5,237,242,-5
Pelp1,4,9,229,242,-5
Pemt,7,12,223,242,-5
Perm1,4,9,229,242,-5
Pet100,4,9,229,242,-5
Pex1,3,8,231,242,-5
Zfp955a,6,11,225,242,-5
Pex10,2,7,233,242,-5
Pex7,2,7,233,242,-5
Pfas,4,9,229,242,-5
Zfp970,8,13,221,242,-5
2810408A11Rik,3,8,231,242,-5
2700097O09Rik,7,12,223,242,-5
2700062C07Rik,2,7,233,242,-5
Pfkp,4,9,229,242,-5
Pfn4,7,12,223,242,-5
Ppl,3,8,231,242,-5
Zfp865,2,7,233,242,-5
Odad4,2,7,233,242,-5
Zfp825,5,10,227,242,-5
Ppwd1,2,7,233,242,-5
Zfp707,3,8,231,242,-5
Ppp4r3a,2,7,233,242,-5
Patz1,5,10,227,242,-5
Pax1,0,5,237,242,-5
4932411N23Rik,3,8,231,242,-5
Ppp2r5e,4,9,229,242,-5
Paxip1,2,7,233,242,-5
Pbld2,6,11,225,242,-5
4931406C07Rik,2,7,233,242,-5
Zfp748,3,8,231,242,-5
Zfp760,7,12,223,242,-5
Pcdh10,0,5,237,242,-5
4930590J08Rik,1,6,235,242,-5
Pcdhb12,2,7,233,242,-5
Pcdhb9,3,8,231,242,-5
Pcdhga1,3,8,231,242,-5
Pcdhga12,4,9,229,242,-5
Zfp772,2,7,233,242,-5
Ppp1r21,2,7,233,242,-5
Zfp780b,2,7,233,242,-5
Ppp1r1b,4,9,229,242,-5
4930578I06Rik,0,5,237,242,-5
Pcmt1,2,7,233,242,-5
Pcmtd1,8,13,221,242,-5
4930564D02Rik,1,6,235,242,-5
Ppp1r14c,1,6,235,242,-5
Pcyox1,5,10,227,242,-5
Pdc,2,7,233,242,-5
2610001J05Rik,4,9,229,242,-5
Zfp994,3,8,231,242,-5
Zfp995,3,8,231,242,-5
Zfpl1,4,9,229,242,-5
Pik3c3,2,7,233,242,-5
1700049E17Rik1,3,8,231,242,-5
1700037C18Rik,4,9,229,242,-5
Pik3r5,1,6,235,242,-5
Pilra,4,9,229,242,-5
Znhit6,2,7,233,242,-5
Pnkd,2,7,233,242,-5
Znrf1,2,7,233,242,-5
Pitpnb,2,7,233,242,-5
Pkd1l3,2,7,233,242,-5
1700017N19Rik,2,7,233,242,-5
Zrsr1,2,7,233,242,-5
Pm20d1,4,9,229,242,-5
Pknox2,6,11,225,242,-5
Zscan18,0,5,237,242,-5
Zscan25,3,8,231,242,-5
Plaa,2,7,233,242,-5
1700010I14Rik,4,9,229,242,-5
Plbd2,2,7,233,242,-5
1190007I07Rik,2,7,233,242,-5
Plcg1,2,7,233,242,-5
Pld6,11,16,215,242,-5
Plekha3,2,7,233,242,-5
Plp2,5,10,227,242,-5
Plekha4,3,8,231,242,-5
Plekha8,3,8,231,242,-5
Plekhb2,4,9,229,242,-5
1110038F14Rik,3,8,231,242,-5
1110025L11Rik,3,8,231,242,-5
Pnp2,7,12,223,242,-5
Pih1d1,4,9,229,242,-5
Zmat4,4,9,229,242,-5
Phip,2,7,233,242,-5
Pggt1b,3,8,231,242,-5
Pgls,2,7,233,242,-5
Polr3d,3,8,231,242,-5
Pglyrp4,1,6,235,242,-5
Pgp,2,7,233,242,-5
Pgrmc1,5,10,227,242,-5
Polr2k,8,13,221,242,-5
Polr2j,5,10,227,242,-5
2410002F23Rik,6,11,225,242,-5
Phc1,6,11,225,242,-5
2310033P09Rik,2,7,233,242,-5
Zfyve9,2,7,233,242,-5
Polr1c,2,7,233,242,-5
Phkb,4,9,229,242,-5
Pigm,1,6,235,242,-5
Phrf1,2,7,233,242,-5
Pole3,2,7,233,242,-5
1700129C05Rik,4,9,229,242,-5
1700123O20Rik,2,7,233,242,-5
1700123L14Rik,1,6,235,242,-5
Pi16,7,12,223,242,-5
Pianp,10,15,217,242,-5
1700122O11Rik,4,9,229,242,-5
Pibf1,2,7,233,242,-5
Piezo2,2,7,233,242,-5
Zkscan17,2,7,233,242,-5
Pigb,4,9,229,242,-5
Zkscan6,3,8,231,242,-5
Parp16,7,12,223,242,-5
Zfp692,2,7,233,242,-5
Zfp691,15,20,207,242,-5
Abca7,2,7,233,242,-5
Olfr1307,2,7,233,242,-5
Zfp24,2,7,233,242,-5
Abo,1,6,235,242,-5
Olfr1366,0,5,237,242,-5
Olfr1416,0,5,237,242,-5
Abhd5,2,7,233,242,-5
Prss2,5,10,227,242,-5
Olfr18,1,6,235,242,-5
Abhd15,9,14,219,242,-5
Olfr237,1,6,235,242,-5
Olfr243,1,6,235,242,-5
Prrc2a,3,8,231,242,-5
Olfr251,1,6,235,242,-5
Prr33,2,7,233,242,-5
Abcg3,1,6,235,242,-5
Olfr293,0,5,237,242,-5
Olfr298,0,5,237,242,-5
Zfp318,3,8,231,242,-5
Zfp319,1,6,235,242,-5
Olfr301,1,6,235,242,-5
Olfr316,0,5,237,242,-5
Olfr324,1,6,235,242,-5
Olfr33,0,5,237,242,-5
Olfr354,0,5,237,242,-5
Abcf3,2,7,233,242,-5
Olfr366,0,5,237,242,-5
Olfr398,1,6,235,242,-5
Olfr402,0,5,237,242,-5
Zfp369,4,9,229,242,-5
Acaca,2,7,233,242,-5
Acacb,8,13,221,242,-5
Olfr1281,2,7,233,242,-5
Zfp12,2,7,233,242,-5
Zer1,2,7,233,242,-5
Acp2,3,8,231,242,-5
Psmd4,2,7,233,242,-5
Psmd13,2,7,233,242,-5
Psmd10,5,10,227,242,-5
Zfp112,0,5,237,242,-5
Oit1,8,13,221,242,-5
Psmc2,3,8,231,242,-5
Psmc1,3,8,231,242,-5
Olfr107,4,9,229,242,-5
Psma8,5,10,227,242,-5
Olfr1120,3,8,231,242,-5
Psma1,5,10,227,242,-5
Psg28,1,6,235,242,-5
Acap2,2,7,233,242,-5
Zfp14,0,5,237,242,-5
Psg23,4,9,229,242,-5
Psg19,0,5,237,242,-5
Olfr1238,3,8,231,242,-5
Zfp143,3,8,231,242,-5
Zfp146,5,10,227,242,-5
Olfr1247,4,9,229,242,-5
Olfr1250,1,6,235,242,-5
Olfr1257,0,5,237,242,-5
Olfr1260,1,6,235,242,-5
Acbd6,2,7,233,242,-5
Prx,0,5,237,242,-5
Acap3,1,6,235,242,-5
Abcb10,2,7,233,242,-5
Olfr543,3,8,231,242,-5
Park7,3,8,231,242,-5
Olfr568,0,5,237,242,-5
Oog1,1,6,235,242,-5
Primpol,5,10,227,242,-5
Prim1,2,7,233,242,-5
Optc,3,8,231,242,-5
Zfp580,4,9,229,242,-5
Osbpl5,4,9,229,242,-5
Preb,2,7,233,242,-5
Prdx6b,0,5,237,242,-5
Prdx6,3,8,231,242,-5
Osgin2,3,8,231,242,-5
Zfp599,3,8,231,242,-5
9030025P20Rik,6,11,225,242,-5
Zfp609,2,7,233,242,-5
7530416G11Rik,6,11,225,242,-5
6430571L13Rik,3,8,231,242,-5
6030458C11Rik,2,7,233,242,-5
Oxsr1,2,7,233,242,-5
Oxtr,1,6,235,242,-5
5730455P16Rik,3,8,231,242,-5
P2rx4,6,11,225,242,-5
Pa2g4,3,8,231,242,-5
Zfp646,4,9,229,242,-5
Zfp653,2,7,233,242,-5
4933421I07Rik,4,9,229,242,-5
Panx3,1,6,235,242,-5
4933409G03Rik,0,5,237,242,-5
Zfp687,3,8,231,242,-5
Pard6g,1,6,235,242,-5
Parg,2,7,233,242,-5
Omg,1,6,235,242,-5
Olfr981,1,6,235,242,-5
Olfr967,12,17,213,242,-5
Prl8a9,0,5,237,242,-5
Zfp407,2,7,233,242,-5
Zfp418,6,11,225,242,-5
Olfr667,2,7,233,242,-5
Prob1,2,7,233,242,-5
Olfr691,2,7,233,242,-5
Prmt9,2,7,233,242,-5
Olfr697,0,5,237,242,-5
Prmt7,3,8,231,242,-5
Zfp449,5,10,227,242,-5
Olfr701,1,6,235,242,-5
Olfr703,0,5,237,242,-5
Olfr709-ps1,0,5,237,242,-5
Olfr73,1,6,235,242,-5
Prl7d1,3,8,231,242,-5
Olfr920,1,6,235,242,-5
Olfr742,4,9,229,242,-5
Prl7b1,1,6,235,242,-5
Olfr744,6,11,225,242,-5
Olfr769,2,7,233,242,-5
Zfp493,14,19,209,242,-5
Zfp518a,5,10,227,242,-5
Olfr794,4,9,229,242,-5
Prl2a1,1,6,235,242,-5
Zfp523,2,7,233,242,-5
Olfr853,1,6,235,242,-5
A430005L14Rik,4,9,229,242,-5
Olfr898,2,7,233,242,-5
Olfr914,2,7,233,242,-5
Vmn2r75,4,9,229,242,-5
Fbxo3,2,7,233,242,-5
B3galt1,2,7,233,242,-5
Mgrn1,2,7,233,242,-5
Rnf40,2,7,233,242,-5
Rnf4,2,7,233,242,-5
Map1a,0,5,237,242,-5
Btbd35f10,0,5,237,242,-5
Bicdl1,2,7,233,242,-5
Mgat4f,2,7,233,242,-5
Rnf167,4,9,229,242,-5
Mmp19,2,7,233,242,-5
Rnf38,2,7,233,242,-5
Mcmdc2,7,12,223,242,-5
Btbd2,3,8,231,242,-5
Mei4,1,6,235,242,-5
Atf2,4,9,229,242,-5
Btbd10,3,8,231,242,-5
Rilpl2,2,7,233,242,-5
Borcs7,4,9,229,242,-5
Atg16l2,5,10,227,242,-5
Vmn1r60,2,7,233,242,-5
Atl1,2,7,233,242,-5
Rnf25,2,7,233,242,-5
Rims3,0,5,237,242,-5
Bsg,3,8,231,242,-5
Rnf41,2,7,233,242,-5
Vmn1r236,3,8,231,242,-5
Borcs8,3,8,231,242,-5
Lrrc42,3,8,231,242,-5
Mob1b,3,8,231,242,-5
Mbnl1,6,11,225,242,-5
Bub3,3,8,231,242,-5
B230217C12Rik,5,10,227,242,-5
Rpl15,3,8,231,242,-5
Btg1b,0,5,237,242,-5
Map3k7,2,7,233,242,-5
Mnt,3,8,231,242,-5
Map3k5,3,8,231,242,-5
Vmn1r209,0,5,237,242,-5
Vmn1r43,1,6,235,242,-5
Lrrc52,1,6,235,242,-5
B230307C23Rik,4,9,229,242,-5
Mab21l3,4,9,229,242,-5
Rps25,6,11,225,242,-5
Bag6,3,8,231,242,-5
Mepce,3,8,231,242,-5
Mcc,0,5,237,242,-5
Map3k13,2,7,233,242,-5
Meioc,2,7,233,242,-5
Map3k11,2,7,233,242,-5
Rps27,10,15,217,242,-5
Vmn2r120,1,6,235,242,-5
Lsp1,8,13,221,242,-5
Metap1,2,7,233,242,-5
Med10,3,8,231,242,-5
Atp13a5,0,5,237,242,-5
Bfar,2,7,233,242,-5
Vmn1r224,3,8,231,242,-5
Bpifb2,0,5,237,242,-5
Bcs1l,2,7,233,242,-5
Med11,2,7,233,242,-5
Mageb5,0,5,237,242,-5
Rpl38,4,9,229,242,-5
Riox1,2,7,233,242,-5
Rps6kl1,0,5,237,242,-5
Vmn2r17,1,6,235,242,-5
Mad2l1bp,3,8,231,242,-5
Rpl4,3,8,231,242,-5
Mink1,2,7,233,242,-5
Atp5g2,5,10,227,242,-5
Bean1,3,8,231,242,-5
Med1,4,9,229,242,-5
Mecr,2,7,233,242,-5
Brd3,3,8,231,242,-5
Mageb5b,1,6,235,242,-5
Brca2,1,6,235,242,-5
Magee2,1,6,235,242,-5
Vmn1r55,0,5,237,242,-5
Vmn2r20,0,5,237,242,-5
Atox1,5,10,227,242,-5
Rraga,2,7,233,242,-5
Lst1,13,18,211,242,-5
Rin2,2,7,233,242,-5
Mdfic2,0,5,237,242,-5
Mdga2,3,8,231,242,-5
Rit2,1,6,235,242,-5
Atp10b,1,6,235,242,-5
Rragb,5,10,227,242,-5
Atp11a,2,7,233,242,-5
Rpl3,6,11,225,242,-5
B4galt2,0,5,237,242,-5
Mdk,6,11,225,242,-5
Ly6g6f,5,10,227,242,-5
Bcl7c,4,9,229,242,-5
Rint1,4,9,229,242,-5
AU021092,5,10,227,242,-5
Mipep,3,8,231,242,-5
Rps3a1,6,11,225,242,-5
Vmn1r229,0,5,237,242,-5
Luc7l2,2,7,233,242,-5
Bclaf1,3,8,231,242,-5
Mak,2,7,233,242,-5
Maip1,2,7,233,242,-5
Bud13,2,7,233,242,-5
Atp5h,2,7,233,242,-5
Mfsd14a,4,9,229,242,-5
Rpap1,4,9,229,242,-5
Lrp8,7,12,223,242,-5
Morf4l1,3,8,231,242,-5
C2cd5,3,8,231,242,-5
Bms1,2,7,233,242,-5
Lrp2bp,5,10,227,242,-5
Lrrc14b,4,9,229,242,-5
Rps15a,9,14,219,242,-5
Mfsd12,2,7,233,242,-5
Marchf7,3,8,231,242,-5
Asic4,4,9,229,242,-5
Mpi,4,9,229,242,-5
Atpif1,2,7,233,242,-5
Rnps1,3,8,231,242,-5
Atr,3,8,231,242,-5
BC035947,3,8,231,242,-5
Rtn4ip1,2,7,233,242,-5
Mapk9,4,9,229,242,-5
Mphosph9,1,6,235,242,-5
Mettl23,2,7,233,242,-5
Lyzl6,3,8,231,242,-5
Bmp2k,5,10,227,242,-5
Mapk1ip1,2,7,233,242,-5
C87436,5,10,227,242,-5
Mphosph10,2,7,233,242,-5
Mpc1,2,7,233,242,-5
Rtn2,3,8,231,242,-5
Bbs10,2,7,233,242,-5
Maskbp3,3,8,231,242,-5
Rpf1,2,7,233,242,-5
Mas1,10,15,217,242,-5
Mettl16,4,9,229,242,-5
Bmp5,3,8,231,242,-5
Rpf2,3,8,231,242,-5
Mfsd3,6,11,225,242,-5
Atp9b,2,7,233,242,-5
Bmt2,4,9,229,242,-5
Lzts3,2,7,233,242,-5
BC049352,3,8,231,242,-5
Vmn2r11,0,5,237,242,-5
Lrrc34,5,10,227,242,-5
Marchf2,5,10,227,242,-5
Mblac1,1,6,235,242,-5
Mfsd4b5,3,8,231,242,-5
Rp2,3,8,231,242,-5
Vmn1r40,1,6,235,242,-5
Rnf139,3,8,231,242,-5
Rph3a,1,6,235,242,-5
Mapk10,2,7,233,242,-5
Atxn3,4,9,229,242,-5
Asb1,5,10,227,242,-5
C1qa,6,11,225,242,-5
Mapk8ip2,3,8,231,242,-5
Rpp38,7,12,223,242,-5
Birc6,3,8,231,242,-5
Mob3a,2,7,233,242,-5
Mettl6,3,8,231,242,-5
AW209491,2,7,233,242,-5
9930012K11Rik,4,10,228,242,-6
Gm21943,0,6,236,242,-6
Ccdc173,5,11,226,242,-6
Zfp451,2,8,232,242,-6
Orc5,5,11,226,242,-6
Zfp382,7,13,222,242,-6
Zfp593,2,8,232,242,-6
Lyzl1,1,7,234,242,-6
Gm20854,1,7,234,242,-6
Olfr465-ps1,1,7,234,242,-6
Ccdc175,3,9,230,242,-6
Zfp454,4,10,228,242,-6
Prmt2,8,14,220,242,-6
Upp2,8,14,220,242,-6
Scgb2b21,0,6,236,242,-6
Prelid2,4,10,228,242,-6
Bhlha9,3,9,230,242,-6
Knop1,2,8,232,242,-6
Oscp1,3,9,230,242,-6
Blmh,4,10,228,242,-6
Gm2411,3,9,230,242,-6
Tmem126b,4,10,228,242,-6
Gm20824,0,6,236,242,-6
Gm28079,6,12,224,242,-6
Olfr597,1,7,234,242,-6
Olfr635,0,6,236,242,-6
Olfr654,0,6,236,242,-6
Tmem132a,2,8,232,242,-6
Olfr552,1,7,234,242,-6
Zfp426,2,8,232,242,-6
Dtx3,4,10,228,242,-6
Srcap,2,8,232,242,-6
Abca16,0,6,236,242,-6
Bloc1s5,5,11,226,242,-6
St7,2,8,232,242,-6
Gm20825,1,7,234,242,-6
Edil3,2,8,232,242,-6
Osbpl9,2,8,232,242,-6
Osbpl7,1,7,234,242,-6
Olfr682-ps1,0,6,236,242,-6
Gm28102,0,6,236,242,-6
Klra8,4,10,228,242,-6
Gm20834,0,6,236,242,-6
Tmem159,3,9,230,242,-6
AA986860,4,10,228,242,-6
Gm20867,2,8,232,242,-6
Prl2c3,14,20,208,242,-6
Ccdc142,12,18,212,242,-6
Olfr77,1,7,234,242,-6
Krit1,4,10,228,242,-6
Tmem17,1,7,234,242,-6
Krtap15,8,14,220,242,-6
Gm21560,12,18,212,242,-6
A630023A22Rik,3,9,230,242,-6
Srsf4,2,8,232,242,-6
Gm21497,0,6,236,242,-6
Tmem168,3,9,230,242,-6
Olfr930,0,6,236,242,-6
Dtwd2,1,7,234,242,-6
Prkcg,1,7,234,242,-6
Rpn2,2,8,232,242,-6
A4galt,6,12,224,242,-6
Gm20896,0,6,236,242,-6
E230025N22Rik,0,6,236,242,-6
Gm20914,1,7,234,242,-6
Gm21394,1,7,234,242,-6
Olfr808,1,7,234,242,-6
Tmem164,5,11,226,242,-6
Olfr809,3,9,230,242,-6
Urb2,2,8,232,242,-6
Gm20917,1,7,234,242,-6
Olfr905,0,6,236,242,-6
Olfr90,3,9,230,242,-6
Gm21209,1,7,234,242,-6
E2f7,0,6,236,242,-6
Rpp25l,2,8,232,242,-6
Ssh2,3,9,230,242,-6
Prl7a2,3,9,230,242,-6
Tmem143,3,9,230,242,-6
Gm20873,0,6,236,242,-6
Srp72,2,8,232,242,-6
Krtap22-2,1,7,234,242,-6
Rplp1,4,10,228,242,-6
Gm21876,0,6,236,242,-6
Tmem185a,2,8,232,242,-6
Lztfl1,5,11,226,242,-6
Ecm2,5,11,226,242,-6
Gm21865,3,9,230,242,-6
Srp19,4,10,228,242,-6
Tmem184c,4,10,228,242,-6
Echdc1,5,11,226,242,-6
Gm21095,1,7,234,242,-6
Gm21812,1,7,234,242,-6
Vmn1r202,2,8,232,242,-6
Srp68,2,8,232,242,-6
Kpna7,6,12,224,242,-6
Zfp532,8,14,220,242,-6
Oma1,3,9,230,242,-6
A26c3,2,8,232,242,-6
Zfp457,6,12,224,242,-6
Srpk2,2,8,232,242,-6
Prl8a2,0,6,236,242,-6
Zfp458,8,14,220,242,-6
Gm21750,6,12,224,242,-6
Gm21748,32,38,172,242,-6
Dynlt2b,3,9,230,242,-6
A2m,1,7,234,242,-6
Macroh2a1,3,9,230,242,-6
Ssx2ip,2,8,232,242,-6
Ccdc124,2,8,232,242,-6
Gm21719,0,6,236,242,-6
Tubg1,3,9,230,242,-6
Dnttip2,2,8,232,242,-6
Olfr45,1,7,234,242,-6
Acly,3,9,230,242,-6
Rpl14,3,9,230,242,-6
Diablo,2,8,232,242,-6
Dhx37,3,9,230,242,-6
Spag16,1,7,234,242,-6
Olfr118,1,7,234,242,-6
Pskh1,3,9,230,242,-6
Dhtkd1,2,8,232,242,-6
Zfp119b,2,8,232,242,-6
Spaca1,3,9,230,242,-6
Map3k4,2,8,232,242,-6
Gm43218,3,9,230,242,-6
BC024978,4,10,228,242,-6
Olfr1090,5,11,226,242,-6
Zfp114,2,8,232,242,-6
Kif24,1,7,234,242,-6
Olfr1037,0,6,236,242,-6
Dhcr24,2,8,232,242,-6
Zfp113,2,8,232,242,-6
Kifbp,4,10,228,242,-6
Uhrf1,5,11,226,242,-6
Gm39653,5,11,226,242,-6
Dis3l,3,9,230,242,-6
Uimc1,2,8,232,242,-6
Tmtc3,2,8,232,242,-6
Accs,5,11,226,242,-6
Olfr127,0,6,236,242,-6
Dlgap3,1,7,234,242,-6
Zfp174,0,6,236,242,-6
Dlg3,3,9,230,242,-6
Dleu7,7,13,222,242,-6
Zfp157,5,11,226,242,-6
Ace3,0,6,236,242,-6
Gm37419,12,18,212,242,-6
Kin,3,9,230,242,-6
Kifc5b,2,8,232,242,-6
Psg16,2,8,232,242,-6
Dis3l2,2,8,232,242,-6
Spata13,3,9,230,242,-6
Gm38394,2,8,232,242,-6
Dguok,4,10,228,242,-6
Psmb7,4,10,228,242,-6
BC024063,4,10,228,242,-6
Ccl21b,8,14,220,242,-6
Tns4,1,7,234,242,-6
Tob1,3,9,230,242,-6
Gm48551,3,9,230,242,-6
Sorbs1,2,8,232,242,-6
Dennd11,2,8,232,242,-6
Zdhhc7,2,8,232,242,-6
Obsl1,2,8,232,242,-6
Psmg2,3,9,230,242,-6
Uggt2,2,8,232,242,-6
Kidins220,2,8,232,242,-6
Oat,5,11,226,242,-6
Ccne2,4,10,228,242,-6
Oas1c,3,9,230,242,-6
Actl10,5,11,226,242,-6
Nynrin,5,11,226,242,-6
Nyap1,0,6,236,242,-6
Ptar1,3,9,230,242,-6
Kif16b,2,8,232,242,-6
Dennd6b,2,8,232,242,-6
Arxes1,8,14,220,242,-6
Gm47429,11,17,214,242,-6
Sox6,4,10,228,242,-6
Zfp11,4,10,228,242,-6
Zfp109,6,12,224,242,-6
Dgcr6,3,9,230,242,-6
Zfp108,5,11,226,242,-6
Dffb,2,8,232,242,-6
Ogg1,3,9,230,242,-6
Gm45711,0,6,236,242,-6
Mapk3,3,9,230,242,-6
Acp1,2,8,232,242,-6
Deup1,0,6,236,242,-6
Odf3,3,9,230,242,-6
Gm45861,1,7,234,242,-6
Desi1,3,9,230,242,-6
Vmn1r26,1,7,234,242,-6
Zfand4,4,10,228,242,-6
Sost,0,6,236,242,-6
Acat1,2,8,232,242,-6
Spata6,3,9,230,242,-6
Olfr441,0,6,236,242,-6
Abcg8,0,6,236,242,-6
Gm3047,0,6,236,242,-6
Tmem265,17,23,202,242,-6
Klhl9,2,8,232,242,-6
Gm30737,1,7,234,242,-6
Dolk,4,10,228,242,-6
Dock5,2,8,232,242,-6
Olfr271-ps1,0,6,236,242,-6
Doc2g,5,11,226,242,-6
Gm3173,21,27,194,242,-6
Spata6l,9,15,218,242,-6
Man2b2,3,9,230,242,-6
Dnmt3l,3,9,230,242,-6
Dnm1,2,8,232,242,-6
Dnali1,5,11,226,242,-6
Dnal4,4,10,228,242,-6
Olfr224,3,9,230,242,-6
Abhd1,6,12,224,242,-6
Olfr19,0,6,236,242,-6
Tmem260,2,8,232,242,-6
Zfp322a,5,11,226,242,-6
Tmem255a,3,9,230,242,-6
Tmem248,3,9,230,242,-6
Dtna,10,16,216,242,-6
Gm28729,4,10,228,242,-6
Gm28778,22,28,192,242,-6
Uox,6,12,224,242,-6
Gm28961,0,6,236,242,-6
Gm28998,0,6,236,242,-6
Abcd1,2,8,232,242,-6
Gm29106,0,6,236,242,-6
Abcf2,2,8,232,242,-6
Tmem235,3,9,230,242,-6
Dscam,1,7,234,242,-6
Ccdc182,2,8,232,242,-6
Zfp330,2,8,232,242,-6
Tmem241,7,13,222,242,-6
Zfp329,3,9,230,242,-6
Gm3012,9,15,218,242,-6
Gm3015,4,10,228,242,-6
Scn2a,0,6,236,242,-6
Gm33815,1,7,234,242,-6
Manf,3,9,230,242,-6
Olfr1336,1,7,234,242,-6
Speer4f1,0,6,236,242,-6
Tmem88b,1,7,234,242,-6
Tmem8b,1,7,234,242,-6
Klf12,5,11,226,242,-6
Dnah8,5,11,226,242,-6
Speer1,4,10,228,242,-6
Dnah7a,0,6,236,242,-6
Olfr1303,0,6,236,242,-6
Spdye4b,3,9,230,242,-6
Zfp239,1,7,234,242,-6
Dnah3,2,8,232,242,-6
Abtb1,2,8,232,242,-6
Klc3,1,7,234,242,-6
Olfr1284,8,14,220,242,-6
Dmtf1,3,9,230,242,-6
Gm3594,4,10,228,242,-6
Dmpk,2,8,232,242,-6
Dnajb13,3,9,230,242,-6
Tmem87a,4,10,228,242,-6
Olfr177,2,8,232,242,-6
Zfp260,6,12,224,242,-6
Zfp280d,3,9,230,242,-6
Bcl2l13,5,11,226,242,-6
Prss21,1,7,234,242,-6
Spin1,5,11,226,242,-6
Olfr165,6,12,224,242,-6
Olfr1555-ps1,2,8,232,242,-6
Abhd17a,2,8,232,242,-6
Dnajc18,6,12,224,242,-6
Olfr1445,0,6,236,242,-6
Dnajc16,2,8,232,242,-6
Spg7,2,8,232,242,-6
Dnajc14,2,8,232,242,-6
Spg20,2,8,232,242,-6
Dnajc13,2,8,232,242,-6
Olfr1383,5,11,226,242,-6
Olfr1371,2,8,232,242,-6
Olfr1368,0,6,236,242,-6
Gm20806,0,6,236,242,-6
Eif1ad18,10,16,216,242,-6
Rps13,4,10,228,242,-6
Lrrc51,4,10,228,242,-6
Taf15,2,8,232,242,-6
Vapb,2,8,232,242,-6
Taf11,2,8,232,242,-6
Cand1,2,8,232,242,-6
Polr2b,2,8,232,242,-6
Phc3,4,10,228,242,-6
Tada2a,2,8,232,242,-6
Polr2d,3,9,230,242,-6
Rsph3a,11,17,214,242,-6
Galnt11,6,12,224,242,-6
Lrriq1,6,12,224,242,-6
Taco1,4,10,228,242,-6
Polr2g,2,8,232,242,-6
Phactr4,3,9,230,242,-6
Zfpm2,0,6,236,242,-6
Fam135b,2,8,232,242,-6
Lin7c,4,10,228,242,-6
Lrriq4,3,9,230,242,-6
Tab2,4,10,228,242,-6
Phf7,5,11,226,242,-6
S100g,25,31,186,242,-6
Pogk,6,12,224,242,-6
Tex13b,2,8,232,242,-6
Poglut2,6,12,224,242,-6
Tes,3,9,230,242,-6
Pi4ka,3,9,230,242,-6
Tescl,8,14,220,242,-6
Fzd8,5,11,226,242,-6
Polb,3,9,230,242,-6
G2e3,2,8,232,242,-6
Taf9b,2,8,232,242,-6
Taf9,11,17,214,242,-6
Camsap1,2,8,232,242,-6
Vmn1r12,1,7,234,242,-6
Zic5,3,9,230,242,-6
Btbd6,3,9,230,242,-6
Pole2,4,10,228,242,-6
Lipi,0,6,236,242,-6
Fam169a,0,6,236,242,-6
Gabbr2,1,7,234,242,-6
S100b,0,6,236,242,-6
Polg,15,21,206,242,-6
Lrsam1,4,10,228,242,-6
Limd2,5,11,226,242,-6
Lrtm2,2,8,232,242,-6
Polr3f,2,8,232,242,-6
3110021N24Rik,7,13,222,242,-6
Pex19,3,9,230,242,-6
4921504E06Rik,3,9,230,242,-6
4921511C20Rik,0,6,236,242,-6
Pou2f1,9,15,218,242,-6
Car14,6,12,224,242,-6
Gfpt1,2,8,232,242,-6
Tfcp2,3,9,230,242,-6
Ggh,3,9,230,242,-6
Zfp954,5,11,226,242,-6
Synpo2l,1,7,234,242,-6
Utp15,2,8,232,242,-6
Ggnbp2,4,10,228,242,-6
Penk,6,12,224,242,-6
Samd4,0,6,236,242,-6
Lta,12,18,212,242,-6
Pelo,2,8,232,242,-6
Exosc8,2,8,232,242,-6
Letmd1,2,8,232,242,-6
Pop1,3,9,230,242,-6
V1rd19,0,6,236,242,-6
Capn7,5,11,226,242,-6
Pom121l12,0,6,236,242,-6
Tex26,6,12,224,242,-6
Galt,2,8,232,242,-6
Gan,1,7,234,242,-6
Gapdhs,3,9,230,242,-6
Gapt,1,7,234,242,-6
Garem2,0,6,236,242,-6
2510009E07Rik,3,9,230,242,-6
Bspry,3,9,230,242,-6
Tex33,1,7,234,242,-6
Lhpp,7,13,222,242,-6
Vamp2,2,8,232,242,-6
Capn5,5,11,226,242,-6
Safb2,2,8,232,242,-6
Zfp984,4,10,228,242,-6
Gcc2,4,10,228,242,-6
Fam114a1,2,8,232,242,-6
Capn6,4,10,228,242,-6
Lsm4,2,8,232,242,-6
Fxyd5,5,11,226,242,-6
Pofut1,2,8,232,242,-6
Stab2,2,8,232,242,-6
Loxl4,2,8,232,242,-6
Fastkd5,4,10,228,242,-6
Tbk1,4,10,228,242,-6
Fgd2,4,10,228,242,-6
Fgd3,2,8,232,242,-6
Plac8,6,12,224,242,-6
Plac1,4,10,228,242,-6
Fgf2,2,8,232,242,-6
Fasl,6,12,224,242,-6
Zscan4-ps2,3,9,230,242,-6
Fgf22,5,11,226,242,-6
1700011M02Rik,5,11,226,242,-6
Cacng5,0,6,236,242,-6
Fgf5,1,7,234,242,-6
Tbc1d25,2,8,232,242,-6
Loxhd1,0,6,236,242,-6
Fgfrl1,3,9,230,242,-6
Lox,1,7,234,242,-6
Tbc1d16,9,15,218,242,-6
Fhod1,2,8,232,242,-6
Zscan4c,0,6,236,242,-6
1110059E24Rik,2,8,232,242,-6
Pick1,4,10,228,242,-6
Fbrs,2,8,232,242,-6
0610030E20Rik,2,8,232,242,-6
Plekhm1,2,8,232,242,-6
Plekhh1,4,10,228,242,-6
Plekhg6,1,7,234,242,-6
Tcerg1l,0,6,236,242,-6
Cacna1a,1,7,234,242,-6
Fbxo22,2,8,232,242,-6
Plekhd1,5,11,226,242,-6
Fbxw10,0,6,236,242,-6
Rtraf,4,10,228,242,-6
Tbxas1,6,12,224,242,-6
Lrp12,2,8,232,242,-6
Fbxw5,2,8,232,242,-6
C8g,4,10,228,242,-6
Plpp1,2,8,232,242,-6
Fbxl13,3,9,230,242,-6
1110051M20Rik,4,10,228,242,-6
Tcf7l1,2,8,232,242,-6
Tcf7l2,5,11,226,242,-6
Vkorc1l1,2,8,232,242,-6
1700018F24Rik,2,8,232,242,-6
Fam98c,4,10,228,242,-6
Pml,2,8,232,242,-6
Calhm2,6,12,224,242,-6
1700066M21Rik,3,9,230,242,-6
Ryr3,1,7,234,242,-6
Foxf2,0,6,236,242,-6
Tefm,3,9,230,242,-6
Tas1r3,1,7,234,242,-6
Fam219a,2,8,232,242,-6
Pigq,3,9,230,242,-6
Rtf1,2,8,232,242,-6
Pigh,3,9,230,242,-6
Pigf,6,12,224,242,-6
Fam216b,2,8,232,242,-6
Tapt1,3,9,230,242,-6
Calm2,3,9,230,242,-6
Fsip2,1,7,234,242,-6
Piga,2,8,232,242,-6
Fstl3,3,9,230,242,-6
Tango2,5,11,226,242,-6
Pidd1,2,8,232,242,-6
1700066B19Rik,1,7,234,242,-6
Fam234a,3,9,230,242,-6
1700037H04Rik,3,9,230,242,-6
Lrrc14,2,8,232,242,-6
Pja2,2,8,232,242,-6
Zpbp,1,7,234,242,-6
1700020L24Rik,12,18,212,242,-6
Fam89a,2,8,232,242,-6
Fam76a,3,9,230,242,-6
Pitpnm1,3,9,230,242,-6
Fktn,3,9,230,242,-6
Pithd1,3,9,230,242,-6
Pin4,6,12,224,242,-6
C1qb,7,13,222,242,-6
Pin1,2,8,232,242,-6
Tas2r137,6,12,224,242,-6
Lmtk3,1,7,234,242,-6
Pim1,5,11,226,242,-6
C2cd2,2,8,232,242,-6
Fmn1,2,8,232,242,-6
Fmnl3,2,8,232,242,-6
C1qtnf5,8,14,220,242,-6
Tfpi,5,11,226,242,-6
Ppa1,3,9,230,242,-6
Ppa2,2,8,232,242,-6
Eif4ebp2,3,9,230,242,-6
Stox1,8,14,220,242,-6
Zfp69,1,7,234,242,-6
Bnip3l,2,8,232,242,-6
Bnc2,5,11,226,242,-6
Lap3,2,8,232,242,-6
4933405O20Rik,1,7,234,242,-6
Usp17la,4,10,228,242,-6
Gm15319,12,18,212,242,-6
4933412E24Rik,0,6,236,242,-6
Papolg,2,8,232,242,-6
Lypd6,6,12,224,242,-6
Panx2,9,15,218,242,-6
Pank4,2,8,232,242,-6
Lypd9,1,7,234,242,-6
Palm,3,9,230,242,-6
Zfp658,1,7,234,242,-6
Pak5,1,7,234,242,-6
Ccar1,4,10,228,242,-6
Zfp651,2,8,232,242,-6
Parp10,3,9,230,242,-6
Pqlc3,6,12,224,242,-6
Leprotl1,2,8,232,242,-6
Eif4g2,3,9,230,242,-6
Cbr4,6,12,224,242,-6
4931417E11Rik,0,6,236,242,-6
Endov,2,8,232,242,-6
Pax6,6,12,224,242,-6
Eml6,3,9,230,242,-6
Lbhd2,9,15,218,242,-6
Ppp4c,3,9,230,242,-6
Cbwd1,3,9,230,242,-6
Patl2,0,6,236,242,-6
Elmo2,4,10,228,242,-6
Strn,2,8,232,242,-6
Gm14403,14,20,208,242,-6
Patl1,3,9,230,242,-6
Elk4,4,10,228,242,-6
Pate13,2,8,232,242,-6
Zfp7,3,9,230,242,-6
4933402N22Rik,2,8,232,242,-6
Parp2,3,9,230,242,-6
Rps26,5,11,226,242,-6
Tm9sf1,3,9,230,242,-6
Padi6,0,6,236,242,-6
Pacsin3,5,11,226,242,-6
Pacsin1,2,8,232,242,-6
Zfp61,0,6,236,242,-6
Egfl7,8,14,220,242,-6
Efhc1,2,8,232,242,-6
Ccdc113,2,8,232,242,-6
Stard4,3,9,230,242,-6
Tmed9,2,8,232,242,-6
Stard3,2,8,232,242,-6
Zfp607b,4,10,228,242,-6
9030624G23Rik,1,7,234,242,-6
Tmem102,6,12,224,242,-6
Efcab3,3,9,230,242,-6
Prdm9,5,11,226,242,-6
Prdx3,6,12,224,242,-6
Prdx4,2,8,232,242,-6
Lyrm7,5,11,226,242,-6
Bmf,5,11,226,242,-6
Eefsec,2,8,232,242,-6
Kxd1,2,8,232,242,-6
Eef2kmt,2,8,232,242,-6
Gm2042,6,12,224,242,-6
Lyrm4,2,8,232,242,-6
Ovol1,4,10,228,242,-6
5730409E04Rik,7,13,222,242,-6
Stk3,4,10,228,242,-6
Gm17174,4,10,228,242,-6
Pabpc5,0,6,236,242,-6
Pabpc2,0,6,236,242,-6
Gm17359,6,12,224,242,-6
Gm17472,3,9,230,242,-6
Rps19,4,10,228,242,-6
Eif1ad6,5,11,226,242,-6
P2ry13,2,8,232,242,-6
Gm2026,25,31,186,242,-6
Zfp638,6,12,224,242,-6
Rps18-ps5,9,15,218,242,-6
Eif1ad17,7,13,222,242,-6
Eif1ad14,6,12,224,242,-6
Lage3,3,9,230,242,-6
5730480H06Rik,3,9,230,242,-6
Gm20075,8,14,220,242,-6
5730522E02Rik,7,13,222,242,-6
Ppp2r5d,2,8,232,242,-6
Rps27l,5,11,226,242,-6
Gm14137,6,12,224,242,-6
Ppp1r10,5,11,226,242,-6
Pdha1,5,11,226,242,-6
Ppil3,3,9,230,242,-6
Tgif2lx2,0,6,236,242,-6
Rps6kc1,2,8,232,242,-6
Ppil6,11,17,214,242,-6
Brd3os,3,9,230,242,-6
Esx1,3,9,230,242,-6
Zfp931,8,14,220,242,-6
Ppm1b,2,8,232,242,-6
4930447F04Rik,1,7,234,242,-6
Gm10135,9,15,218,242,-6
Usp46,1,7,234,242,-6
Ero1a,7,13,222,242,-6
Gm10230,9,15,218,242,-6
Erlin2,2,8,232,242,-6
Gm10375,5,11,226,242,-6
Surf4,2,8,232,242,-6
Gm10376,9,15,218,242,-6
Erich5,4,10,228,242,-6
Tgif2lx1,0,6,236,242,-6
Pdia6,2,8,232,242,-6
4930447C04Rik,10,16,216,242,-6
Rpsa,4,10,228,242,-6
Brd8,2,8,232,242,-6
Git1,2,8,232,242,-6
Pdzk1ip1,8,14,220,242,-6
Pdzd9,7,13,222,242,-6
Leo1,2,8,232,242,-6
Gjb5,1,7,234,242,-6
Exoc3l4,3,9,230,242,-6
4930404N11Rik,9,15,218,242,-6
Zfp941,3,9,230,242,-6
Pdilt,2,8,232,242,-6
Samt1,1,7,234,242,-6
4930444P10Rik,5,11,226,242,-6
Rps9,3,9,230,242,-6
Sycp1,8,14,220,242,-6
Tgfbr1,2,8,232,242,-6
Zfp94,0,6,236,242,-6
Casp6,6,12,224,242,-6
Syce1l,10,16,216,242,-6
Rps6ka3,6,12,224,242,-6
Bpifb6,0,6,236,242,-6
Zfp729b,4,10,228,242,-6
Zfp811,1,7,234,242,-6
Lcmt1,2,8,232,242,-6
Ephb4,4,10,228,242,-6
Gm12789,7,13,222,242,-6
Sufu,2,8,232,242,-6
Gm12790,6,12,224,242,-6
Ppp1r3e,7,13,222,242,-6
Pcdh18,4,10,228,242,-6
Pcdh12,2,8,232,242,-6
4930596D02Rik,0,6,236,242,-6
Styk1,5,11,226,242,-6
Zfp758,4,10,228,242,-6
Pcbp2,4,10,228,242,-6
Zfp750,7,13,222,242,-6
Rps28,7,13,222,242,-6
Pcare,0,6,236,242,-6
Zfp746,2,8,232,242,-6
Zfp74,4,10,228,242,-6
Stx7,6,12,224,242,-6
Usp27x,4,10,228,242,-6
Bpi,0,6,236,242,-6
Gm12184,35,41,166,242,-6
Gm11639,1,7,234,242,-6
Usp40,2,8,232,242,-6
Supt3,2,8,232,242,-6
Zfp81,3,9,230,242,-6
Ppp1r13b,3,9,230,242,-6
Thoc7,7,13,222,242,-6
Ppp1r14a,7,13,222,242,-6
Gm10772,11,17,214,242,-6
Pcolce2,0,6,236,242,-6
Pcnt,2,8,232,242,-6
Usp4,2,8,232,242,-6
Lcn12,6,12,224,242,-6
Ldha,6,12,224,242,-6
Pcm1,2,8,232,242,-6
Ppp1r17,1,7,234,242,-6
Thumpd2,4,10,228,242,-6
Ly6g2,2,8,232,242,-6
Erc1,2,8,232,242,-6
Erbb2,2,8,232,242,-6
Gm1141,2,8,232,242,-6
Tomm5,3,9,230,242,-6
Ccdc92,3,9,230,242,-6
Actn2,3,9,230,242,-6
Triobp,2,8,232,242,-6
Naip6,0,6,236,242,-6
Rbak,2,8,232,242,-6
Ankrd23,7,13,222,242,-6
Naga,3,9,230,242,-6
H2bc21,5,11,226,242,-6
Ankrd24,4,10,228,242,-6
Nadk2,3,9,230,242,-6
Ankrd28,3,9,230,242,-6
Cldnd2,15,21,206,242,-6
Nbeal1,2,8,232,242,-6
Cldnd1,4,10,228,242,-6
H3c7,9,15,218,242,-6
Wdr89,3,9,230,242,-6
Micos10,2,8,232,242,-6
Ankrd40,5,11,226,242,-6
Cldn34c4,0,6,236,242,-6
Ankrd42,3,9,230,242,-6
Hap1,2,8,232,242,-6
Clec4n,7,13,222,242,-6
H2ac4,20,26,196,242,-6
Nap1l1,2,8,232,242,-6
Atp6v1b1,8,14,220,242,-6
Cnih2,5,11,226,242,-6
Vmn2r112,2,8,232,242,-6
Nat3,2,8,232,242,-6
Cnep1r1,4,10,228,242,-6
Slc2a3,7,13,222,242,-6
Isl2,2,8,232,242,-6
Mfsd8,7,13,222,242,-6
Nasp,3,9,230,242,-6
Isca2,2,8,232,242,-6
Trim39,3,9,230,242,-6
H2-Q10,5,11,226,242,-6
Trim43a,4,10,228,242,-6
H2-T24,8,14,220,242,-6
Serpina7,2,8,232,242,-6
Atp6v1f,2,8,232,242,-6
Clptm1,3,9,230,242,-6
Mgat2,3,9,230,242,-6
Trmt112,2,8,232,242,-6
Slc25a27,1,7,234,242,-6
Uap1,2,8,232,242,-6
Myh15,2,8,232,242,-6
Hdac3,2,8,232,242,-6
Hddc2,7,13,222,242,-6
Slc22a30,2,8,232,242,-6
Myef2,2,8,232,242,-6
Hdgfl3,2,8,232,242,-6
Rbm6,2,8,232,242,-6
CK137956,1,7,234,242,-6
Hdhd5,4,10,228,242,-6
Mindy1,2,8,232,242,-6
Mycbpap,0,6,236,242,-6
Heatr4,0,6,236,242,-6
Slc22a16,0,6,236,242,-6
Cip2a,2,8,232,242,-6
Hectd4,2,8,232,242,-6
Wdr33,3,9,230,242,-6
Trpd52l3,0,6,236,242,-6
Cib1,2,8,232,242,-6
Wdr4,5,11,226,242,-6
Trp53rkb,0,6,236,242,-6
Rbm17,3,9,230,242,-6
Rbm43,4,10,228,242,-6
Trmt2a,3,9,230,242,-6
Ankrd49,3,9,230,242,-6
Rit1,3,9,230,242,-6
Ankrd52,2,8,232,242,-6
Haus5,3,9,230,242,-6
Ankrd53,2,8,232,242,-6
Haus8,3,9,230,242,-6
U2af1,3,9,230,242,-6
Cdk7,2,8,232,242,-6
Slc25a1,3,9,230,242,-6
Hbp1,3,9,230,242,-6
Hbq1b,15,21,206,242,-6
Hcar1,2,8,232,242,-6
Myo16,0,6,236,242,-6
Atp5o,4,10,228,242,-6
Vmn2r124,0,6,236,242,-6
Mier2,4,10,228,242,-6
Naxe,3,9,230,242,-6
Atp7b,3,9,230,242,-6
Ciao2b,4,10,228,242,-6
Col20a1,3,9,230,242,-6
Jakmip2,3,9,230,242,-6
Septin7,4,10,228,242,-6
Grb2,7,13,222,242,-6
Vmn1r88,0,6,236,242,-6
Cdc42se2,4,10,228,242,-6
Grik1,2,8,232,242,-6
Grik2,3,9,230,242,-6
Slc43a3,9,15,218,242,-6
Ndufs5,3,9,230,242,-6
Gykl1,1,7,234,242,-6
Wwox,2,8,232,242,-6
Vmn1r90,0,6,236,242,-6
Aldoc,2,8,232,242,-6
Rnf115,5,11,226,242,-6
Wtap,8,14,220,242,-6
Alg13,2,8,232,242,-6
Grk3,2,8,232,242,-6
Grk4,5,11,226,242,-6
Mettl21a,1,7,234,242,-6
Slc46a1,7,13,222,242,-6
Vmn1r81,3,9,230,242,-6
Trem1,0,6,236,242,-6
Xlr3a,3,9,230,242,-6
Nenf,4,10,228,242,-6
AW554918,4,10,228,242,-6
Gpr19,4,10,228,242,-6
Nemf,2,8,232,242,-6
Rad18,3,9,230,242,-6
Copg2,4,10,228,242,-6
Nelfb,2,8,232,242,-6
Metap1d,3,9,230,242,-6
Gpr39,0,6,236,242,-6
Gpr63,6,12,224,242,-6
Nek11,3,9,230,242,-6
Gpr85,3,9,230,242,-6
Gps2,3,9,230,242,-6
Mettl11b,1,7,234,242,-6
Gpx8,5,11,226,242,-6
Col5a3,1,7,234,242,-6
Mettl27,6,12,224,242,-6
Grpel2,2,8,232,242,-6
Coil,2,8,232,242,-6
Gtf2i,2,8,232,242,-6
Amy2a4,7,13,222,242,-6
Amz1,5,11,226,242,-6
Vmn2r108,0,6,236,242,-6
Nck1,2,8,232,242,-6
Slc35b4,2,8,232,242,-6
Gtpbp1,2,8,232,242,-6
Rasal1,3,9,230,242,-6
Anapc4,3,9,230,242,-6
Ang2,11,17,214,242,-6
Slc35a1,4,10,228,242,-6
Cnnm1,1,7,234,242,-6
Slc34a2,6,12,224,242,-6
Trim26,5,11,226,242,-6
Gucd1,4,10,228,242,-6
Gucy2g,2,8,232,242,-6
Ncapd3,2,8,232,242,-6
Ncam1,3,9,230,242,-6
Ampd3,5,11,226,242,-6
Trim13,6,12,224,242,-6
Ramac,3,9,230,242,-6
Rarg,3,9,230,242,-6
Atxn7l3,2,8,232,242,-6
Ndufb10,2,8,232,242,-6
Mex3d,4,10,228,242,-6
Slc38a6,5,11,226,242,-6
Itprip,5,11,226,242,-6
Coa7,2,8,232,242,-6
Ndufa4,8,14,220,242,-6
Gsto1,7,13,222,242,-6
Wnt3a,0,6,236,242,-6
Atpaf1,3,9,230,242,-6
Ndp,5,11,226,242,-6
Itln1,5,11,226,242,-6
Slc35f5,4,10,228,242,-6
Rnaseh1,2,8,232,242,-6
Amotl1,2,8,232,242,-6
Mfsd13b,14,20,208,242,-6
Wnk1,6,12,224,242,-6
Trpm5,3,9,230,242,-6
Mx1,3,9,230,242,-6
Ube2j2,3,9,230,242,-6
Vps33b,3,9,230,242,-6
Cenpl,2,8,232,242,-6
Idh2,4,10,228,242,-6
Shld1,7,13,222,242,-6
Cenpm,10,16,216,242,-6
Idh3b,3,9,230,242,-6
Cenpo,3,9,230,242,-6
Arhgef2,4,10,228,242,-6
Rfxank,2,8,232,242,-6
Il19,9,15,218,242,-6
Immp1l,3,9,230,242,-6
Ifi30,4,10,228,242,-6
Arhgef26,1,7,234,242,-6
Ttc4,2,8,232,242,-6
Ttc41,7,13,222,242,-6
Ifit3b,9,15,218,242,-6
Mrpl57,2,8,232,242,-6
Ttc8,3,9,230,242,-6
Mon1a,3,9,230,242,-6
Twsg1,7,13,222,242,-6
Ide,3,9,230,242,-6
Ice1,3,9,230,242,-6
Il34,7,13,222,242,-6
Vrk3,2,8,232,242,-6
Celf6,2,8,232,242,-6
Rexo1,2,8,232,242,-6
Ttc16,4,10,228,242,-6
Siglece,2,8,232,242,-6
Asrgl1,2,8,232,242,-6
Sf3a2,2,8,232,242,-6
Ms4a15,5,11,226,242,-6
Hyal4,0,6,236,242,-6
Siah3,0,6,236,242,-6
Il9,1,7,234,242,-6
Siah1a,2,8,232,242,-6
Siae,3,9,230,242,-6
Hykk,4,10,228,242,-6
Mrs2,3,9,230,242,-6
Asph,4,10,228,242,-6
Rflnb,4,10,228,242,-6
Arih2,2,8,232,242,-6
Ifrd2,3,9,230,242,-6
Ces5a,1,7,234,242,-6
Sh3bgrl,6,12,224,242,-6
Cep78,1,7,234,242,-6
Vmn2r92,0,6,236,242,-6
Vmn2r90,2,8,232,242,-6
Sh2b3,3,9,230,242,-6
Sh2b1,2,8,232,242,-6
Tuba1a,5,11,226,242,-6
Rhox11,1,7,234,242,-6
Mrm3,2,8,232,242,-6
Vmn2r76,0,6,236,242,-6
Mrgprb8,0,6,236,242,-6
Igkv3-3,2,8,232,242,-6
Mpp6,3,9,230,242,-6
Tubal3,1,7,234,242,-6
Cep41,5,11,226,242,-6
Sgcd,1,7,234,242,-6
Mpzl1,4,10,228,242,-6
Tubb6,6,12,224,242,-6
Armcx5,5,11,226,242,-6
Sh3bgrl2,2,8,232,242,-6
Rgs16,1,7,234,242,-6
Tuft1,4,10,228,242,-6
Sft2d1,3,9,230,242,-6
Mrpl46,2,8,232,242,-6
Ift43,6,12,224,242,-6
Ascl2,1,7,234,242,-6
Ift52,2,8,232,242,-6
Mrpl22,4,10,228,242,-6
Ift80,5,11,226,242,-6
Asb7,2,8,232,242,-6
Igf2bp3,0,6,236,242,-6
Ighmbp2,0,6,236,242,-6
Cep120,2,8,232,242,-6
Cerkl,5,11,226,242,-6
Rhag,2,8,232,242,-6
Asb4,4,10,228,242,-6
Rhbdd2,2,8,232,242,-6
Sh3bp2,5,11,226,242,-6
Igsf9b,1,7,234,242,-6
Ttc14,2,8,232,242,-6
Sike1,4,10,228,242,-6
Ints4,3,9,230,242,-6
Wbp4,2,8,232,242,-6
Mtrf1,3,9,230,242,-6
Hk1,3,9,230,242,-6
Hltf,3,9,230,242,-6
Cdkl5,7,13,222,242,-6
Hmces,3,9,230,242,-6
Cdkn2a,6,12,224,242,-6
Slc12a4,2,8,232,242,-6
Hmgb1,3,9,230,242,-6
Hmgcll1,3,9,230,242,-6
Retreg3,2,8,232,242,-6
Mtmr2,2,8,232,242,-6
Wbp1,2,8,232,242,-6
Ap1s1,2,8,232,242,-6
Mkrn2,2,8,232,242,-6
Mthfs,10,16,216,242,-6
Mthfd2l,5,11,226,242,-6
Hmmr,2,8,232,242,-6
Chmp6,2,8,232,242,-6
Slc15a4,3,9,230,242,-6
Hira,2,8,232,242,-6
Tsc1,2,8,232,242,-6
Ano7,3,9,230,242,-6
Hes3,3,9,230,242,-6
Hexdc,3,9,230,242,-6
Rbp2,11,17,214,242,-6
Hexim1,2,8,232,242,-6
Wdr20,5,11,226,242,-6
Ints2,5,11,226,242,-6
Mup3,2,8,232,242,-6
Hgh1,2,8,232,242,-6
Hgs,5,11,226,242,-6
Hhat,2,8,232,242,-6
Hibadh,3,9,230,242,-6
Mul1,2,8,232,242,-6
Mucl1,0,6,236,242,-6
Slc16a8,2,8,232,242,-6
Muc15,3,9,230,242,-6
Wdr11,2,8,232,242,-6
Hif1an,2,8,232,242,-6
Hnf1b,2,8,232,242,-6
Hnrnpa1,3,9,230,242,-6
Mlkl,2,8,232,242,-6
Setdb1,2,8,232,242,-6
Hs3st4,0,6,236,242,-6
Msra,3,9,230,242,-6
Arf3,2,8,232,242,-6
Cfhr1,5,11,226,242,-6
Msl1,2,8,232,242,-6
Tst,6,12,224,242,-6
Msi1,0,6,236,242,-6
Sirpb1a,3,9,230,242,-6
Hsdl2,2,8,232,242,-6
Hsf1,3,9,230,242,-6
Arfgap1,2,8,232,242,-6
Arfgap2,3,9,230,242,-6
Hsfy2,0,6,236,242,-6
Hspa12a,3,9,230,242,-6
Hspa13,5,11,226,242,-6
Txndc12,4,10,228,242,-6
Sez6,1,7,234,242,-6
Arel1,4,10,228,242,-6
Mmut,2,8,232,242,-6
Apbb1ip,1,7,234,242,-6
Cftr,2,8,232,242,-6
Mmaa,3,9,230,242,-6
Ceacam20,2,8,232,242,-6
Mmadhc,2,8,232,242,-6
Inafm1,4,10,228,242,-6
Hoxc5,0,6,236,242,-6
Chd8,5,11,226,242,-6
Rela,2,8,232,242,-6
Apon,7,13,222,242,-6
Atad5,0,6,236,242,-6
Setd4,6,12,224,242,-6
Champ1,2,8,232,242,-6
mt-Nd1,11,17,214,242,-6
Vmn2r4,0,6,236,242,-6
Appl1,4,10,228,242,-6
Vta1,3,9,230,242,-6
Aprt,3,9,230,242,-6
Atad1,4,10,228,242,-6
Rnf145,2,8,232,242,-6
Guca1a,8,14,220,242,-6
Slurp1,7,13,222,242,-6
Smad2,2,8,232,242,-6
Kctd17,2,8,232,242,-6
Cct6b,4,10,228,242,-6
Nol11,2,8,232,242,-6
Nol4l,3,9,230,242,-6
Nomo1,2,8,232,242,-6
Gm8765,0,6,236,242,-6
Nudcd1,3,9,230,242,-6
Maz,3,9,230,242,-6
Gm5724,0,6,236,242,-6
Ptms,3,9,230,242,-6
Csta2,25,31,186,242,-6
Tpo,0,6,236,242,-6
Kctd13,3,9,230,242,-6
Nub1,2,8,232,242,-6
Nop10,4,10,228,242,-6
Zc3hav1l,0,6,236,242,-6
Cstdc5,1,7,234,242,-6
Cstf1,4,10,228,242,-6
Cstf2,3,9,230,242,-6
Rnf220,2,8,232,242,-6
Mbd3,2,8,232,242,-6
Cd55,4,10,228,242,-6
Trav13-5,18,24,200,242,-6
Notch4,2,8,232,242,-6
Nox4,4,10,228,242,-6
Ctdp1,2,8,232,242,-6
Kcnab3,0,6,236,242,-6
Kcnb2,0,6,236,242,-6
Cd40,4,10,228,242,-6
Afg3l1,2,8,232,242,-6
Gm8879,6,12,224,242,-6
Ntrk2,2,8,232,242,-6
Cd69,6,12,224,242,-6
Tpbpa,13,19,210,242,-6
Cryz,3,9,230,242,-6
Gm9789,0,6,236,242,-6
Cryzl1,4,10,228,242,-6
Slitrk1,0,6,236,242,-6
Zcchc3,1,7,234,242,-6
Csad,2,8,232,242,-6
Nme9,5,11,226,242,-6
Kctd20,3,9,230,242,-6
Ddit4l,6,12,224,242,-6
Yipf4,2,8,232,242,-6
Gm9603,6,12,224,242,-6
Ddhd2,3,9,230,242,-6
Csl,2,8,232,242,-6
Acyp2,5,11,226,242,-6
Ptgs1,6,12,224,242,-6
Vmn1r38,1,7,234,242,-6
Csn2,4,10,228,242,-6
Dctn2,2,8,232,242,-6
Csnk1e,2,8,232,242,-6
Csnk1g1,4,10,228,242,-6
Nudt15,1,7,234,242,-6
Cables2,3,9,230,242,-6
Nudt12,6,12,224,242,-6
Afm,2,8,232,242,-6
Gm8890,4,10,228,242,-6
Nmrk2,4,10,228,242,-6
Cspg4,2,8,232,242,-6
Nob1,4,10,228,242,-6
Dcaf8,2,8,232,242,-6
Adprh,3,9,230,242,-6
Acy1,2,8,232,242,-6
Trak2,3,9,230,242,-6
Adam24,0,6,236,242,-6
Cwf19l2,2,8,232,242,-6
Bad,4,10,228,242,-6
Cxcl5,11,17,214,242,-6
Nsmce1,2,8,232,242,-6
Cd274,4,10,228,242,-6
Gm7995,9,15,218,242,-6
Gm6569,2,8,232,242,-6
Ptprj,2,8,232,242,-6
Ubqln4,2,8,232,242,-6
Smpdl3a,3,9,230,242,-6
Ptprq,3,9,230,242,-6
Adam3,6,12,224,242,-6
Zbtb8os,2,8,232,242,-6
Cd37,9,15,218,242,-6
Cypt3,5,11,226,242,-6
Nr6a1,0,6,236,242,-6
Pura,2,8,232,242,-6
Bahcc1,1,7,234,242,-6
Adam34l,0,6,236,242,-6
Cyp2b19,0,6,236,242,-6
Smim7,3,9,230,242,-6
Nrbf2,3,9,230,242,-6
Ptrh2,2,8,232,242,-6
Zbtb41,6,12,224,242,-6
Bag5,2,8,232,242,-6
Vmn1r47,2,8,232,242,-6
Cyp39a1,2,8,232,242,-6
Zbtb42,4,10,228,242,-6
D930048N14Rik,0,6,236,242,-6
Ublcp1,5,11,226,242,-6
Gm8246,0,6,236,242,-6
Dab2,7,13,222,242,-6
Adora3,7,13,222,242,-6
Smc2,3,9,230,242,-6
Ntng1,2,8,232,242,-6
Cd160,4,10,228,242,-6
Gm5935,1,7,234,242,-6
Dcaf11,3,9,230,242,-6
Dbn1,3,9,230,242,-6
Smco2,1,7,234,242,-6
Ubtd2,7,13,222,242,-6
Dazap1,4,10,228,242,-6
Ctsl,6,12,224,242,-6
Gm6034,5,11,226,242,-6
Sele,1,7,234,242,-6
Kcne2,5,11,226,242,-6
Kcnk7,4,10,228,242,-6
Cttnbp2,5,11,226,242,-6
Ptpn4,5,11,226,242,-6
Pxdn,4,10,228,242,-6
Ubr3,2,8,232,242,-6
Adgrg5,1,7,234,242,-6
Gm6176,3,9,230,242,-6
Seh1l,2,8,232,242,-6
Ubl7,3,9,230,242,-6
Smyd2,2,8,232,242,-6
Ak6,5,11,226,242,-6
Dap3,2,8,232,242,-6
Cwc15,5,11,226,242,-6
Npy5r,2,8,232,242,-6
Nr1d2,3,9,230,242,-6
Gm9833,12,18,212,242,-6
Mdm1,2,8,232,242,-6
Zbtb43,7,13,222,242,-6
Deaf1,3,9,230,242,-6
Cpsf4l,7,13,222,242,-6
Actr8,2,8,232,242,-6
Rab3d,3,9,230,242,-6
Ago3,4,10,228,242,-6
Top3b,3,9,230,242,-6
Cpq,4,10,228,242,-6
Trav6n-6,4,10,228,242,-6
Slc6a9,5,11,226,242,-6
Gpatch3,2,8,232,242,-6
Kat8,5,11,226,242,-6
Ddx59,3,9,230,242,-6
Xrcc5,2,8,232,242,-6
Ddx60,4,10,228,242,-6
Kdm2b,2,8,232,242,-6
Vmn1r54,1,7,234,242,-6
Zdhhc2,7,13,222,242,-6
Crtam,2,8,232,242,-6
Ybx3,2,8,232,242,-6
Katnal1,5,11,226,242,-6
AI429214,5,11,226,242,-6
Nln,2,8,232,242,-6
Actr3b,0,6,236,242,-6
Med22,2,8,232,242,-6
Nipal4,0,6,236,242,-6
Rab36,0,6,236,242,-6
Nkain1,3,9,230,242,-6
Snx17,2,8,232,242,-6
Nkd2,1,7,234,242,-6
Vmn1r58,0,6,236,242,-6
Sdhb,2,8,232,242,-6
Yae1d1,3,9,230,242,-6
Rnf170,4,10,228,242,-6
Ptchd4,1,7,234,242,-6
Yipf1,2,8,232,242,-6
Cramp1l,2,8,232,242,-6
Med23,2,8,232,242,-6
Ddx58,2,8,232,242,-6
Rab29,6,12,224,242,-6
Gorasp2,2,8,232,242,-6
Nkiras2,2,8,232,242,-6
Trav8d-2,6,12,224,242,-6
Cpsf7,2,8,232,242,-6
Crip1,12,18,212,242,-6
Snx2,2,8,232,242,-6
Kansl1l,5,11,226,242,-6
Niban3,5,11,226,242,-6
Med4,2,8,232,242,-6
Ddx39a,2,8,232,242,-6
Snx32,4,10,228,242,-6
Rabep2,2,8,232,242,-6
Cox19,3,9,230,242,-6
Ak5,5,11,226,242,-6
Gmps,2,8,232,242,-6
Sntg1,1,7,234,242,-6
Cdc27,4,10,228,242,-6
Meaf6,5,11,226,242,-6
Nfe2,6,12,224,242,-6
Slc6a13,4,10,228,242,-6
Masp2,16,22,204,242,-6
Rnf157,0,6,236,242,-6
Cd82,5,11,226,242,-6
Gna12,2,8,232,242,-6
Bbs2,2,8,232,242,-6
Ddx21,2,8,232,242,-6
Tonsl,1,7,234,242,-6
Rnf148,1,7,234,242,-6
Nlrp1b,1,7,234,242,-6
Marveld1,6,12,224,242,-6
Dedd,3,9,230,242,-6
Trav4d-3,6,12,224,242,-6
Agl,2,8,232,242,-6
Aif1,14,20,208,242,-6
Rab19,4,10,228,242,-6
Trav3-4,0,6,236,242,-6
Chit1,4,11,227,242,-7
1810020O05Rik,3,10,229,242,-7
Fbxo24,3,10,229,242,-7
Vmn2r86,2,9,231,242,-7
Aplp2,3,10,229,242,-7
Asxl1,2,9,231,242,-7
Tex30,6,13,223,242,-7
Vmn2r88,2,9,231,242,-7
Cfap77,3,10,229,242,-7
Tmprss6,6,13,223,242,-7
Diaph3,1,8,233,242,-7
Cep250,3,10,229,242,-7
Ackr2,8,15,219,242,-7
Cfap70,1,8,233,242,-7
Atoh8,6,13,223,242,-7
BC049762,15,22,205,242,-7
Zc3h7b,5,12,225,242,-7
Arnt,2,9,231,242,-7
Chia1,0,7,235,242,-7
Cfap99,2,9,231,242,-7
Adam20,0,7,235,242,-7
Cep350,2,9,231,242,-7
Tomm40l,5,12,225,242,-7
Aptx,3,10,229,242,-7
Baiap3,6,13,223,242,-7
Fbxo2,9,16,217,242,-7
Aqp9,5,12,225,242,-7
Zdhhc21,4,11,227,242,-7
D930020B18Rik,2,9,231,242,-7
Fam135a,3,10,229,242,-7
Tnfsf13,8,15,219,242,-7
Vinac1,3,10,229,242,-7
Tubgcp2,2,9,231,242,-7
Disc1,1,8,233,242,-7
C9,6,13,223,242,-7
Acbd5,3,10,229,242,-7
Celf2,3,10,229,242,-7
Zbtb8a,2,9,231,242,-7
Vill,8,15,219,242,-7
Arsb,3,10,229,242,-7
Chd9,9,16,217,242,-7
2310022A10Rik,2,9,231,242,-7
Adam21,4,11,227,242,-7
Fbxl8,8,15,219,242,-7
Traf3ip3,11,18,213,242,-7
Apol7b,19,26,197,242,-7
Fbxl19,3,10,229,242,-7
Apol7a,5,12,225,242,-7
Tnc,2,9,231,242,-7
Tcf3,3,10,229,242,-7
Tmsb15a,10,17,215,242,-7
Fam13c,1,8,233,242,-7
Arl16,3,10,229,242,-7
Banf1,2,9,231,242,-7
Cfap157,2,9,231,242,-7
Fam3b,4,11,227,242,-7
Dctn6,3,10,229,242,-7
Zmynd12,2,9,231,242,-7
Dgcr2,2,9,231,242,-7
Ccr10,3,10,229,242,-7
Fam234b,3,10,229,242,-7
Zscan10,1,8,233,242,-7
Cad,3,10,229,242,-7
Chn1,2,9,231,242,-7
Tcte1,5,12,225,242,-7
1700016C15Rik,9,16,217,242,-7
Fancd2,1,8,233,242,-7
Dctd,6,13,223,242,-7
Armc6,3,10,229,242,-7
Ccdc92b,0,7,235,242,-7
Tef,5,12,225,242,-7
Zscan21,3,10,229,242,-7
1700067P10Rik,0,7,235,242,-7
Ccs,3,10,229,242,-7
Dgkz,2,9,231,242,-7
Fam3c,6,13,223,242,-7
Arhgef28,3,10,229,242,-7
Zwilch,6,13,223,242,-7
Ttll1,3,10,229,242,-7
Zcchc8,2,9,231,242,-7
Batf2,3,10,229,242,-7
Tnrc6b,6,13,223,242,-7
Arl13b,3,10,229,242,-7
Fam81b,0,7,235,242,-7
Fam72a,1,8,233,242,-7
Asf1b,1,8,233,242,-7
Fam53c,2,9,231,242,-7
Acvr1b,2,9,231,242,-7
Ash2l,2,9,231,242,-7
Aspdh,5,12,225,242,-7
1700022I11Rik,11,18,213,242,-7
Tdrd6,0,7,235,242,-7
Zfp106,2,9,231,242,-7
Tdrd7,2,9,231,242,-7
1700016H13Rik,3,10,229,242,-7
Denr,3,10,229,242,-7
Cfap100,11,18,213,242,-7
Ddb1,2,9,231,242,-7
Fancb,3,10,229,242,-7
Tekt2,8,15,219,242,-7
Tekt3,1,8,233,242,-7
C130073F10Rik,6,13,223,242,-7
Faxc,2,9,231,242,-7
Ttll6,1,8,233,242,-7
Fam20a,1,8,233,242,-7
Cept1,3,10,229,242,-7
Degs2,6,13,223,242,-7
1700113H08Rik,1,8,233,242,-7
Cep85l,2,9,231,242,-7
Dcdc2b,13,20,209,242,-7
Dcbld1,2,9,231,242,-7
1600014C23Rik,18,25,199,242,-7
Acsm3,3,10,229,242,-7
Fam221b,0,7,235,242,-7
Cfap53,8,15,219,242,-7
Bard1,0,7,235,242,-7
Zup1,3,10,229,242,-7
Tprn,2,9,231,242,-7
Btrc,3,10,229,242,-7
Ccdc88b,3,10,229,242,-7
1700123K08Rik,6,13,223,242,-7
Dhx29,2,9,231,242,-7
Cep68,3,10,229,242,-7
Ttll5,3,10,229,242,-7
C8b,0,7,235,242,-7
Zeb1,6,13,223,242,-7
Bud23,4,11,227,242,-7
1700084M14Rik,7,14,221,242,-7
1700086D15Rik,5,12,225,242,-7
Fam219b,2,9,231,242,-7
Fancl,2,9,231,242,-7
1700012B09Rik,13,20,209,242,-7
Zdhhc11,1,8,233,242,-7
Tenm3,3,10,229,242,-7
Ccl28,3,10,229,242,-7
Arhgap33os,2,9,231,242,-7
Vmn2r5,1,8,233,242,-7
Acsl5,2,9,231,242,-7
Cacnb2,1,8,233,242,-7
Calhm3,3,10,229,242,-7
Cenpc1,2,9,231,242,-7
Zkscan2,0,7,235,242,-7
Fastk,2,9,231,242,-7
Tent5b,5,12,225,242,-7
BC005624,2,9,231,242,-7
Cfap46,2,9,231,242,-7
Dhrs13,2,9,231,242,-7
Tmem163,2,9,231,242,-7
Ccdc50,4,11,227,242,-7
Tmem225,0,7,235,242,-7
Cndp2,6,13,223,242,-7
Zfp365,3,10,229,242,-7
Ankar,0,7,235,242,-7
Cnmd,2,9,231,242,-7
Tm7sf3,4,11,227,242,-7
Agk,2,9,231,242,-7
B9d2,3,10,229,242,-7
Cnn2,4,11,227,242,-7
Trim27,2,9,231,242,-7
Crybg2,4,11,227,242,-7
Eif2a,4,11,227,242,-7
Tomm6,6,13,223,242,-7
Zfp383,4,11,227,242,-7
Abca14,0,7,235,242,-7
Trav5-4,9,16,217,242,-7
Cdin1,2,9,231,242,-7
Cryaa,3,10,229,242,-7
Ccdc181,2,9,231,242,-7
Zfp629,9,16,217,242,-7
Tmc1,4,11,227,242,-7
Aasdhppt,3,10,229,242,-7
Ubac1,2,9,231,242,-7
Best1,3,10,229,242,-7
Aarsd1,3,10,229,242,-7
Eif1ad11,9,16,217,242,-7
Dtl,4,11,227,242,-7
Ankra2,2,9,231,242,-7
Dnaaf3,1,8,233,242,-7
Vmn1r19,1,8,233,242,-7
Triml1,0,7,235,242,-7
Clec4a4,7,14,221,242,-7
Drc3,4,11,227,242,-7
Usp21,2,9,231,242,-7
Zfp712,1,8,233,242,-7
Bola3,2,9,231,242,-7
Csmd3,0,7,235,242,-7
Clpp,2,9,231,242,-7
Trim55,1,8,233,242,-7
Dse,4,11,227,242,-7
Dsg1a,0,7,235,242,-7
Usp2,4,11,227,242,-7
Clptm1l,2,9,231,242,-7
Ankrd16,2,9,231,242,-7
Trim46,8,15,219,242,-7
Vmn2r114,2,9,231,242,-7
Aga,7,14,221,242,-7
Agbl2,2,9,231,242,-7
Cdk1,9,16,217,242,-7
Ankrd12,2,9,231,242,-7
Cmss1,2,9,231,242,-7
Cc2d1b,2,9,231,242,-7
Cmtm2a,4,11,227,242,-7
Fbxo38,2,9,231,242,-7
Zfp688,2,9,231,242,-7
Eif1ad10,11,18,213,242,-7
Aars2,2,9,231,242,-7
Zfp62,4,11,227,242,-7
Ccdc107,3,10,229,242,-7
B3gntl1,2,9,231,242,-7
Dynlt2a3,40,47,155,242,-7
Agr3,1,8,233,242,-7
Edem2,2,9,231,242,-7
Zfp566,2,9,231,242,-7
Ccdc146,2,9,231,242,-7
B3glct,3,10,229,242,-7
Vmn1r21,0,7,235,242,-7
Ahctf1,4,11,227,242,-7
Commd10,2,9,231,242,-7
Alas1,4,11,227,242,-7
Ahrr,0,7,235,242,-7
Commd6,4,11,227,242,-7
AW146154,3,10,229,242,-7
Ccdc130,7,14,221,242,-7
B3gat2,4,11,227,242,-7
Trbv31,7,14,221,242,-7
Cox5a,3,10,229,242,-7
Cox20,4,11,227,242,-7
Zfp526,2,9,231,242,-7
E2f2,0,7,235,242,-7
Cops7b,2,9,231,242,-7
Zfp524,4,11,227,242,-7
Tmem161b,8,15,219,242,-7
Coro1c,2,9,231,242,-7
Xylt2,3,10,229,242,-7
Ube2dnl1,2,9,231,242,-7
9530003J23Rik,5,12,225,242,-7
Atpaf2,2,9,231,242,-7
Amer3,0,7,235,242,-7
Cntd1,2,9,231,242,-7
Ccdc112,3,10,229,242,-7
Tmco6,2,9,231,242,-7
Ubap1,2,9,231,242,-7
Tmed6,6,13,223,242,-7
Cntn6,1,8,233,242,-7
Ccdc174,4,11,227,242,-7
Coa5,4,11,227,242,-7
Zfp606,2,9,231,242,-7
Ccdc171,1,8,233,242,-7
Coch,2,9,231,242,-7
Cdc5l,2,9,231,242,-7
Efcab12,2,9,231,242,-7
Creb3l4,4,11,227,242,-7
Alg6,4,11,227,242,-7
Ccdc167,2,9,231,242,-7
Agpat3,3,10,229,242,-7
Cog6,2,9,231,242,-7
Cog7,2,9,231,242,-7
Eef1e1,4,11,227,242,-7
Agpat5,2,9,231,242,-7
9430015G10Rik,2,9,231,242,-7
Dynlrb2,9,16,217,242,-7
Dpysl3,2,9,231,242,-7
Zfp326,3,10,229,242,-7
Dpp3,3,10,229,242,-7
Zfp930,5,12,225,242,-7
Brd8dc,8,15,219,242,-7
Cyb5d1,6,13,223,242,-7
Cyb561d2,5,12,225,242,-7
Tsacc,9,16,217,242,-7
Cyb561a3,2,9,231,242,-7
Cxcl9,5,12,225,242,-7
Ccdc43,2,9,231,242,-7
Ano5,0,7,235,242,-7
Unc13a,0,7,235,242,-7
4930433I11Rik,0,7,235,242,-7
Tmem79,3,10,229,242,-7
Tram2,1,8,233,242,-7
Exoc3,4,11,227,242,-7
Cwc22,2,9,231,242,-7
Ccdc42,2,9,231,242,-7
Casp7,5,12,225,242,-7
Zfp938,4,11,227,242,-7
Ubl5b,20,27,195,242,-7
Zfp936,8,15,219,242,-7
Trpm4,5,12,225,242,-7
Trappc3,2,9,231,242,-7
Cideb,12,19,211,242,-7
Etv3,2,9,231,242,-7
Ethe1,3,10,229,242,-7
Atp5g3,2,9,231,242,-7
Ano8,1,8,233,242,-7
Zfp952,5,12,225,242,-7
Tsc2,2,9,231,242,-7
Ezh2,5,12,225,242,-7
Tymp,1,8,233,242,-7
Tex48,5,12,225,242,-7
Chpf2,2,9,231,242,-7
Acad9,2,9,231,242,-7
Capn8,1,8,233,242,-7
Adamts5,3,10,229,242,-7
Tfam,3,10,229,242,-7
Zfp963,4,11,227,242,-7
Dnah6,0,7,235,242,-7
Zbtb39,4,11,227,242,-7
Anxa1,5,12,225,242,-7
Cdkn2c,2,9,231,242,-7
Chrnb2,0,7,235,242,-7
Dnah7c,1,8,233,242,-7
Wdfy3,2,9,231,242,-7
Tsga8,0,7,235,242,-7
Cyb5r4,2,9,231,242,-7
Adarb2,0,7,235,242,-7
Tsen54,3,10,229,242,-7
Eya4,1,8,233,242,-7
Tsen2,3,10,229,242,-7
Dnai3,0,7,235,242,-7
Tsen15,2,9,231,242,-7
Tmem94,2,9,231,242,-7
Cisd1,3,10,229,242,-7
Trpc1,3,10,229,242,-7
Atp5pb,2,9,231,242,-7
Trarg1,1,8,233,242,-7
Eqtn,10,17,215,242,-7
4930579F01Rik,1,8,233,242,-7
U2surp,4,11,227,242,-7
Ung,0,7,235,242,-7
Dop1a,4,11,227,242,-7
Usp35,0,7,235,242,-7
Cldn34b2,1,8,233,242,-7
Cdk5r1,3,10,229,242,-7
Tmem267,7,14,221,242,-7
Wdr62,0,7,235,242,-7
Ephb3,1,8,233,242,-7
Catsperz,21,28,193,242,-7
Cavin2,3,10,229,242,-7
Epha6,0,7,235,242,-7
Epha5,3,10,229,242,-7
Trmt10b,5,12,225,242,-7
Zfp770,4,11,227,242,-7
Wdr73,2,9,231,242,-7
Unk,3,10,229,242,-7
Cavin4,2,9,231,242,-7
Zfp768,2,9,231,242,-7
Cldn34c2,6,13,223,242,-7
Wdr75,3,10,229,242,-7
Entpd6,2,9,231,242,-7
Ube4a,3,10,229,242,-7
Cdk5rap3,2,9,231,242,-7
Catsperg2,1,8,233,242,-7
Wdr5,4,11,227,242,-7
Usp45,3,10,229,242,-7
Zfp90,3,10,229,242,-7
Zan,3,10,229,242,-7
Zfp882,4,11,227,242,-7
4930513O06Rik,1,8,233,242,-7
Baalc,2,9,231,242,-7
Abhd12,3,10,229,242,-7
Ctrc,13,20,209,242,-7
Ermard,2,9,231,242,-7
4930522L14Rik,6,13,223,242,-7
Adnp,7,14,221,242,-7
4930544D05Rik,7,14,221,242,-7
Erich6b,0,7,235,242,-7
Ankrd9,2,9,231,242,-7
Ankub1,2,9,231,242,-7
Wdr38,6,13,223,242,-7
Dnajc8,5,12,225,242,-7
Zfp821,3,10,229,242,-7
Dnase1l1,5,12,225,242,-7
Bcl2l2,5,12,225,242,-7
Ubl4a,2,9,231,242,-7
Dnpep,2,9,231,242,-7
Erfl,2,9,231,242,-7
Zfp809,2,9,231,242,-7
Thsd1,0,7,235,242,-7
Ccdc40,1,8,233,242,-7
Stoml1,2,9,231,242,-7
Leng8,3,10,229,242,-7
Lrfn4,0,7,235,242,-7
Lrif1,4,11,227,242,-7
H2az2,3,10,229,242,-7
Slc25a54,6,13,223,242,-7
Stard6,8,15,219,242,-7
Mex3a,0,7,235,242,-7
Rtp1,0,7,235,242,-7
Gm3676,3,10,229,242,-7
Olfr1275,0,7,235,242,-7
Olfr1265,0,7,235,242,-7
Psd,6,13,223,242,-7
Rfx4,0,7,235,242,-7
Olfr1221,1,8,233,242,-7
Gm8362,6,13,223,242,-7
Rtn1,0,7,235,242,-7
Rnf103,2,9,231,242,-7
H2bc9,3,10,229,242,-7
Gm20503,12,19,211,242,-7
Gm17175,1,8,233,242,-7
Slc25a43,4,11,227,242,-7
Rusf1,2,9,231,242,-7
Smarcc2,2,9,231,242,-7
Rasl12,3,10,229,242,-7
Prss33,0,7,235,242,-7
Rasl10b,1,8,233,242,-7
Hagh,5,12,225,242,-7
Hadhb,2,9,231,242,-7
Slc25a35,4,11,227,242,-7
Olfr1356,1,8,233,242,-7
Olfr1348,5,12,225,242,-7
Prss48,5,12,225,242,-7
Lpar5,6,13,223,242,-7
Gm20390,0,7,235,242,-7
Olfr1310,4,11,227,242,-7
Rnaset2a,5,12,225,242,-7
Gm884,0,7,235,242,-7
Ncbp2,2,9,231,242,-7
Psmb11,1,8,233,242,-7
Stag3,10,17,215,242,-7
Ssxb9,2,9,231,242,-7
Ssxb8,5,12,225,242,-7
Ncoa6,4,11,227,242,-7
Rsrc1,3,10,229,242,-7
H2-DMb2,7,14,221,242,-7
Odf2l,2,9,231,242,-7
Slx4ip,3,10,229,242,-7
Ssty2,1,8,233,242,-7
Odaph,11,18,213,242,-7
Rsph14,3,10,229,242,-7
H1f2,10,17,215,242,-7
Rslcan18,8,15,219,242,-7
Oc90,3,10,229,242,-7
Lrrc71,6,13,223,242,-7
Gm36028,9,16,217,242,-7
Slc29a2,0,7,235,242,-7
Gm20852,0,7,235,242,-7
Gm20828,0,7,235,242,-7
Slc27a4,2,9,231,242,-7
Stag2,3,10,229,242,-7
H2ac20,12,19,211,242,-7
Gm20736,7,14,221,242,-7
Rasa3,1,8,233,242,-7
Rasa2,3,10,229,242,-7
Rtel1,5,12,225,242,-7
Nckap5l,5,12,225,242,-7
Ogfr,2,9,231,242,-7
Rtcb,2,9,231,242,-7
Gm20815,1,8,233,242,-7
Gm8857,3,10,229,242,-7
Ncoa5,2,9,231,242,-7
Ogn,8,15,219,242,-7
Lrrc39,2,9,231,242,-7
Olfr2,1,8,233,242,-7
Gm17124,3,10,229,242,-7
Gm20924,1,8,233,242,-7
Olfr750,0,7,235,242,-7
Lep,4,11,227,242,-7
Olfr733,2,9,231,242,-7
Olfr731,0,7,235,242,-7
Samd7,0,7,235,242,-7
Prmt5,2,9,231,242,-7
Prmt6,3,10,229,242,-7
Mip,2,9,231,242,-7
Stx12,2,9,231,242,-7
Slc18a2,1,8,233,242,-7
Olfr676,1,8,233,242,-7
Olfr671,2,9,231,242,-7
Gm42669,5,12,225,242,-7
Prok2,6,13,223,242,-7
Olfr646,3,10,229,242,-7
Micos13,3,10,229,242,-7
Gm13941,0,7,235,242,-7
Rab40b,1,8,233,242,-7
Gm17079,10,17,215,242,-7
Gm4297,1,8,233,242,-7
Prkg1,1,8,233,242,-7
Prkra,3,10,229,242,-7
Ldlrad3,7,14,221,242,-7
Myrip,7,14,221,242,-7
Gm43191,31,38,173,242,-7
Gm8082,0,7,235,242,-7
Spaca4,11,18,213,242,-7
Gm13271,10,17,215,242,-7
Slc16a5,5,12,225,242,-7
Mlf2,2,9,231,242,-7
Olfr775,1,8,233,242,-7
Samt4,0,7,235,242,-7
Samt2b,1,8,233,242,-7
Slc16a6,4,11,227,242,-7
Prl3d2,3,10,229,242,-7
Prorp,3,10,229,242,-7
Olfr607,1,8,233,242,-7
Mgat1,2,9,231,242,-7
Samd10,2,9,231,242,-7
Smc5,3,10,229,242,-7
Mfsd5,2,9,231,242,-7
Ston2,4,11,227,242,-7
Rnase6,3,10,229,242,-7
Gm8247,2,9,231,242,-7
Gm4125,4,11,227,242,-7
Lmbr1l,2,9,231,242,-7
Olfr30,1,8,233,242,-7
Lmod2,0,7,235,242,-7
Stmn1,6,13,223,242,-7
Gm16405,5,12,225,242,-7
Has3,2,9,231,242,-7
Gm16440,3,10,229,242,-7
Gm3839,5,12,225,242,-7
Gm17027,0,7,235,242,-7
Gm14819,0,7,235,242,-7
Slc23a4,1,8,233,242,-7
Gm14525,2,9,231,242,-7
Limch1,5,12,225,242,-7
Gm14409,13,20,209,242,-7
Olfr51,1,8,233,242,-7
Lhb,5,12,225,242,-7
Rmnd1,4,11,227,242,-7
Mfsd9,3,10,229,242,-7
Heatr9,1,8,233,242,-7
Sacs,1,8,233,242,-7
Lin9,4,11,227,242,-7
Gm14444,18,25,199,242,-7
Slc22a21,6,13,223,242,-7
Sacm1l,4,11,227,242,-7
Saal1,1,8,233,242,-7
Olfr374,0,7,235,242,-7
Smc6,2,9,231,242,-7
Oard1,2,9,231,242,-7
Lrriq3,4,11,227,242,-7
Gm43720,2,9,231,242,-7
Nr2c1,2,9,231,242,-7
Gmnc,4,11,227,242,-7
Nr1h5,1,8,233,242,-7
Slc66a1,3,10,229,242,-7
Mecom,7,14,221,242,-7
Meak7,3,10,229,242,-7
Spopfm3,2,9,231,242,-7
Pwwp4d,0,7,235,242,-7
Gpr139,0,7,235,242,-7
Nptxr,0,7,235,242,-7
Map2k5,3,10,229,242,-7
Rabl3,2,9,231,242,-7
Pxt1,15,22,205,242,-7
Slc6a16,3,10,229,242,-7
Rabif,2,9,231,242,-7
Rpl22l1,4,11,227,242,-7
Nemp2,1,8,233,242,-7
Gpr156,0,7,235,242,-7
Gm29427,5,12,225,242,-7
Speer2,1,8,233,242,-7
Nrd1,2,9,231,242,-7
Slfn8,4,11,227,242,-7
Lzts1,4,11,227,242,-7
Puf60,3,10,229,242,-7
Gpsm1,3,10,229,242,-7
Rag2,2,9,231,242,-7
Rad51b,1,8,233,242,-7
Gmip,5,12,225,242,-7
Spred3,1,8,233,242,-7
Rad23a,2,9,231,242,-7
Macroh2a2,2,9,231,242,-7
Nemp1,2,9,231,242,-7
Mageb1,4,11,227,242,-7
Specc1l,2,9,231,242,-7
Sppl2b,2,9,231,242,-7
Npepl1,4,11,227,242,-7
Slc6a6,2,9,231,242,-7
Slc6a7,0,7,235,242,-7
Nop9,3,10,229,242,-7
Slco1a5,2,9,231,242,-7
Nlrp14,0,7,235,242,-7
Rab24,3,10,229,242,-7
Mbip,2,9,231,242,-7
Nktr,3,10,229,242,-7
Gm3327,2,9,231,242,-7
Gng3,3,10,229,242,-7
Nipsnap3a,1,8,233,242,-7
Mbtps2,3,10,229,242,-7
Nipa1,4,11,227,242,-7
Mccc2,2,9,231,242,-7
Sphk2,2,9,231,242,-7
Rab3il1,3,10,229,242,-7
Gm3409,2,9,231,242,-7
Nim1k,0,7,235,242,-7
Gnal,4,11,227,242,-7
Gnpda2,5,12,225,242,-7
Ngly1,3,10,229,242,-7
Slco6c1,5,12,225,242,-7
Gpatch2,2,9,231,242,-7
Rpia,3,10,229,242,-7
Mapk12,3,10,229,242,-7
Gpatch1,3,10,229,242,-7
Slc7a13,4,11,227,242,-7
Gpat2,1,8,233,242,-7
Nmnat1,2,9,231,242,-7
Ngdn,2,9,231,242,-7
Gm3164,4,11,227,242,-7
Gp1ba,4,11,227,242,-7
Me2,5,12,225,242,-7
Spinkl,5,12,225,242,-7
Gnai3,2,9,231,242,-7
Slc7a6,3,10,229,242,-7
Gm2956,6,13,223,242,-7
Gpsm3,4,11,227,242,-7
Rnf146,2,9,231,242,-7
Megf9,3,10,229,242,-7
Gtdc1,2,9,231,242,-7
Pter,9,16,217,242,-7
Ralyl,2,9,231,242,-7
Gstt2,4,11,227,242,-7
Lsm8,3,10,229,242,-7
Gm9758,3,10,229,242,-7
Numbl,0,7,235,242,-7
Rpusd1,1,8,233,242,-7
Gm3550,4,11,227,242,-7
Srp9,3,10,229,242,-7
Luzp1,2,9,231,242,-7
Gm21830,9,16,217,242,-7
Spcs3,2,9,231,242,-7
Nudt6,3,10,229,242,-7
Luzp4,4,11,227,242,-7
Slc35g2,1,8,233,242,-7
Ranbp1,2,9,231,242,-7
Gramd1a,3,10,229,242,-7
Gtf2h5,3,10,229,242,-7
Nxpe2,5,12,225,242,-7
Ndufa5,2,9,231,242,-7
Gm21118,0,7,235,242,-7
Gtsf2,2,9,231,242,-7
Ssbp4,4,11,227,242,-7
Lsm11,1,8,233,242,-7
Gm21425,0,7,235,242,-7
Rrm2,6,13,223,242,-7
Meig1,16,23,203,242,-7
Srsf6,2,9,231,242,-7
Gtpbp2,3,10,229,242,-7
Gm21586,10,17,215,242,-7
Ndufaf3,6,13,223,242,-7
Slc35d1,2,9,231,242,-7
Gtf3c1,3,10,229,242,-7
Nucb2,4,11,227,242,-7
Srl,3,10,229,242,-7
Gsta3,4,11,227,242,-7
Ndufb7,2,9,231,242,-7
Slc41a2,6,13,223,242,-7
Lyrm1,5,12,225,242,-7
Spryd7,3,10,229,242,-7
Lysmd2,2,9,231,242,-7
Med24,2,9,231,242,-7
Nsa2,4,11,227,242,-7
Gramd3,3,10,229,242,-7
Nrp2,2,9,231,242,-7
Gramd1c,2,9,231,242,-7
Gm28710,1,8,233,242,-7
Rps11,6,13,223,242,-7
Nrf1,2,9,231,242,-7
Gm2888,2,9,231,242,-7
Rprd2,2,9,231,242,-7
Lztr1,3,10,229,242,-7
Nsmaf,2,9,231,242,-7
Ndufc2,4,11,227,242,-7
Ptpre,4,11,227,242,-7
Nsun2,2,9,231,242,-7
Gm21882,0,7,235,242,-7
Nubp1,3,10,229,242,-7
Rps6ka1,3,10,229,242,-7
Ly6m,8,15,219,242,-7
Spdef,3,10,229,242,-7
Gm9774,17,24,201,242,-7
Rps27a,3,10,229,242,-7
Lyplal1,6,13,223,242,-7
Gm266,2,9,231,242,-7
Lypd10,2,9,231,242,-7
Gm26920,21,28,193,242,-7
Rnf169,2,9,231,242,-7
Rps23,4,11,227,242,-7
Grk1,0,7,235,242,-7
Hivep3,0,7,235,242,-7
Gm3415,2,9,231,242,-7
Smim14,4,11,227,242,-7
Snx14,2,9,231,242,-7
Gm50367,15,22,205,242,-7
Pkp1,0,7,235,242,-7
Pde6d,6,13,223,242,-7
Ighv1-76,6,13,223,242,-7
Ighv1-84,4,11,227,242,-7
Sh2d3c,3,10,229,242,-7
Ppm1a,5,12,225,242,-7
Kif23,3,10,229,242,-7
Ighv10-3,5,12,225,242,-7
Pdik1l,7,14,221,242,-7
Sdad1,3,10,229,242,-7
Tab1,2,9,231,242,-7
Mrnip,4,11,227,242,-7
Fgf3,3,10,229,242,-7
Kif11,1,8,233,242,-7
Sdha,3,10,229,242,-7
Galk1,2,9,231,242,-7
Gadl1,2,9,231,242,-7
Pkmyt1,1,8,233,242,-7
Mtbp,2,9,231,242,-7
Pdpr,4,11,227,242,-7
Jph3,3,10,229,242,-7
Khk,2,9,231,242,-7
Pdzd4,0,7,235,242,-7
Igkv4-90,8,15,219,242,-7
Ppdpf,5,12,225,242,-7
Ppcdc,4,11,227,242,-7
Khdc3,5,12,225,242,-7
Pp2d1,1,8,233,242,-7
Snx1,2,9,231,242,-7
Gatb,4,11,227,242,-7
Fgf23,2,9,231,242,-7
Kifc1,6,13,223,242,-7
Gatm,6,13,223,242,-7
Mplkip,3,10,229,242,-7
Katnal2,6,13,223,242,-7
Mpp2,0,7,235,242,-7
Ms4a12,0,7,235,242,-7
Gfra2,0,7,235,242,-7
Sypl,4,11,227,242,-7
Gfer,4,11,227,242,-7
Ifnar1,3,10,229,242,-7
Rhot1,2,9,231,242,-7
Syt10,0,7,235,242,-7
Gm6882,9,16,217,242,-7
Senp8,3,10,229,242,-7
Ift172,5,12,225,242,-7
Ift20,2,9,231,242,-7
Plxdc1,3,10,229,242,-7
Mrap2,2,9,231,242,-7
Gdpd5,3,10,229,242,-7
Mrgpre,1,8,233,242,-7
Pde1c,3,10,229,242,-7
Mtfp1,2,9,231,242,-7
Rhobtb1,2,9,231,242,-7
Gm49776,20,27,195,242,-7
Smpd4,6,13,223,242,-7
Gm5622,0,7,235,242,-7
Gcnt4,1,8,233,242,-7
Gm49948,6,13,223,242,-7
Reck,3,10,229,242,-7
Tbc1d7,4,11,227,242,-7
Pla2g2c,1,8,233,242,-7
Sgf29,3,10,229,242,-7
Tbc1d2b,6,13,223,242,-7
Pdcd10,4,11,227,242,-7
Mrpl35,2,9,231,242,-7
Phka2,6,13,223,242,-7
Kcnj6,3,10,229,242,-7
Fnbp1l,2,9,231,242,-7
Insig2,5,12,225,242,-7
Ms4a4c,16,23,203,242,-7
Sec61g,5,12,225,242,-7
Phykpl,2,9,231,242,-7
Secisbp2,2,9,231,242,-7
Pias3,3,10,229,242,-7
Fmnl2,2,9,231,242,-7
Kcnf1,4,11,227,242,-7
Selenbp2,18,25,199,242,-7
Flvcr2,3,10,229,242,-7
Selenof,2,9,231,242,-7
Mrpl4,2,9,231,242,-7
Sgce,4,11,227,242,-7
Gm5460,0,7,235,242,-7
Incenp,1,8,233,242,-7
Selenok,3,10,229,242,-7
Ing5,2,9,231,242,-7
Pnoc,5,12,225,242,-7
Pik3c2b,0,7,235,242,-7
Pik3cb,2,9,231,242,-7
Pik3r2,4,11,227,242,-7
Kbtbd7,2,9,231,242,-7
Fkbp2,2,9,231,242,-7
Kat6b,4,11,227,242,-7
Selenot,2,9,231,242,-7
Katnb1,3,10,229,242,-7
Pnma1,5,12,225,242,-7
Sec22c,3,10,229,242,-7
Fndc8,2,9,231,242,-7
Fnta,2,9,231,242,-7
Foxh1,4,11,227,242,-7
Pex5,2,9,231,242,-7
Sdhaf4,3,10,229,242,-7
Pmel,3,10,229,242,-7
Pfdn4,2,9,231,242,-7
Sdr42e1,4,11,227,242,-7
Mrpl47,2,9,231,242,-7
Kctd16,4,11,227,242,-7
Ikzf5,5,12,225,242,-7
Ftmt,0,7,235,242,-7
Gm6370,3,10,229,242,-7
Tbc1d13,2,9,231,242,-7
Kcnu1,4,11,227,242,-7
Msto1,2,9,231,242,-7
Sfr1,3,10,229,242,-7
Fsbp,5,12,225,242,-7
Pgap2,4,11,227,242,-7
Polrmt,2,9,231,242,-7
Polr3k,2,9,231,242,-7
Tas1r1,0,7,235,242,-7
Il1f10,1,8,233,242,-7
Sec16b,0,7,235,242,-7
Piwil1,0,7,235,242,-7
Il1f9,2,9,231,242,-7
Foxo4,2,9,231,242,-7
Pheta1,2,9,231,242,-7
Kcnk12,2,9,231,242,-7
Foxi2,0,7,235,242,-7
Phf14,5,12,225,242,-7
Poll,2,9,231,242,-7
Synj1,4,11,227,242,-7
Mrps10,2,9,231,242,-7
Klhdc7a,2,9,231,242,-7
Lats1,3,10,229,242,-7
Gm10770,3,10,229,242,-7
Oxgr1,2,9,231,242,-7
Itgb4,0,7,235,242,-7
Gm8024,5,12,225,242,-7
Lancl2,3,10,229,242,-7
Gm45021,13,20,209,242,-7
Itgb3bp,3,10,229,242,-7
Pld2,2,9,231,242,-7
Gm10643,3,10,229,242,-7
P2ry10b,9,16,217,242,-7
Hpcal4,2,9,231,242,-7
Moap1,11,18,213,242,-7
Hpf1,3,10,229,242,-7
Skap2,2,9,231,242,-7
Pabpc1,4,11,227,242,-7
Mxd4,5,12,225,242,-7
Gm7970,2,9,231,242,-7
Pabpc6,1,8,233,242,-7
Ktn1,5,12,225,242,-7
Gm10358,12,19,211,242,-7
Gm10340,6,13,223,242,-7
Hrh2,0,7,235,242,-7
Hrh4,1,8,233,242,-7
Paip2b,2,9,231,242,-7
Plcxd1,2,9,231,242,-7
Smim4,3,10,229,242,-7
Sephs2,4,11,227,242,-7
Sccpdh,4,11,227,242,-7
Mvb12b,3,10,229,242,-7
Mmp24,0,7,235,242,-7
Saysd1,4,11,227,242,-7
Gm7954,1,8,233,242,-7
Otop1,1,8,233,242,-7
Slc15a1,2,9,231,242,-7
Mmachc,4,11,227,242,-7
Sarnp,3,10,229,242,-7
Lck,4,11,227,242,-7
Gm12394,2,9,231,242,-7
Slc13a5,3,10,229,242,-7
Hmga2,2,9,231,242,-7
Prepl,5,12,225,242,-7
Gm44501,0,7,235,242,-7
Slc11a1,5,12,225,242,-7
Ric8b,3,10,229,242,-7
Gm44511,11,18,213,242,-7
Fbxo43,1,8,233,242,-7
Gm11992,2,9,231,242,-7
Gm11236,4,11,227,242,-7
Lce1a1,3,10,229,242,-7
Izumo1,3,10,229,242,-7
Gm44790,20,27,195,242,-7
Osgepl1,3,10,229,242,-7
Ostn,1,8,233,242,-7
Slamf8,6,13,223,242,-7
Lcat,4,11,227,242,-7
Gm44973,18,25,199,242,-7
Sult2a8,15,22,205,242,-7
Fbxo47,5,12,225,242,-7
Snhg11,3,10,229,242,-7
Serhl,3,10,229,242,-7
Sla2,3,10,229,242,-7
Otog,0,7,235,242,-7
Fcor,19,26,197,242,-7
Krtap6-3,0,7,235,242,-7
Pank2,3,10,229,242,-7
Kmt2d,5,12,225,242,-7
Krt73,1,8,233,242,-7
Pbx4,5,12,225,242,-7
Glipr2,2,9,231,242,-7
Izumo4,2,9,231,242,-7
Rcan3,5,12,225,242,-7
Scgb1b30,9,16,217,242,-7
Glipr1l1,2,9,231,242,-7
Tbl3,2,9,231,242,-7
Pccb,3,10,229,242,-7
Morc2b,0,7,235,242,-7
Knstrn,4,11,227,242,-7
Sycp3,13,20,209,242,-7
Jade3,4,11,227,242,-7
Rccd1,0,7,235,242,-7
Rcn2,3,10,229,242,-7
Glp2r,0,7,235,242,-7
Iqcg,1,8,233,242,-7
Mos,4,11,227,242,-7
Scgb3a2,3,10,229,242,-7
Snrk,4,11,227,242,-7
Ffar1,0,7,235,242,-7
Pcgf1,2,9,231,242,-7
Mpg,4,11,227,242,-7
Pcmtd2,3,10,229,242,-7
Smoc2,5,12,225,242,-7
Scn2b,2,9,231,242,-7
Pcp2,16,23,203,242,-7
Snrnp27,6,13,223,242,-7
Mtmr10,2,9,231,242,-7
Gimap6,7,14,221,242,-7
Pbrm1,2,9,231,242,-7
Fkbp10,4,11,227,242,-7
Kntc1,1,8,233,242,-7
Gm47189,2,9,231,242,-7
Pradc1,2,9,231,242,-7
Mrps27,2,9,231,242,-7
Gm10033,8,15,219,242,-7
Tbx15,4,11,227,242,-7
Mup14,6,13,223,242,-7
Paqr8,0,7,235,242,-7
Hvcn1,6,13,223,242,-7
Glt8d2,3,10,229,242,-7
Gm4836,2,9,231,242,-7
Mogs,2,9,231,242,-7
Plb1,0,7,235,242,-7
Ppp4r3b,3,10,229,242,-7
Kri1,2,9,231,242,-7
Tbpl1,5,12,225,242,-7
Ppp4r1,2,9,231,242,-7
Glrx5,3,10,229,242,-7
Sergef,3,10,229,242,-7
Siglec15,5,12,225,242,-7
Kpna1,3,10,229,242,-7
Pram1,3,10,229,242,-7
Arl2,3,11,228,242,-8
Arid4b,3,11,228,242,-8
Snapc1,4,12,226,242,-8
Mcub,4,12,226,242,-8
Tpx2,2,10,230,242,-8
Gm5891,2,10,230,242,-8
Slfn14,0,8,234,242,-8
Mrps16,2,10,230,242,-8
Crybg1,2,10,230,242,-8
Snapin,4,12,226,242,-8
Gmppa,3,11,228,242,-8
Cry2,2,10,230,242,-8
Rnf43,0,8,234,242,-8
Slco6d1,0,8,234,242,-8
Dbr1,3,11,228,242,-8
Crot,3,11,228,242,-8
Mrps18c,6,14,222,242,-8
Arsi,1,9,232,242,-8
Rgs19,3,11,228,242,-8
Gm8297,4,12,226,242,-8
Asic1,1,9,232,242,-8
Atraid,5,13,224,242,-8
Rnaseh2c,2,10,230,242,-8
Smarcc1,3,11,228,242,-8
Ctdsp2,2,10,230,242,-8
Ctf1,4,12,226,242,-8
Mok,5,13,224,242,-8
Ctla2b,12,20,210,242,-8
Asphd1,3,11,228,242,-8
Smarcd1,3,11,228,242,-8
Rnaseh2a,2,10,230,242,-8
Mob2,4,12,226,242,-8
Atp8b5,3,11,228,242,-8
Smim38,13,21,208,242,-8
Gm7980,0,8,234,242,-8
Gm8020,0,8,234,242,-8
Mns1,12,20,210,242,-8
Gm8180,0,8,234,242,-8
Mgat4d,0,8,234,242,-8
Vmn2r129,1,9,232,242,-8
Atp2b4,9,17,216,242,-8
Smg9,4,12,226,242,-8
Atp11b,2,10,230,242,-8
Smim20,4,12,226,242,-8
Mipol1,2,10,230,242,-8
Mkrn3,2,10,230,242,-8
Cxcl16,3,11,228,242,-8
Atxn1l,5,13,224,242,-8
Gm8356,6,14,222,242,-8
B4galt4,6,14,222,242,-8
Gm7361,3,11,228,242,-8
Traf1,3,11,228,242,-8
Mrpl23,4,12,226,242,-8
Mrpl13,3,11,228,242,-8
Mroh9,1,9,232,242,-8
Mroh8,4,12,226,242,-8
Armt1,2,10,230,242,-8
Mroh5,1,9,232,242,-8
Arntl2,1,9,232,242,-8
Gm6482,2,10,230,242,-8
Rhd,3,11,228,242,-8
Mroh4,1,9,232,242,-8
Gm6588,1,9,232,242,-8
D2hgdh,9,17,216,242,-8
B3galnt2,3,11,228,242,-8
Traj19,0,8,234,242,-8
Sltm,2,10,230,242,-8
Mlxip,2,10,230,242,-8
Mettl17,9,17,216,242,-8
AU040320,3,11,228,242,-8
D11Wsu47e,2,10,230,242,-8
Slxl1,2,10,230,242,-8
Arv1,3,11,228,242,-8
Trav14-2,3,11,228,242,-8
Rhot2,3,11,228,242,-8
Vmn2r68,0,8,234,242,-8
Atxn7l2,3,11,228,242,-8
Cstad,11,19,212,242,-8
Plekhn1,3,11,228,242,-8
C3ar1,3,11,228,242,-8
Slc9c1,0,8,234,242,-8
Tssk1,1,9,232,242,-8
Hsd3b4,14,22,206,242,-8
Hsdl1,4,12,226,242,-8
Kras,2,10,230,242,-8
Kpnb1,2,10,230,242,-8
Uqcr11,2,10,230,242,-8
Hspb9,9,17,216,242,-8
Cfap58,2,10,230,242,-8
Ccdc17,1,9,232,242,-8
Hyal6,0,8,234,242,-8
Hyls1,2,10,230,242,-8
Cfap44,6,14,222,242,-8
Ccdc178,0,8,234,242,-8
Ccdc18,1,9,232,242,-8
Idh3a,5,13,224,242,-8
Ccdc28a,7,15,220,242,-8
Iffo1,2,10,230,242,-8
Ifi47,9,17,216,242,-8
Klhdc1,3,11,228,242,-8
Ifitm7,4,12,226,242,-8
Klf5,3,11,228,242,-8
Ccdc47,2,10,230,242,-8
Kl,4,12,226,242,-8
Ccdc60,3,11,228,242,-8
Tssk4,5,13,224,242,-8
Ccdc121,1,9,232,242,-8
Sh3yl1,2,10,230,242,-8
Krtcap3,5,13,224,242,-8
Chrnb3,1,9,232,242,-8
Usp48,2,10,230,242,-8
Chrna9,5,13,224,242,-8
Chrna5,0,8,234,242,-8
Ldlr,2,10,230,242,-8
Catspere1,0,8,234,242,-8
Ldb1,4,12,226,242,-8
Lce6a,2,10,230,242,-8
Hmgn2,2,10,230,242,-8
Lce3c,5,13,224,242,-8
Cbl,5,13,224,242,-8
Slamf9,3,11,228,242,-8
Cbln3,0,8,234,242,-8
Lca5,3,11,228,242,-8
Lat,8,16,218,242,-8
Cc2d2b,7,15,220,242,-8
Tspan3,2,10,230,242,-8
Lamtor3-ps,4,12,226,242,-8
Lamtor2,2,10,230,242,-8
Lamp5,3,11,228,242,-8
Scamp4,2,10,230,242,-8
Chaf1b,3,11,228,242,-8
Scamp5,11,19,212,242,-8
Ccdc71,2,10,230,242,-8
Ift74,2,10,230,242,-8
Lefty2,1,9,232,242,-8
Kcnj2,2,10,230,242,-8
Kcnc2,0,8,234,242,-8
Setdb2,4,12,226,242,-8
Impa2,2,10,230,242,-8
Setd3,2,10,230,242,-8
Inha,7,15,220,242,-8
Inka2,1,9,232,242,-8
Ino80c,2,10,230,242,-8
Cdc20b,7,15,220,242,-8
Cdkl3,2,10,230,242,-8
Kansl3,5,13,224,242,-8
Senp7,2,10,230,242,-8
Ipp,5,13,224,242,-8
Sephs1,2,10,230,242,-8
Iqcd,1,9,232,242,-8
Jazf1,1,9,232,242,-8
Iqub,0,8,234,242,-8
Serf1,7,15,220,242,-8
Cdc45,2,10,230,242,-8
Ube2d2b,1,9,232,242,-8
Cdc6,1,9,232,242,-8
Itih2,9,17,216,242,-8
Itpa,2,10,230,242,-8
Cdca2,3,11,228,242,-8
Sec61a2,4,12,226,242,-8
Twf1,5,13,224,242,-8
Iftap,2,10,230,242,-8
Cenpq,4,12,226,242,-8
Sco2,6,14,222,242,-8
Ighv1-11,2,10,230,242,-8
Ttll13,3,11,228,242,-8
Ccdc77,2,10,230,242,-8
Ttll3,2,10,230,242,-8
Cercam,3,11,228,242,-8
Kif7,0,8,234,242,-8
Ccdc83,2,10,230,242,-8
Ccdc87,3,11,228,242,-8
Sgtb,3,11,228,242,-8
Ighv6-5,0,8,234,242,-8
Igkv1-117,10,18,214,242,-8
Ccna2,4,12,226,242,-8
Ufl1,2,10,230,242,-8
Sgk2,2,10,230,242,-8
Igkv5-39,5,13,224,242,-8
Ccng2,3,11,228,242,-8
Kctd9,2,10,230,242,-8
Uchl5,2,10,230,242,-8
Fbxo39,2,10,230,242,-8
Ubxn2b,2,10,230,242,-8
Ubxn10,0,8,234,242,-8
Kcnn1,6,14,222,242,-8
Hint2,5,13,224,242,-8
Samt2,0,8,234,242,-8
Rnf7,2,10,230,242,-8
Trbv5,5,13,224,242,-8
Rpp30,4,12,226,242,-8
Birc2,2,10,230,242,-8
Col9a1,0,8,234,242,-8
Grid1,2,10,230,242,-8
Col16a1,4,12,226,242,-8
Lypd5,1,9,232,242,-8
Slc39a12,1,9,232,242,-8
Lynx1,10,18,214,242,-8
Rps6ka2,5,13,224,242,-8
Rps6kb2,4,12,226,242,-8
Lurap1,2,10,230,242,-8
Rpusd2,1,9,232,242,-8
Rreb1,2,10,230,242,-8
Brsk1,1,9,232,242,-8
Gtf2h4,2,10,230,242,-8
Bsdc1,4,12,226,242,-8
Lsm6,2,10,230,242,-8
Gtsf1l,3,11,228,242,-8
Guf1,2,10,230,242,-8
Lrrn4,1,9,232,242,-8
Lrrc8a,4,12,226,242,-8
Lrrc6,0,8,234,242,-8
Rsph9,4,12,226,242,-8
Gpr65,1,9,232,242,-8
Bet1,2,10,230,242,-8
Rspo2,2,10,230,242,-8
Magea9,2,10,230,242,-8
Bak1,2,10,230,242,-8
Rnpc3,2,10,230,242,-8
Mau2,2,10,230,242,-8
Slc9a3r2,2,10,230,242,-8
Matk,3,11,228,242,-8
Mastl,1,9,232,242,-8
Gopc,3,11,228,242,-8
Bbs12,3,11,228,242,-8
Mapk7,2,10,230,242,-8
Cpt1b,12,20,210,242,-8
Gp1bb,16,24,202,242,-8
Map9,6,14,222,242,-8
Gpc2,0,8,234,242,-8
Gphn,2,10,230,242,-8
Bcl11a,0,8,234,242,-8
Bcl2l12,2,10,230,242,-8
Cotl1,2,10,230,242,-8
Maoa,5,13,224,242,-8
Manea,5,13,224,242,-8
Man2c1,2,10,230,242,-8
Rpl32,3,11,228,242,-8
Mak16,2,10,230,242,-8
Rpl37,3,11,228,242,-8
Trim34b,3,11,228,242,-8
Slc29a3,3,11,228,242,-8
Casp1,5,13,224,242,-8
Slc25a28,3,11,228,242,-8
Slc25a22,13,21,208,242,-8
Lmod3,4,12,226,242,-8
Lmo3,4,12,226,242,-8
Cks1b,3,11,228,242,-8
S100a6,4,12,226,242,-8
Vash1,0,8,234,242,-8
Havcr2,3,11,228,242,-8
Cklf,6,14,222,242,-8
Hbb-bh1,3,11,228,242,-8
Lin28a,2,10,230,242,-8
Hebp1,5,13,224,242,-8
Sag,2,10,230,242,-8
Cib2,4,12,226,242,-8
Uxs1,6,14,222,242,-8
Uvssa,2,10,230,242,-8
Capns2,10,18,214,242,-8
Trpm6,2,10,230,242,-8
Utp25,2,10,230,242,-8
Herc2,2,10,230,242,-8
Slc17a9,0,8,234,242,-8
Lgals1,2,10,230,242,-8
Slc17a6,2,10,230,242,-8
Caskin2,2,10,230,242,-8
Has2,1,9,232,242,-8
Trmt11,5,13,224,242,-8
Lrrc4,2,10,230,242,-8
Cldn34b3,0,8,234,242,-8
Bub1,3,11,228,242,-8
H2ab1,2,10,230,242,-8
Lrrc37a,0,8,234,242,-8
Trim45,1,9,232,242,-8
Rtkn,4,12,226,242,-8
Clpx,3,11,228,242,-8
Lrrc25,2,10,230,242,-8
Clnk,2,10,230,242,-8
Cln6,2,10,230,242,-8
C1qtnf6,14,22,206,242,-8
H2ac23,28,36,178,242,-8
C2cd6,0,8,234,242,-8
Clic3,13,21,208,242,-8
Lrp1b,1,9,232,242,-8
Clec9a,4,12,226,242,-8
H2al1k,8,16,218,242,-8
Clec4b1,4,12,226,242,-8
Cab39l,2,10,230,242,-8
Cabcoco1,2,10,230,242,-8
Cabyr,4,12,226,242,-8
Runx2,0,8,234,242,-8
Haghl,3,11,228,242,-8
Rusc2,6,14,222,242,-8
Vps36,2,10,230,242,-8
Myadm,5,13,224,242,-8
Izumo2,1,9,232,242,-8
Acsl1,2,10,230,242,-8
Odad3,3,11,228,242,-8
Acsl6,1,9,232,242,-8
Gm20906,0,8,234,242,-8
Gm20918,0,8,234,242,-8
Gdpd4,3,11,228,242,-8
Nxpe3,1,9,232,242,-8
Sspn,4,12,226,242,-8
Zfp870,3,11,228,242,-8
Gm21117,1,9,232,242,-8
Actr10,4,12,226,242,-8
Ssbp1,3,11,228,242,-8
Gm21310,0,8,234,242,-8
Nxf7,5,13,224,242,-8
Gm21454,0,8,234,242,-8
Gcsh,3,11,228,242,-8
Tmem170,4,12,226,242,-8
Zdhhc15,1,9,232,242,-8
Gm21698,10,18,214,242,-8
Srrm1,2,10,230,242,-8
Nup93,2,10,230,242,-8
Fam111a,4,12,226,242,-8
Dzip1l,3,11,228,242,-8
Nup35,2,10,230,242,-8
Ssx9,1,9,232,242,-8
Zfp850,4,12,226,242,-8
Tex35,12,20,210,242,-8
Pde1a,2,10,230,242,-8
Psg17,2,10,230,242,-8
Tmem104,2,10,230,242,-8
Gm5799,8,16,218,242,-8
Olfr1195,0,8,234,242,-8
Pcsk7,2,10,230,242,-8
Zfp13,2,10,230,242,-8
Olfr1191-ps1,0,8,234,242,-8
Psma5,5,13,224,242,-8
Olfr1031,14,22,206,242,-8
Ghrl,20,28,194,242,-8
Gm20738,1,9,232,242,-8
Tfdp1,2,10,230,242,-8
Eef2k,1,9,232,242,-8
Stab1,14,22,206,242,-8
Pdcd5,2,10,230,242,-8
Fa2h,5,13,224,242,-8
Gm20821,1,9,232,242,-8
Gm20823,0,8,234,242,-8
Get1,3,11,228,242,-8
Gen1,0,8,234,242,-8
Acot9,3,11,228,242,-8
Acox2,3,11,228,242,-8
Psmd7,2,10,230,242,-8
4930480E11Rik,0,8,234,242,-8
Nup210l,2,10,230,242,-8
Olfr1277,0,8,234,242,-8
Adam4,6,14,222,242,-8
Tex22,12,20,210,242,-8
Gm29564,0,8,234,242,-8
Nrbp1,2,10,230,242,-8
Fam133b,3,11,228,242,-8
Zbtb4,2,10,230,242,-8
Gm29695,0,8,234,242,-8
Purg,5,13,224,242,-8
Tac4,7,15,220,242,-8
Pdk2,2,10,230,242,-8
Pus3,4,12,226,242,-8
Taf13,3,11,228,242,-8
Drc1,1,9,232,242,-8
Adat3,12,20,210,242,-8
Adck5,2,10,230,242,-8
Adcy6,4,12,226,242,-8
Adcy7,2,10,230,242,-8
Tmem253,6,14,222,242,-8
Tmem254a,6,14,222,242,-8
Dpy19l2,0,8,234,242,-8
Fam160b2,2,10,230,242,-8
Taf5,2,10,230,242,-8
Dph7,3,11,228,242,-8
Dph6,3,11,228,242,-8
Pts,7,15,220,242,-8
Sprtn,2,10,230,242,-8
Srpk1,2,10,230,242,-8
Tmem220,11,19,212,242,-8
Pde4dip,2,10,230,242,-8
Zcchc18,0,8,234,242,-8
Gm21874,9,17,216,242,-8
Nudt16,7,15,220,242,-8
Tmem190,14,22,206,242,-8
Ptp4a1,9,17,216,242,-8
Ntf3,2,10,230,242,-8
Fam118b,5,13,224,242,-8
Nsun5,3,11,228,242,-8
Gm26566,7,15,220,242,-8
Srarp,4,12,226,242,-8
Sqor,5,13,224,242,-8
Nsmf,3,11,228,242,-8
Adam26a,0,8,234,242,-8
Adam26b,1,9,232,242,-8
Sptssa,3,11,228,242,-8
Sptlc1,2,10,230,242,-8
Gm28171,0,8,234,242,-8
Gm28557,5,13,224,242,-8
Zc3h10,2,10,230,242,-8
4930449I24Rik,1,9,232,242,-8
Nsfl1c,2,10,230,242,-8
Nrros,3,11,228,242,-8
Exosc5,5,13,224,242,-8
Zfp184,1,9,232,242,-8
Dpep2nb,4,12,226,242,-8
Orc6,2,10,230,242,-8
4933424G06Rik,15,23,204,242,-8
Ephb2,3,11,228,242,-8
Olfr99,0,8,234,242,-8
Gm10220,4,12,226,242,-8
Prkar2b,2,10,230,242,-8
Timm21,3,11,228,242,-8
Zfp661,4,12,226,242,-8
Zfp512,3,11,228,242,-8
Sucla2,2,10,230,242,-8
A530064D06Rik,0,8,234,242,-8
Eogt,3,11,228,242,-8
Entr1,2,10,230,242,-8
Stxbp6,6,14,222,242,-8
Gm10160,24,32,186,242,-8
A630089N07Rik,2,10,230,242,-8
Stxbp3,5,13,224,242,-8
4933416I08Rik,2,10,230,242,-8
Enkd1,2,10,230,242,-8
Olfr767,0,8,234,242,-8
Gm14139,3,11,228,242,-8
Zfp667,1,9,232,242,-8
Papss1,5,13,224,242,-8
Esp6,6,14,222,242,-8
Prickle3,5,13,224,242,-8
4933428M09Rik,1,9,232,242,-8
Zfp422,2,10,230,242,-8
Gm12353,21,29,192,242,-8
Gm10488,0,8,234,242,-8
Erh,5,13,224,242,-8
Supt4a,4,12,226,242,-8
Thoc5,2,10,230,242,-8
P2rx2,2,10,230,242,-8
Sun5,1,9,232,242,-8
Oxsm,2,10,230,242,-8
Gm10767,5,13,224,242,-8
Thg1l,4,12,226,242,-8
Otx1,2,10,230,242,-8
Prdm12,0,8,234,242,-8
Otud6b,2,10,230,242,-8
Otoa,11,19,212,242,-8
Sult2b1,6,14,222,242,-8
Prdm8,3,11,228,242,-8
Gm10377,0,8,234,242,-8
Eral1,2,10,230,242,-8
Zfp595,3,11,228,242,-8
Them6,2,10,230,242,-8
Zfp592,2,10,230,242,-8
Gm10338,9,17,216,242,-8
Tigar,5,13,224,242,-8
Epor,5,13,224,242,-8
Zfp429,14,22,206,242,-8
Parp1,3,11,228,242,-8
Olfr1279,0,8,234,242,-8
Gm16434,8,16,218,242,-8
Ppp1r27,11,19,212,242,-8
Zfp300,1,9,232,242,-8
Olfr27,0,8,234,242,-8
Olfr212,0,8,234,242,-8
Stk10,2,10,230,242,-8
Olfr181,0,8,234,242,-8
Olfr180,0,8,234,242,-8
Olfr1487,0,8,234,242,-8
Zfp775,2,10,230,242,-8
Gm19426,4,12,226,242,-8
Zfp27,2,10,230,242,-8
Zfp251,2,10,230,242,-8
Ei24,3,11,228,242,-8
Olfr1293-ps,3,11,228,242,-8
Acaa2,4,12,226,242,-8
Olfr1286,2,10,230,242,-8
Tmdd1,5,13,224,242,-8
Syncrip,4,12,226,242,-8
Prss8,6,14,222,242,-8
Zfp212,2,10,230,242,-8
Prxl2a,5,13,224,242,-8
Efcab9,12,20,210,242,-8
Zfp189,4,12,226,242,-8
Exoc6b,3,11,228,242,-8
Gjc1,3,11,228,242,-8
Elp6,3,11,228,242,-8
Gm1527,1,9,232,242,-8
Glyctk,3,11,228,242,-8
Abca15,2,10,230,242,-8
Proz,3,11,228,242,-8
Ppp6r2,2,10,230,242,-8
Olfr477,3,11,228,242,-8
Elfn1,2,10,230,242,-8
Tln1,3,11,228,242,-8
Tln2,2,10,230,242,-8
Abcb11,0,8,234,242,-8
Tlr1,3,11,228,242,-8
Elavl4,1,9,232,242,-8
Prpf40b,2,10,230,242,-8
Olfr381,0,8,234,242,-8
Zfp354a,3,11,228,242,-8
Abcf1,2,10,230,242,-8
Stpg4,20,28,194,242,-8
Zfp35,4,12,226,242,-8
Pax3,0,8,234,242,-8
Pbp2,5,13,224,242,-8
4931400O07Rik,0,8,234,242,-8
Ppp2r1b,2,10,230,242,-8
Olfr317,2,10,230,242,-8
Ppp1r8,3,11,228,242,-8
Nps,6,14,222,242,-8
P2ry6,1,9,232,242,-8
Gm5134,0,8,234,242,-8
Wdr88,1,9,232,242,-8
Ankmy1,4,12,226,242,-8
Fam47c,0,8,234,242,-8
Fam47e,10,18,214,242,-8
Tdrkh,1,9,232,242,-8
Nae1,4,12,226,242,-8
Nadk,3,11,228,242,-8
Pign,3,11,228,242,-8
Dip2a,2,10,230,242,-8
Spam1,0,8,234,242,-8
1700092M07Rik,24,32,186,242,-8
Tbl2,2,10,230,242,-8
Ankrd29,8,16,218,242,-8
Tnfrsf4,8,16,218,242,-8
Fat4,1,9,232,242,-8
Tasor2,4,12,226,242,-8
Rec114,14,22,206,242,-8
Naa25,2,10,230,242,-8
Ankrd44,2,10,230,242,-8
Zmynd10,7,15,220,242,-8
Pik3r6,2,10,230,242,-8
Mterf3,2,10,230,242,-8
Nat14,4,12,226,242,-8
Reep1,4,12,226,242,-8
Dlat,2,10,230,242,-8
Ncs1,2,10,230,242,-8
Phospho2,3,11,228,242,-8
Gm3633,2,10,230,242,-8
Fn3krp,7,15,220,242,-8
Reg1,8,16,218,242,-8
Pold3,2,10,230,242,-8
Dlx5,1,9,232,242,-8
Ncbp1,2,10,230,242,-8
Gm3642,1,9,232,242,-8
Gm3646,6,14,222,242,-8
Rasef,0,8,234,242,-8
Spata31,0,8,234,242,-8
Pias2,4,12,226,242,-8
Apobec4,1,9,232,242,-8
Mterf1a,3,11,228,242,-8
Pigg,2,10,230,242,-8
Zkscan7,2,10,230,242,-8
Tnfaip8,4,12,226,242,-8
Ankfn1,0,8,234,242,-8
Wdr70,3,11,228,242,-8
1700034J05Rik,1,9,232,242,-8
Def8,4,12,226,242,-8
Tcl1b4,0,8,234,242,-8
1700006A11Rik,1,9,232,242,-8
Ankrd7,7,15,220,242,-8
Zp3r,0,8,234,242,-8
Tbc1d19,3,11,228,242,-8
Mymx,10,18,214,242,-8
Fgf10,1,9,232,242,-8
Anks4b,2,10,230,242,-8
Myh11,4,12,226,242,-8
1700016K19Rik,2,10,230,242,-8
Cdca7,2,10,230,242,-8
Dexi,2,10,230,242,-8
Wdr25,8,16,218,242,-8
Gm4631,3,11,228,242,-8
Wdr20rt,3,11,228,242,-8
Mvb12a,3,11,228,242,-8
Wdr19,3,11,228,242,-8
Wdr17,9,17,216,242,-8
Gm4787,4,12,226,242,-8
Pla2g4a,8,16,218,242,-8
Ankrd66,4,12,226,242,-8
Denn2b,2,10,230,242,-8
Gm49403,5,13,224,242,-8
Wdr49,3,11,228,242,-8
Wasf1,0,8,234,242,-8
1700034E13Rik,12,20,210,242,-8
1700028P14Rik,0,8,234,242,-8
Socs1,1,9,232,242,-8
Ap3s2,2,10,230,242,-8
Tnfsf13b,0,8,234,242,-8
Dhx32,2,10,230,242,-8
Myt1,2,10,230,242,-8
Fez1,4,12,226,242,-8
Gm49355,2,10,230,242,-8
Spaca6,6,14,222,242,-8
Pms2,3,11,228,242,-8
Dhrs4,3,11,228,242,-8
Ap1s3,3,11,228,242,-8
Gm49333,17,25,200,242,-8
Dhrs2,3,11,228,242,-8
Mypop,2,10,230,242,-8
Myo9a,2,10,230,242,-8
Dhcr7,4,12,226,242,-8
Ncstn,3,11,228,242,-8
Mtmr6,2,10,230,242,-8
Gm5136,0,8,234,242,-8
Nlrp4f,4,12,226,242,-8
Snrpa1,2,10,230,242,-8
Dnmt3b,1,9,232,242,-8
Gm550,7,15,220,242,-8
Fcgr4,8,16,218,242,-8
Gm5458,1,9,232,242,-8
Msh3,2,10,230,242,-8
Yif1b,3,11,228,242,-8
Zfp982,3,11,228,242,-8
Taf8,2,10,230,242,-8
Pon2,2,10,230,242,-8
Fbxl20,2,10,230,242,-8
Nkx3-1,0,8,234,242,-8
1110004F10Rik,2,10,230,242,-8
Gm32717,7,15,220,242,-8
Fdxacb1,2,10,230,242,-8
Tent5d,4,12,226,242,-8
Gm5169,1,9,232,242,-8
Nipa2,3,11,228,242,-8
Snhg4,13,21,208,242,-8
Adprm,2,10,230,242,-8
Gm3404,1,9,232,242,-8
Poteg,0,8,234,242,-8
Spns3,1,9,232,242,-8
Ythdc2,1,9,232,242,-8
Rfwd3,2,10,230,242,-8
Qrsl1,2,10,230,242,-8
Gm5751,23,31,188,242,-8
Yod1,2,10,230,242,-8
Adtrp,4,12,226,242,-8
Dcst1,4,12,226,242,-8
Gm31571,0,8,234,242,-8
Tert,2,10,230,242,-8
Gm3159,2,10,230,242,-8
Plekhh2,0,8,234,242,-8
Agbl3,5,13,224,242,-8
Rexo5,3,11,228,242,-8
Agbl5,3,11,228,242,-8
Tesk2,2,10,230,242,-8
Fbxw17,3,11,228,242,-8
Pllp,9,17,216,242,-8
Gm3402,1,9,232,242,-8
Gm3435,11,19,212,242,-8
Phactr3,3,11,228,242,-8
Rfx2,1,9,232,242,-8
Racgap1,4,12,226,242,-8
2410137M14Rik,10,18,214,242,-8
Tox,0,8,234,242,-8
Ndufs4,4,12,226,242,-8
Dnah17,2,10,230,242,-8
Zswim2,4,12,226,242,-8
Polr2f,2,10,230,242,-8
Fam221a,3,11,228,242,-8
Ddx25,1,9,232,242,-8
Dnaaf4,3,11,228,242,-8
Alg8,2,10,230,242,-8
Dna2,1,9,232,242,-8
Alx1,5,13,224,242,-8
Tesl2,0,8,234,242,-8
1810062G17Rik,6,14,222,242,-8
Mta3,4,12,226,242,-8
Ndufa2,3,11,228,242,-8
Nid2,4,12,226,242,-8
Nova2,0,8,234,242,-8
Akap14,1,9,232,242,-8
Rabgap1l,2,10,230,242,-8
Gm3460,3,11,228,242,-8
Fbxo46,2,10,230,242,-8
Spesp1,0,8,234,242,-8
Xpr1,3,11,228,242,-8
AI467606,0,8,234,242,-8
2610008E11Rik,4,12,226,242,-8
Zfp992,4,12,226,242,-8
Zswim8,2,10,230,242,-8
Xpc,4,12,226,242,-8
Speer4f2,0,8,234,242,-8
Rabggta,3,11,228,242,-8
Dnaja3,2,10,230,242,-8
Tmem91,10,18,214,242,-8
Neurl1b,3,11,228,242,-8
Gm5168,3,11,228,242,-8
Ccdc154,3,12,227,242,-9
Ccdc159,2,11,229,242,-9
Plagl2,3,12,227,242,-9
Uqcrb,5,14,223,242,-9
Ccdc150,1,10,231,242,-9
Plppr2,1,10,231,242,-9
Pramel41,3,12,227,242,-9
Cdc7,0,9,233,242,-9
L2hgdh,3,12,227,242,-9
Plpp4,3,12,227,242,-9
4933414I15Rik,0,9,233,242,-9
Ccdc14,0,9,233,242,-9
Palb2,1,10,231,242,-9
Ube2e2,4,13,225,242,-9
Scfd1,3,12,227,242,-9
Plppr3,0,9,233,242,-9
Krtap6-5,2,11,229,242,-9
1700001J03Rik,12,21,209,242,-9
Ccdc13,3,12,227,242,-9
1700011L22Rik,2,11,229,242,-9
Zfp949,5,14,223,242,-9
Pigyl,4,13,225,242,-9
Pkdrej,0,9,233,242,-9
Kcnq3,0,9,233,242,-9
Ccz1,2,11,229,242,-9
Ppm1d,2,11,229,242,-9
Zfp978,13,22,207,242,-9
4930467E23Rik,8,17,217,242,-9
Kctd14,6,15,221,242,-9
2610021A01Rik,2,11,229,242,-9
4930503E14Rik,11,20,211,242,-9
Pate2,4,13,225,242,-9
4930503L19Rik,3,12,227,242,-9
Pomgnt1,3,12,227,242,-9
4930505A04Rik,7,16,219,242,-9
Scoc,6,15,221,242,-9
Cd1d2,2,11,229,242,-9
Cd200,6,15,221,242,-9
2900092C05Rik,4,13,225,242,-9
Ccdc88a,2,11,229,242,-9
Zfp97,5,14,223,242,-9
Zfp934,4,13,225,242,-9
3110082I17Rik,2,11,229,242,-9
Kdm1b,2,11,229,242,-9
Zfp964,1,10,231,242,-9
Ccdc106,3,12,227,242,-9
Kif18a,1,10,231,242,-9
Pphln1,2,11,229,242,-9
Pou2f2,2,11,229,242,-9
Ccn6,3,12,227,242,-9
Pdp1,2,11,229,242,-9
Ccnb2,8,17,217,242,-9
Ppfia2,1,10,231,242,-9
Ccne1,4,13,225,242,-9
Ccnd1,4,13,225,242,-9
2310057M21Rik,3,12,227,242,-9
Zfp87,4,13,225,242,-9
Cd24a,2,11,229,242,-9
Klhl32,5,14,223,242,-9
Pmch,4,13,225,242,-9
Ccdc166,0,9,233,242,-9
4932429P05Rik,0,9,233,242,-9
Ppp3cb,3,12,227,242,-9
Pcbp3,2,11,229,242,-9
Pcdha2,2,11,229,242,-9
Pcdha6,0,9,233,242,-9
Klra9,4,13,225,242,-9
Cdc20,4,13,225,242,-9
1700024G13Rik,1,10,231,242,-9
1700028J19Rik,6,15,221,242,-9
Klra2,7,16,219,242,-9
Klk10,2,11,229,242,-9
Cdc123,3,12,227,242,-9
Scn1a,0,9,233,242,-9
Ccdc74a,4,13,225,242,-9
Zfp78,3,12,227,242,-9
Ccdc25,2,11,229,242,-9
Unc5c,2,11,229,242,-9
Ccdc30,4,13,225,242,-9
4930572O03Rik,1,10,231,242,-9
4930415L06Rik,0,9,233,242,-9
Pctp,2,11,229,242,-9
4930548H24Rik,2,11,229,242,-9
Pdcd4,3,12,227,242,-9
Pifo,0,9,233,242,-9
Ubox5,3,12,227,242,-9
Pdcl2,3,12,227,242,-9
1810010H24Rik,4,13,225,242,-9
Cd276,2,11,229,242,-9
Cchcr1,3,12,227,242,-9
Arhgef15,2,11,229,242,-9
Uso1,3,12,227,242,-9
Rab26,3,12,227,242,-9
Nipsnap3b,6,15,221,242,-9
Mbtps1,4,13,225,242,-9
Rab8b,2,11,229,242,-9
Aimp2,2,11,229,242,-9
Nepro,3,12,227,242,-9
Med20,2,11,229,242,-9
Nek8,4,13,225,242,-9
Med6,4,13,225,242,-9
Med8,2,11,229,242,-9
Ndufb9,2,11,229,242,-9
B3gnt9,2,11,229,242,-9
Ndufb8,2,11,229,242,-9
Vmn1r72,0,9,233,242,-9
Mesp1,1,10,231,242,-9
Metap2,2,11,229,242,-9
Amn1,2,11,229,242,-9
Rapsn,2,11,229,242,-9
Rnf112,2,11,229,242,-9
Ncl,2,11,229,242,-9
Amt,3,12,227,242,-9
Angel1,2,11,229,242,-9
Nkrf,2,11,229,242,-9
Yeats4,2,11,229,242,-9
Nbeal2,2,11,229,242,-9
Mat2a,4,13,225,242,-9
Bcl2l15,8,17,217,242,-9
Zbtb12,3,12,227,242,-9
Add3,5,14,223,242,-9
Pwwp4b,5,14,223,242,-9
Pxmp2,3,12,227,242,-9
Npm1,3,12,227,242,-9
Bckdhb,4,13,225,242,-9
Bccip,2,11,229,242,-9
Nphp3,6,15,221,242,-9
BC061237,1,10,231,242,-9
BC055324,2,11,229,242,-9
Nmral1,1,10,231,242,-9
Afp,2,11,229,242,-9
Agbl4,3,12,227,242,-9
Rpap2,2,11,229,242,-9
Marchf11,1,10,231,242,-9
Nmi,6,15,221,242,-9
Ager,3,12,227,242,-9
Mars2,1,10,231,242,-9
Ropn1l,8,17,217,242,-9
Nme6,4,13,225,242,-9
Angel2,3,12,227,242,-9
Ank2,6,15,221,242,-9
Lair1,3,12,227,242,-9
Mpc2,2,11,229,242,-9
Mtmr12,2,11,229,242,-9
Mphosph6,2,11,229,242,-9
Mtif3,3,12,227,242,-9
Rec8,6,15,221,242,-9
Art1,2,11,229,242,-9
Arrb2,4,13,225,242,-9
Relt,2,11,229,242,-9
Rhcg,5,14,223,242,-9
mt-Co3,8,17,217,242,-9
mt-Atp6,9,18,215,242,-9
Vstm2a,2,11,229,242,-9
Arap3,7,16,219,242,-9
Msmb,8,17,217,242,-9
Msantd3,1,10,231,242,-9
Rgs12,3,12,227,242,-9
Ms4a4b,3,12,227,242,-9
Arid3b,5,14,223,242,-9
Rgs10,7,16,219,242,-9
Mrps33,4,13,225,242,-9
Arhgef1,1,10,231,242,-9
Rfx1,2,11,229,242,-9
Aox4,1,10,231,242,-9
Mosmo,4,13,225,242,-9
Napepld,1,10,231,242,-9
Morn2,5,14,223,242,-9
Nap1l4,3,12,227,242,-9
Nagk,2,11,229,242,-9
Nabp1,4,13,225,242,-9
Wdr86,5,14,223,242,-9
Naa40,2,11,229,242,-9
Naa30,2,11,229,242,-9
Mier1,5,14,223,242,-9
Atp5l,4,13,225,242,-9
Mif4gd,2,11,229,242,-9
Naa20,2,11,229,242,-9
Riox2,2,11,229,242,-9
Mios,2,11,229,242,-9
Wdr6,3,12,227,242,-9
Mki67,7,16,219,242,-9
Atg7,4,13,225,242,-9
Mlh1,3,12,227,242,-9
Ribc2,1,10,231,242,-9
Myo19,3,12,227,242,-9
Myf6,0,9,233,242,-9
Rcbtb1,5,14,223,242,-9
Wdfy4,11,20,211,242,-9
Pusl1,2,11,229,242,-9
Bend5,2,11,229,242,-9
Mag,4,13,225,242,-9
Car7,2,11,229,242,-9
Caprin2,4,13,225,242,-9
Aasdh,2,11,229,242,-9
Zfp40,7,16,219,242,-9
Olfr510,1,10,231,242,-9
Lhfpl3,1,10,231,242,-9
Lig4,3,12,227,242,-9
Cand2,0,9,233,242,-9
S1pr2,3,12,227,242,-9
S100pbp,2,11,229,242,-9
Olfr357,0,9,233,242,-9
Zfp334,0,9,233,242,-9
Olfr325,1,10,231,242,-9
Zfp324,3,12,227,242,-9
Camkmt,3,12,227,242,-9
Prr27,0,9,233,242,-9
Calhm5,2,11,229,242,-9
Prr32,0,9,233,242,-9
Rwdd2a,4,13,225,242,-9
Loxl3,0,9,233,242,-9
Vdac3,2,11,229,242,-9
Olfr1509,1,10,231,242,-9
Lgals2,8,17,217,242,-9
Olfr656,0,9,233,242,-9
Mad2l2,3,12,227,242,-9
Zfp438,0,9,233,242,-9
Ccdc103,4,13,225,242,-9
P2rx3,1,10,231,242,-9
Larp7,4,13,225,242,-9
Cby1,3,12,227,242,-9
9130023H24Rik,1,10,231,242,-9
Prelid3a,2,11,229,242,-9
9430038I01Rik,5,14,223,242,-9
Usp33,2,11,229,242,-9
9530077C05Rik,3,12,227,242,-9
Zfp560,6,15,221,242,-9
Prkar1b,9,18,215,242,-9
Olfr893,2,11,229,242,-9
Zfp516,2,11,229,242,-9
Catsper2,4,13,225,242,-9
Catsper1,0,9,233,242,-9
Prl3c1,1,10,231,242,-9
Zfp474,3,12,227,242,-9
A830005F24Rik,9,18,215,242,-9
Olfr700,0,9,233,242,-9
Prn,10,19,213,242,-9
Aamdc,3,12,227,242,-9
Abhd6,3,12,227,242,-9
Zfp273,5,14,223,242,-9
Lpcat2,3,12,227,242,-9
Lpcat4,3,12,227,242,-9
Nutm2,0,9,233,242,-9
Nupr1l,3,12,227,242,-9
Brsk2,1,10,231,242,-9
Brms1l,4,13,225,242,-9
Zdhhc12,2,11,229,242,-9
Actrt3,3,12,227,242,-9
Zcwpw1,2,11,229,242,-9
Lsmem1,7,16,219,242,-9
Ptges3l,4,13,225,242,-9
Zc3h7a,2,11,229,242,-9
Lyrm2,6,15,221,242,-9
Rps12,4,13,225,242,-9
Bloc1s2,4,13,225,242,-9
Zbtb5,2,11,229,242,-9
Adamts10,5,14,223,242,-9
Bivm,8,17,217,242,-9
Birc5,5,14,223,242,-9
Macc1,1,10,231,242,-9
Zbtb34,1,10,231,242,-9
Adap1,4,13,225,242,-9
Vmn1r214,0,9,233,242,-9
Btbd16,0,9,233,242,-9
Zdhhc4,2,11,229,242,-9
Obi1,3,12,227,242,-9
Lrrc27,4,13,225,242,-9
Lpin1,2,11,229,242,-9
Zfp248,1,10,231,242,-9
Lrguk,2,11,229,242,-9
Zfp213,2,11,229,242,-9
Olfr128,0,9,233,242,-9
Lrmp,1,10,231,242,-9
Lrpap1,3,12,227,242,-9
Lrrc19,6,15,221,242,-9
Olfr1178,3,12,227,242,-9
C1d,2,11,229,242,-9
Lrrc61,3,12,227,242,-9
Psmc5,2,11,229,242,-9
Zfp110,2,11,229,242,-9
Psmc6,2,11,229,242,-9
Oip5,3,12,227,242,-9
Zfp101,3,12,227,242,-9
Acot10,2,11,229,242,-9
Zfand6,3,12,227,242,-9
Acrbp,4,13,225,242,-9
Lrrc4b,1,10,231,242,-9
Olfr1220,1,10,231,242,-9
Sec1,2,11,229,242,-9
Cdca7l,1,10,231,242,-9
Slc41a3,1,10,231,242,-9
Gm15130,0,9,233,242,-9
Tm2d3,4,13,225,242,-9
Cog5,3,12,227,242,-9
Slc39a11,3,12,227,242,-9
Cog2,3,12,227,242,-9
Slc37a2,1,10,231,242,-9
Stpg2,0,9,233,242,-9
Gm45015,3,12,227,242,-9
Cntrl,3,12,227,242,-9
Slc36a4,3,12,227,242,-9
Trim14,0,9,233,242,-9
Slc35a3,2,11,229,242,-9
Gtse1,1,10,231,242,-9
Strada,2,11,229,242,-9
Gzma,7,16,219,242,-9
Gm14434,26,35,181,242,-9
Gzmm,4,13,225,242,-9
Elobl,21,30,191,242,-9
Emc9,9,18,215,242,-9
Cmtm1,8,17,217,242,-9
Emid1,6,15,221,242,-9
Col1a1,3,12,227,242,-9
Gm17026,5,14,223,242,-9
Tssk2,6,15,221,242,-9
Eif1b,4,13,225,242,-9
Tmem106c,4,13,225,242,-9
Gm20696,0,9,233,242,-9
Efcab6,2,11,229,242,-9
Tmeff2,1,10,231,242,-9
Tmeff1,2,11,229,242,-9
Slc6a21,0,9,233,242,-9
Gm20509,4,13,225,242,-9
Egf,2,11,229,242,-9
Coro1b,3,12,227,242,-9
Steap2,3,12,227,242,-9
Gpr182,4,13,225,242,-9
Gm19935,5,14,223,242,-9
Slc52a2,2,11,229,242,-9
Slc51a,2,11,229,242,-9
Gm17949,7,16,219,242,-9
Gm17657,6,15,221,242,-9
Gprin2,4,13,225,242,-9
Gpsm2,2,11,229,242,-9
Eif1ad4,8,17,217,242,-9
Col5a1,2,11,229,242,-9
Col2a1,1,10,231,242,-9
Tlcd1,3,12,227,242,-9
Trim5,12,21,209,242,-9
Emp2,2,11,229,242,-9
Engase,2,11,229,242,-9
Gm10282,10,19,213,242,-9
Hipk4,3,12,227,242,-9
Chrna7,1,10,231,242,-9
Gm10251,2,11,229,242,-9
Ern2,2,11,229,242,-9
Esco2,7,16,219,242,-9
Hjurp,2,11,229,242,-9
Esf1,2,11,229,242,-9
Gm10096,0,9,233,242,-9
Esp24,11,20,211,242,-9
Hmgn3,4,13,225,242,-9
Glrx3,5,14,223,242,-9
Slamf1,0,9,233,242,-9
Hnrnpr,3,12,227,242,-9
Hoxa6,9,18,215,242,-9
Gldc,3,12,227,242,-9
Chfr,3,12,227,242,-9
Gins1,2,11,229,242,-9
Hps6,3,12,227,242,-9
Chaf1a,1,10,231,242,-9
Exosc7,3,12,227,242,-9
Erich2,10,19,213,242,-9
Hic2,0,9,233,242,-9
Eri2,3,12,227,242,-9
Slc25a2,9,18,215,242,-9
Gm13698,9,18,215,242,-9
Trim63,4,13,225,242,-9
H2ac8,10,19,213,242,-9
Clec4a2,16,25,201,242,-9
Clec14a,3,12,227,242,-9
Gm13283,5,14,223,242,-9
Gm13199,8,17,217,242,-9
Epb41l4a,2,11,229,242,-9
Sucnr1,5,14,223,242,-9
Cldn22,4,13,225,242,-9
Erg28,2,11,229,242,-9
Timeless,1,10,231,242,-9
Trmu,4,13,225,242,-9
Gm12258,0,9,233,242,-9
Hdac1,2,11,229,242,-9
Epyc,2,11,229,242,-9
Gm11034,6,15,221,242,-9
Hemgn,2,11,229,242,-9
Ciapin1,2,11,229,242,-9
Slc1a2,5,14,223,242,-9
Tmem107,3,12,227,242,-9
Crabp1,4,13,225,242,-9
Cracd,4,13,225,242,-9
Gm7233,2,11,229,242,-9
Gm5592,0,9,233,242,-9
Spdl1,2,11,229,242,-9
Gm5800,0,9,233,242,-9
Tmigd3,5,14,223,242,-9
Gm3526,3,12,227,242,-9
Dbndd1,5,14,223,242,-9
Speer3,2,11,229,242,-9
Gm5945,0,9,233,242,-9
Dars2,2,11,229,242,-9
Gm3488,13,22,207,242,-9
Gm3453,4,13,225,242,-9
Gm3424,1,10,231,242,-9
D830030K20Rik,8,17,217,242,-9
Tmem63a,6,15,221,242,-9
Gm33933,3,12,227,242,-9
Dnase1,12,21,209,242,-9
Traj21,1,10,231,242,-9
Czib,3,12,227,242,-9
Smpd3,3,12,227,242,-9
Tmem50b,4,13,225,242,-9
Cyp4f39,3,12,227,242,-9
Gm5591,0,9,233,242,-9
Dcun1d1,6,15,221,242,-9
Dcun1d4,4,13,225,242,-9
Snx29,3,12,227,242,-9
Gm42742,12,21,209,242,-9
Gm4131,4,13,225,242,-9
Dipk1b,4,13,225,242,-9
Tnfrsf17,10,19,213,242,-9
Tnfaip8l1,2,11,229,242,-9
Spata2l,4,13,225,242,-9
Dld,2,11,229,242,-9
Defb14,1,10,231,242,-9
Snx7,6,15,221,242,-9
Tmsb15b1,16,25,201,242,-9
Tmppe,6,15,221,242,-9
Spats2,2,11,229,242,-9
Dmxl1,9,18,215,242,-9
Toporsl,0,9,233,242,-9
Gm5114,0,9,233,242,-9
Gm3573,3,12,227,242,-9
Gm5141,3,12,227,242,-9
Ddx20,2,11,229,242,-9
Dnah1,0,9,233,242,-9
Dnah12,1,10,231,242,-9
Tmem42,4,13,225,242,-9
Gm3138,0,9,233,242,-9
Crat,5,14,223,242,-9
Dock6,3,12,227,242,-9
Gm8374,4,13,225,242,-9
Gm8773,2,11,229,242,-9
Gm21721,0,9,233,242,-9
Gm8922,5,14,223,242,-9
Gm21663,6,15,221,242,-9
Tmem169,7,16,219,242,-9
Gm21083,13,22,207,242,-9
Gm973,7,16,219,242,-9
Ebag9,5,14,223,242,-9
Ebi3,5,14,223,242,-9
Ssxa1,1,10,231,242,-9
Crybg3,4,13,225,242,-9
Ssxb6,2,11,229,242,-9
Gm20865,0,9,233,242,-9
Slco5a1,0,9,233,242,-9
Tmem128,2,11,229,242,-9
Crlf3,2,11,229,242,-9
Gm20816,0,9,233,242,-9
Gm20809,1,10,231,242,-9
Tmem116,8,17,217,242,-9
Gnptab,5,14,223,242,-9
Smarcad1,2,11,229,242,-9
Dynlt1a,5,14,223,242,-9
Tmem191c,3,12,227,242,-9
Trappc10,2,11,229,242,-9
Dock7,2,11,229,242,-9
Donson,0,9,233,242,-9
Gm7945,0,9,233,242,-9
Gm8005,4,13,225,242,-9
Dpep1,9,18,215,242,-9
Dpf1,4,13,225,242,-9
Gm3045,0,9,233,242,-9
Tmem258,5,14,223,242,-9
Dpy30,2,11,229,242,-9
Gm8122,3,12,227,242,-9
Gm8232,1,10,231,242,-9
Cul1,2,11,229,242,-9
Gm29644,0,9,233,242,-9
Gm29049,0,9,233,242,-9
Dtd2,3,12,227,242,-9
Tmem216,2,11,229,242,-9
Gm8165,0,9,233,242,-9
Gm28047,22,31,189,242,-9
Gm21994,20,29,193,242,-9
Gm21977,2,11,229,242,-9
Ext2,2,11,229,242,-9
Trhde,0,9,233,242,-9
Gm45062,25,34,183,242,-9
Fgf7,5,14,223,242,-9
Fam184a,11,20,211,242,-9
Ier3ip1,2,11,229,242,-9
Fiz1,2,11,229,242,-9
Ceacam2,8,17,217,242,-9
Idi1,3,12,227,242,-9
Cdsn,3,12,227,242,-9
Shld3,3,12,227,242,-9
Taf6,3,12,227,242,-9
Fam166b,10,19,213,242,-9
Fancf,1,10,231,242,-9
Ttc5,3,12,227,242,-9
Ttc34,0,9,233,242,-9
Tbc1d5,2,11,229,242,-9
Inpp1,4,13,225,242,-9
Icos,2,11,229,242,-9
Far2,4,13,225,242,-9
Tbc1d8,5,14,223,242,-9
Tex261,2,11,229,242,-9
Cfap45,9,18,215,242,-9
Gask1a,1,10,231,242,-9
Tdp1,7,16,219,242,-9
Setmar,6,15,221,242,-9
Ttc17,2,11,229,242,-9
Il17f,7,16,219,242,-9
Foxm1,1,10,231,242,-9
Tekt4,0,9,233,242,-9
Cep290,4,13,225,242,-9
Frmd4b,2,11,229,242,-9
Tent4a,2,11,229,242,-9
Fam241b,6,15,221,242,-9
Fn3k,5,14,223,242,-9
Sh2d6,3,12,227,242,-9
Ftdc2,1,10,231,242,-9
Fus,2,11,229,242,-9
Cenpa,0,9,233,242,-9
Ighv1-12,4,13,225,242,-9
Cenpv,5,14,223,242,-9
Flrt3,1,10,231,242,-9
Cers4,7,16,219,242,-9
Fam204a,2,11,229,242,-9
Ift22,3,12,227,242,-9
Tvp23b,3,12,227,242,-9
Ift140,3,12,227,242,-9
Il25,3,12,227,242,-9
Tbcb,2,11,229,242,-9
Cfap126,8,17,217,242,-9
Fcrla,7,16,219,242,-9
Tchp,1,10,231,242,-9
Fem1al,3,12,227,242,-9
Serp2,6,15,221,242,-9
Itpripl1,2,11,229,242,-9
Fcgrt,7,16,219,242,-9
Tsx,10,19,213,242,-9
Cfap91,4,13,225,242,-9
Fbh1,3,12,227,242,-9
Cdk14,3,12,227,242,-9
Fer1l5,4,13,225,242,-9
Cdh26,1,10,231,242,-9
Gm36864,8,18,216,242,-10
Dnaaf1,1,11,230,242,-10
Flna,3,13,226,242,-10
Dynlt1b,9,19,214,242,-10
Gm8279,5,15,222,242,-10
Adam19,0,10,232,242,-10
Ntrk3,6,16,220,242,-10
Gm8237,6,16,220,242,-10
Ptgr2,3,13,226,242,-10
Smarca2,3,13,226,242,-10
Gm3739,4,14,224,242,-10
Cenpn,4,14,224,242,-10
Flywch1,2,12,228,242,-10
Tnrc6a,2,12,228,242,-10
Acyp1,5,15,222,242,-10
Nuf2,4,14,224,242,-10
Mettl4,2,12,228,242,-10
Rnf121,3,13,226,242,-10
Nuggc,2,12,228,242,-10
Tmem183a,2,12,228,242,-10
Zcchc7,3,13,226,242,-10
Dynlt2a2,8,18,216,242,-10
Nat1,6,16,220,242,-10
Wdpcp,7,17,218,242,-10
1700088E04Rik,7,17,218,242,-10
Tatdn1,5,15,222,242,-10
Pik3r3,4,14,224,242,-10
Gm8094,5,15,222,242,-10
Gm30191,2,12,228,242,-10
Zbtb22,2,12,228,242,-10
Mis18bp1,2,12,228,242,-10
Tmem243,2,12,228,242,-10
Spata25,11,21,210,242,-10
1700057G04Rik,10,20,212,242,-10
Atp2a1,7,17,218,242,-10
Nras,2,12,228,242,-10
Ankle1,2,12,228,242,-10
Gm8126,7,17,218,242,-10
Fam53b,2,12,228,242,-10
Zmat3,2,12,228,242,-10
Smg5,2,12,228,242,-10
Ptrhd1,0,10,232,242,-10
Nrm,6,16,220,242,-10
Tmem218,2,12,228,242,-10
Cenph,3,13,226,242,-10
Mgme1,4,14,224,242,-10
Pigw,2,12,228,242,-10
Smco4,3,13,226,242,-10
Tmem209,4,14,224,242,-10
Mtx3,3,13,226,242,-10
Nt5c2,5,15,222,242,-10
Nup188,2,12,228,242,-10
Ankrd37,6,16,220,242,-10
Gm21739,0,10,232,242,-10
Rnf126,2,12,228,242,-10
Igkv6-14,4,14,224,242,-10
Ogfrl1,4,14,224,242,-10
Ccnq,3,13,226,242,-10
Mcat,2,12,228,242,-10
Gnb4,1,11,230,242,-10
1810046K07Rik,3,13,226,242,-10
Gm20773,0,10,232,242,-10
Faim,3,13,226,242,-10
Gngt1,3,13,226,242,-10
Efcab11,0,10,232,242,-10
Barhl1,0,10,232,242,-10
Fam227a,1,11,230,242,-10
Marveld3,3,13,226,242,-10
Gm45623,0,10,232,242,-10
Tmem18,2,12,228,242,-10
Zfyve16,2,12,228,242,-10
Cpvl,1,11,230,242,-10
Ankrd61,4,14,224,242,-10
Zfp131,7,17,218,242,-10
Ufm1,3,13,226,242,-10
Stap2,2,12,228,242,-10
Psenen,2,12,228,242,-10
Wdr47,2,12,228,242,-10
Mapk11,1,11,230,242,-10
Accsl,5,15,222,242,-10
Ufsp2,4,14,224,242,-10
Rpl22,2,12,228,242,-10
Zfp105,1,11,230,242,-10
Mcpt8,4,14,224,242,-10
Crppa,2,12,228,242,-10
St6galnac2,3,13,226,242,-10
Gm3072,0,10,232,242,-10
Nup37,2,12,228,242,-10
Spag4,7,17,218,242,-10
Cd109,0,10,232,242,-10
E030018B13Rik,2,12,228,242,-10
Zdhhc16,5,15,222,242,-10
AY074887,8,18,216,242,-10
Fmc1,2,12,228,242,-10
Wdr66,0,10,232,242,-10
Tmem161a,3,13,226,242,-10
Mep1b,10,20,212,242,-10
Ocm,17,27,198,242,-10
Ccsap,0,10,232,242,-10
Sfxn5,3,13,226,242,-10
B3gnt8,2,12,228,242,-10
Tbx5,1,11,230,242,-10
Tubgcp5,4,14,224,242,-10
Kctd7,1,11,230,242,-10
Mef2a,3,13,226,242,-10
Acr,4,14,224,242,-10
Ssxb3,2,12,228,242,-10
Cep131,0,10,232,242,-10
Myorg,3,13,226,242,-10
Med21,6,16,220,242,-10
Pole,2,12,228,242,-10
Adgb,0,10,232,242,-10
Nphp1,3,13,226,242,-10
Rcor3,2,12,228,242,-10
Mrps24,3,13,226,242,-10
Gm5797,1,11,230,242,-10
Gm5798,8,18,216,242,-10
1700012B07Rik,3,13,226,242,-10
Arhgef19,6,16,220,242,-10
Akr1c19,5,15,222,242,-10
Spdye4a,2,12,228,242,-10
Rfx8,0,10,232,242,-10
Akna,3,13,226,242,-10
Arhgef25,4,14,224,242,-10
Serpinb1c,2,12,228,242,-10
Ndst3,3,13,226,242,-10
Nde1,3,13,226,242,-10
Akap7,3,13,226,242,-10
Dnah7b,5,15,222,242,-10
Rgp1,2,12,228,242,-10
Mrpl53,6,16,220,242,-10
Gm3512,4,14,224,242,-10
Fanci,6,16,220,242,-10
Apip,3,13,226,242,-10
Dnai4,4,14,224,242,-10
Speer4e,4,14,224,242,-10
Gm6121,1,11,230,242,-10
Rars2,4,14,224,242,-10
Smyd3,2,12,228,242,-10
Aim2,6,16,220,242,-10
Rad54l,0,10,232,242,-10
Snn,3,13,226,242,-10
Armc3,0,10,232,242,-10
Arhgap33,2,12,228,242,-10
Apom,8,18,216,242,-10
mt-Co2,7,17,218,242,-10
Alg5,3,13,226,242,-10
mt-Atp8,10,20,212,242,-10
Ranbp17,1,11,230,242,-10
Ddx11,2,12,228,242,-10
Ralgps1,1,11,230,242,-10
Gm527,1,11,230,242,-10
Ralgds,2,12,228,242,-10
Ddx28,2,12,228,242,-10
Mss51,0,10,232,242,-10
Iqank1,6,16,220,242,-10
Alg1,3,13,226,242,-10
Ipo8,2,12,228,242,-10
Ddias,8,18,216,242,-10
Cdc34,4,14,224,242,-10
Ms4a6c,5,15,222,242,-10
Dnah2,2,12,228,242,-10
Rexo2,2,12,228,242,-10
Tbca,6,16,220,242,-10
Arhgap11a,1,11,230,242,-10
Pla2g7,5,15,222,242,-10
Dcst2,1,11,230,242,-10
Ndufv3,2,12,228,242,-10
Necap2,2,12,228,242,-10
Wipi1,3,13,226,242,-10
Dnajb8,3,13,226,242,-10
Fam81a,5,15,222,242,-10
Kcnc1,0,10,232,242,-10
Yipf7,6,16,220,242,-10
Stard3nl,3,13,226,242,-10
Rd3,2,12,228,242,-10
Gm3182,1,11,230,242,-10
R3hdm2,3,13,226,242,-10
Dkk4,0,10,232,242,-10
Tbata,13,23,206,242,-10
Fam89b,6,16,220,242,-10
Tmem30c,8,18,216,242,-10
Cyp2c29,3,13,226,242,-10
Smim6,8,18,216,242,-10
Ilvbl,3,13,226,242,-10
Asic3,6,16,220,242,-10
Gm7876,0,10,232,242,-10
Asnsd1,2,12,228,242,-10
Gm3115,2,12,228,242,-10
Mog,4,14,224,242,-10
Mocs2,2,12,228,242,-10
Fam83h,2,12,228,242,-10
Fkbp1b,13,23,206,242,-10
Cyb561d1,1,11,230,242,-10
Tmem274,13,23,206,242,-10
Cxcr3,2,12,228,242,-10
Ffar2,4,14,224,242,-10
Mmp11,9,19,214,242,-10
Cyp3a41a,2,12,228,242,-10
Rdh11,2,12,228,242,-10
Nfu1,2,12,228,242,-10
Gm7102,7,17,218,242,-10
Gm6356,2,12,228,242,-10
Armh3,2,12,228,242,-10
Traf4,2,12,228,242,-10
Sema3b,3,13,226,242,-10
Xrcc2,1,11,230,242,-10
Sema3a,0,10,232,242,-10
Ahi1,2,12,228,242,-10
Arpin,4,14,224,242,-10
D6Ertd527e,1,11,230,242,-10
Spin2c,6,16,220,242,-10
Tdh,1,11,230,242,-10
Mroh2a,4,14,224,242,-10
Dlx4,3,13,226,242,-10
Katnip,4,14,224,242,-10
Arsa,2,12,228,242,-10
Dnajc30,2,12,228,242,-10
Gm3383,9,19,214,242,-10
Cd72,4,14,224,242,-10
Ncapg2,1,11,230,242,-10
Fcmr,8,18,216,242,-10
Gm6592,7,17,218,242,-10
Mthfsl,7,17,218,242,-10
Dnd1,3,13,226,242,-10
Nmbr,9,19,214,242,-10
Gm49358,11,21,210,242,-10
Cox7b,8,18,216,242,-10
Ccdc136,1,11,230,242,-10
Ccdc152,9,19,214,242,-10
Trim36,5,15,222,242,-10
Lrrc46,5,15,222,242,-10
Skp2,0,10,232,242,-10
Tlcd3a,2,12,228,242,-10
Fam187a,6,16,220,242,-10
H2-M2,7,17,218,242,-10
H2-T10,8,18,216,242,-10
Klc2,2,12,228,242,-10
Zfp872,1,11,230,242,-10
Epsti1,2,12,228,242,-10
Ttc13,5,15,222,242,-10
Stx16,4,14,224,242,-10
Chst1,0,10,232,242,-10
Zfp708,21,31,190,242,-10
Slamf7,2,12,228,242,-10
Hdhd2,3,13,226,242,-10
Etfa,3,13,226,242,-10
Klhl25,1,11,230,242,-10
Usp28,2,12,228,242,-10
AAdacl4fm3,1,11,230,242,-10
Slc26a8,5,15,222,242,-10
Pex11g,3,13,226,242,-10
Gm14308,27,37,178,242,-10
Galnt13,4,14,224,242,-10
Cnot2,3,13,226,242,-10
Zfp738,3,13,226,242,-10
Galnt3,3,13,226,242,-10
Elapor1,1,11,230,242,-10
Gcsam,0,10,232,242,-10
Ccdc65,0,10,232,242,-10
Hspb11,4,14,224,242,-10
Olfr456,2,12,228,242,-10
Ccdc63,6,16,220,242,-10
Usp8,3,13,226,242,-10
Gm14410,13,23,206,242,-10
Ell,3,13,226,242,-10
9330182O14Rik,1,11,230,242,-10
Strip1,3,13,226,242,-10
Gm14391,9,19,214,242,-10
Slc2a6,3,13,226,242,-10
Swsap1,2,12,228,242,-10
4931406B18Rik,1,11,230,242,-10
Kiz,2,12,228,242,-10
Cndp1,8,18,216,242,-10
Olfr633,1,11,230,242,-10
Cby3,3,13,226,242,-10
Ppip5k2,2,12,228,242,-10
Hck,0,10,232,242,-10
Ckap5,2,12,228,242,-10
C1qtnf2,6,16,220,242,-10
Slc26a6,2,12,228,242,-10
Tro,1,11,230,242,-10
Gm10058,0,10,232,242,-10
Hacd2,3,13,226,242,-10
Chrna2,1,11,230,242,-10
Trmt12,1,11,230,242,-10
Epha10,3,13,226,242,-10
Catsperb,1,11,230,242,-10
Gm12695,0,10,232,242,-10
Hyal2,6,16,220,242,-10
Sugp2,3,13,226,242,-10
Sigirr,5,15,222,242,-10
Sulf1,5,15,222,242,-10
Ttc23,2,12,228,242,-10
Rxfp2,2,12,228,242,-10
Vbp1,7,17,218,242,-10
Orai1,2,12,228,242,-10
Gas8,2,12,228,242,-10
Lmnb2,2,12,228,242,-10
Lmf1,3,13,226,242,-10
Hirip3,2,12,228,242,-10
Haus3,2,12,228,242,-10
Zfp518b,3,13,226,242,-10
Olfr789,0,10,232,242,-10
Trip13,4,14,224,242,-10
Paqr7,4,14,224,242,-10
4933402D24Rik,2,12,228,242,-10
Lins1,2,12,228,242,-10
Pou1f1,5,15,222,242,-10
Ifit1bl1,5,15,222,242,-10
Trp53bp2,2,12,228,242,-10
Clip3,5,15,222,242,-10
Zfp689,0,10,232,242,-10
4933405L10Rik,5,15,222,242,-10
H2ac24,14,24,204,242,-10
Pou5f2,4,14,224,242,-10
Clec10a,7,17,218,242,-10
Trim68,1,11,230,242,-10
Zfp488,1,11,230,242,-10
H2aw,4,14,224,242,-10
Lrmda,8,18,216,242,-10
H2bc13,25,35,182,242,-10
Chrne,2,12,228,242,-10
Cep43,2,12,228,242,-10
Lrch4,8,18,216,242,-10
Unc50,3,13,226,242,-10
Olfr420,3,13,226,242,-10
Abcc12,1,11,230,242,-10
Tlr2,2,12,228,242,-10
Commd5,3,13,226,242,-10
Ccn3,2,12,228,242,-10
6820408C15Rik,1,11,230,242,-10
Otud7a,1,11,230,242,-10
Ccl4,13,23,206,242,-10
Gm1993,1,11,230,242,-10
Coprs,2,12,228,242,-10
Fra10ac1,2,12,228,242,-10
Zfp867,1,11,230,242,-10
Prss42,2,12,228,242,-10
Gpr61,2,12,228,242,-10
Slc4a8,4,14,224,242,-10
Prdm15,5,15,222,242,-10
Bhlhb9,6,16,220,242,-10
Lgals3bp,4,14,224,242,-10
Tmc3,0,10,232,242,-10
Pcsk4,1,11,230,242,-10
Bicra,1,11,230,242,-10
Zfp998,10,20,212,242,-10
Caps2,3,13,226,242,-10
Ska2,2,12,228,242,-10
Ces1g,3,13,226,242,-10
Prss46,4,14,224,242,-10
Abraxas1,2,12,228,242,-10
Magohb,2,12,228,242,-10
Trpv1,3,13,226,242,-10
Cep55,2,12,228,242,-10
Gpha2,14,24,204,242,-10
Gpr137,2,12,228,242,-10
Olfr1280,0,10,232,242,-10
4930516K23Rik,1,11,230,242,-10
Efna3,2,12,228,242,-10
Cox11,4,14,224,242,-10
Prss56,2,12,228,242,-10
Coro2a,2,12,228,242,-10
Coq9,2,12,228,242,-10
Fpgs,5,15,222,242,-10
Rpl35a,4,14,224,242,-10
Zfp866,2,12,228,242,-10
Ehmt2,3,13,226,242,-10
Gm2012,1,11,230,242,-10
Gpr158,0,10,232,242,-10
Carns1,3,13,226,242,-10
Ggt7,2,12,228,242,-10
Pdia2,8,18,216,242,-10
Samt1c,2,12,228,242,-10
Zfp997,7,17,218,242,-10
Slc1a6,2,12,228,242,-10
Sh2d1b1,2,12,228,242,-10
Zfp346,4,14,224,242,-10
Idh1,4,14,224,242,-10
Gsc,4,14,224,242,-10
Slc16a9,3,13,226,242,-10
Pgam2,6,16,220,242,-10
Erap1,9,19,214,242,-10
Chst14,7,17,218,242,-10
Olfr362,0,10,232,242,-10
Slc38a9,2,12,228,242,-10
Pfkm,2,12,228,242,-10
Rps6ka5,1,11,230,242,-10
Slc22a15,5,15,222,242,-10
Trdmt1,5,15,222,242,-10
Sh2d7,0,10,232,242,-10
Hspa14,2,12,228,242,-10
Gm14459,0,10,232,242,-10
Gsto2,3,13,226,242,-10
Gstt3,4,14,224,242,-10
Heatr1,7,17,218,242,-10
Gtf2b,5,15,222,242,-10
Elac1,0,10,232,242,-10
Bscl2,5,15,222,242,-10
Gtf3c5,2,12,228,242,-10
Zfp986,7,17,218,242,-10
Col14a1,4,14,224,242,-10
Kif22,0,10,232,242,-10
Eif2b3,3,13,226,242,-10
Gdf11,1,11,230,242,-10
Zfp991,9,19,214,242,-10
Abhd14a,4,14,224,242,-10
Blm,4,14,224,242,-10
Prdm2,3,13,226,242,-10
Gins3,3,13,226,242,-10
Fam20b,2,12,228,242,-10
Gm11027,30,40,172,242,-10
Scamp2,4,14,224,242,-10
Lgals8,2,12,228,242,-10
Cfap43,1,11,230,242,-10
2610318N02Rik,2,12,228,242,-10
Ccdc89,4,14,224,242,-10
Cibar1,2,12,228,242,-10
Kif2c,3,13,226,242,-10
Bmp8b,0,10,232,242,-10
Tfrc,2,12,228,242,-10
Skida1,4,14,224,242,-10
Plac8l1,18,29,195,242,-11
Zfp65,2,13,227,242,-11
4933430I17Rik,2,13,227,242,-11
Zfp935,15,26,201,242,-11
Supt20,4,15,223,242,-11
Zfp647,2,13,227,242,-11
Thnsl1,2,13,227,242,-11
Efhb,2,13,227,242,-11
Wscd2,0,11,231,242,-11
1110032A03Rik,4,15,223,242,-11
Nat2,5,16,221,242,-11
Gja5,2,13,227,242,-11
Spata24,5,16,221,242,-11
Gja1,6,17,219,242,-11
Disp1,0,11,231,242,-11
Rassf2,4,15,223,242,-11
Pde4a,0,11,231,242,-11
Gin1,3,14,225,242,-11
Naaladl1,1,12,229,242,-11
1700008O03Rik,8,19,215,242,-11
Naa80,2,13,227,242,-11
Rbks,2,13,227,242,-11
Cdca5,3,14,225,242,-11
Zfp819,4,15,223,242,-11
Exosc9,2,13,227,242,-11
Gdpgp1,1,12,229,242,-11
Tex9,4,15,223,242,-11
Sox5,1,12,229,242,-11
Ppp1r26,0,11,231,242,-11
Fbxo15,6,17,219,242,-11
Tgfb1i1,4,15,223,242,-11
Nat8f6,10,21,211,242,-11
Paqr5,3,14,225,242,-11
Ndufaf8,3,14,225,242,-11
Gm35549,7,18,217,242,-11
Gask1b,5,16,221,242,-11
Gm10037,14,25,203,242,-11
Pask,2,13,227,242,-11
Als2,3,14,225,242,-11
Ndufa9,2,13,227,242,-11
Glul,2,13,227,242,-11
Ndst2,2,13,227,242,-11
Ndc80,1,12,229,242,-11
Ncoa7,3,14,225,242,-11
Tbx10,2,13,227,242,-11
Dlx6,5,16,221,242,-11
Glmn,2,13,227,242,-11
Wfikkn1,7,18,217,242,-11
Rasgrf1,1,12,229,242,-11
Thop1,2,13,227,242,-11
Tmem41a,4,15,223,242,-11
Nectin3,4,15,223,242,-11
Actl9,0,11,231,242,-11
Actr6,2,13,227,242,-11
1700094D03Rik,10,21,211,242,-11
Plekhm3,0,11,231,242,-11
Prr14l,6,17,219,242,-11
Tm2d1,2,13,227,242,-11
Zfp341,1,12,229,242,-11
Pfkfb2,2,13,227,242,-11
2810021J22Rik,1,12,229,242,-11
Eif5a2,3,14,225,242,-11
Nt5dc1,3,14,225,242,-11
Dydc1,1,12,229,242,-11
Tagap,4,15,223,242,-11
Sptbn4,1,12,229,242,-11
Flacc1,5,16,221,242,-11
Dtd1,2,13,227,242,-11
Nrde2,2,13,227,242,-11
Gm14325,16,27,199,242,-11
Drg1,3,14,225,242,-11
Gm14322,16,27,199,242,-11
Adamtsl5,5,16,221,242,-11
Zmym3,4,15,223,242,-11
Nutm1,2,13,227,242,-11
Tmem150b,5,16,221,242,-11
Porcn,5,16,221,242,-11
Sting1,9,20,213,242,-11
2310057J18Rik,2,13,227,242,-11
Polr1has,3,14,225,242,-11
Egfl8,1,12,229,242,-11
Phex,1,12,229,242,-11
Gm20715,0,11,231,242,-11
Steap1,4,15,223,242,-11
Psma2,2,13,227,242,-11
2210017I01Rik,11,22,209,242,-11
Gm20716,6,17,219,242,-11
2010109A12Rik,28,39,175,242,-11
Fam227b,1,12,229,242,-11
Tenm4,2,13,227,242,-11
Tedc1,1,12,229,242,-11
Tmem130,2,13,227,242,-11
Phyhip,4,15,223,242,-11
Ssxb5,9,20,213,242,-11
Odf3l1,3,14,225,242,-11
Prss12,8,19,215,242,-11
Tmem144,8,19,215,242,-11
Odad1,1,12,229,242,-11
Tmem147,3,14,225,242,-11
Tatdn3,3,14,225,242,-11
Dpy19l4,2,13,227,242,-11
Gm10681,8,19,215,242,-11
1700020L13Rik,6,17,219,242,-11
A26c2,0,11,231,242,-11
Fam178b,3,14,225,242,-11
Zfp568,3,14,225,242,-11
Tbc1d2,0,11,231,242,-11
Zfp57,3,14,225,242,-11
Gm12666,7,18,217,242,-11
Ephx1,4,15,223,242,-11
Gm3486,1,12,229,242,-11
Epp13,4,15,223,242,-11
Aifm2,3,14,225,242,-11
Aire,0,11,231,242,-11
Nfatc2ip,0,11,231,242,-11
Gabra1,2,13,227,242,-11
Rabgap1,2,13,227,242,-11
Rabggtb,4,15,223,242,-11
Speer4b,4,15,223,242,-11
Pla2g12a,2,13,227,242,-11
6720489N17Rik,8,19,215,242,-11
Ovol2,3,14,225,242,-11
Taf1d,5,16,221,242,-11
Thrsp,6,17,219,242,-11
Prkag2,6,17,219,242,-11
Pitpnm3,0,11,231,242,-11
Aanat,0,11,231,242,-11
Gm128,8,19,215,242,-11
Pwwp4a,3,14,225,242,-11
Fam78a,3,14,225,242,-11
Pwwp4c,0,11,231,242,-11
Adgrl3,0,11,231,242,-11
3830403N18Rik,6,17,219,242,-11
Gm3095,2,13,227,242,-11
Tkfc,2,13,227,242,-11
Adprhl1,3,14,225,242,-11
Aaas,4,15,223,242,-11
Emx2,2,13,227,242,-11
Dot1l,2,13,227,242,-11
Noxo1,0,11,231,242,-11
Zfp469,0,11,231,242,-11
Fam186a,0,11,231,242,-11
Zfp472,2,13,227,242,-11
Eno4,0,11,231,242,-11
Gm3127,0,11,231,242,-11
Gm31371,2,13,227,242,-11
Stxbp4,3,14,225,242,-11
Tmem45a,8,19,215,242,-11
Zfp950,6,17,219,242,-11
Phf21a,3,14,225,242,-11
Fbxo36,7,18,217,242,-11
Tpst1,4,15,223,242,-11
Bcl2a1d,10,21,211,242,-11
Cep192,1,12,229,242,-11
Bcor,2,13,227,242,-11
Mrpl14,3,14,225,242,-11
Gm6337,7,18,217,242,-11
Rhbdd3,2,13,227,242,-11
Armh2,6,17,219,242,-11
Bcl9,2,13,227,242,-11
Dagla,0,11,231,242,-11
Gm6401,3,14,225,242,-11
Cox5b-ps,35,46,161,242,-11
Magi2,4,15,223,242,-11
Chd1l,2,13,227,242,-11
Gpcpd1,2,13,227,242,-11
BC049715,15,26,201,242,-11
Arrdc3,2,13,227,242,-11
Gpatch11,3,14,225,242,-11
Krtap17-1,1,12,229,242,-11
Arsg,3,14,225,242,-11
Rpgrip1,13,24,205,242,-11
Mapk15,3,14,225,242,-11
Rpl39l,10,21,211,242,-11
Kcnab2,2,13,227,242,-11
Mapre3,2,13,227,242,-11
Vmn1r181,2,13,227,242,-11
Aqp7,3,14,225,242,-11
Snrpg,2,13,227,242,-11
Cfap97d2,0,11,231,242,-11
Msl3l2,1,12,229,242,-11
Txnrd3,3,14,225,242,-11
Lrrc75b,0,11,231,242,-11
Lrrc8e,2,13,227,242,-11
Trh,1,12,229,242,-11
Ly6f,5,16,221,242,-11
Sncaip,2,13,227,242,-11
M1ap,6,17,219,242,-11
Rps18-ps6,14,25,203,242,-11
Dcaf15,3,14,225,242,-11
Gm8127,6,17,219,242,-11
Scd4,2,13,227,242,-11
Arid3a,1,12,229,242,-11
Colca2,3,14,225,242,-11
Mrpl52,2,13,227,242,-11
Inka1,9,20,213,242,-11
Cdpf1,3,14,225,242,-11
Hsd3b2,3,14,225,242,-11
Cr2,9,20,213,242,-11
Sema3e,0,11,231,242,-11
Rnaseh2b,2,13,227,242,-11
Aunip,2,13,227,242,-11
Smim12,2,13,227,242,-11
Vmn1r87,0,11,231,242,-11
AU041133,4,15,223,242,-11
Gm8871,3,14,225,242,-11
Mettl8,3,14,225,242,-11
Mfap5,11,22,209,242,-11
Mkks,4,15,223,242,-11
Il20ra,5,16,221,242,-11
Gm8229,1,12,229,242,-11
Ccdc183,2,13,227,242,-11
Rnase10,4,15,223,242,-11
Atp23,3,14,225,242,-11
Ctse,1,12,229,242,-11
Trappc2,6,17,219,242,-11
Mindy4,2,13,227,242,-11
Gm8159,3,14,225,242,-11
Icam4,6,17,219,242,-11
Mief2,3,14,225,242,-11
Cd248,1,12,229,242,-11
Tram1l1,0,11,231,242,-11
Chchd7,2,13,227,242,-11
Slc9a5,0,11,231,242,-11
Sidt2,3,14,225,242,-11
Crhr1,1,12,229,242,-11
Hsbp1l1,4,15,223,242,-11
Cep19,2,13,227,242,-11
Kcng1,2,13,227,242,-11
Il5ra,2,13,227,242,-11
Sgcb,3,14,225,242,-11
Smim8,6,17,219,242,-11
Crygn,12,23,207,242,-11
Ascc1,2,13,227,242,-11
Igsf9,5,16,221,242,-11
Aurkc,11,22,209,242,-11
Gm906,3,14,225,242,-11
Mms22l,1,12,229,242,-11
Sirt6,2,13,227,242,-11
Mettl1,3,14,225,242,-11
Mmel1,2,13,227,242,-11
Gm8897,2,13,227,242,-11
Smim18,11,22,209,242,-11
Atf7,2,13,227,242,-11
Gm8068,1,12,229,242,-11
mt-Co1,8,19,215,242,-11
Atp5k,2,13,227,242,-11
Anln,3,14,225,242,-11
Ap4b1,4,15,223,242,-11
Slc25a41,4,15,223,242,-11
Catsper3,3,14,225,242,-11
Ttll7,1,12,229,242,-11
Itgb1bp2,7,18,217,242,-11
Ldlrad2,4,15,223,242,-11
Dennd4c,2,13,227,242,-11
Irx5,1,12,229,242,-11
Ireb2,3,14,225,242,-11
Lekr1,1,12,229,242,-11
Cage1,1,12,229,242,-11
Tspan2,6,17,219,242,-11
Kif6,2,13,227,242,-11
Depdc5,6,17,219,242,-11
Upb1,3,14,225,242,-11
Sar1b,3,14,225,242,-11
Sepsecs,2,13,227,242,-11
Cfap74,1,12,229,242,-11
Trrap,3,14,225,242,-11
Hibch,3,14,225,242,-11
Slc25a13,5,16,221,242,-11
Dennd10,2,13,227,242,-11
Cdc42ep5,8,19,215,242,-11
Samd3,2,13,227,242,-11
Cilk1,3,14,225,242,-11
Klf2,5,16,221,242,-11
Card6,2,13,227,242,-11
Anxa7,2,13,227,242,-11
Henmt1,4,15,223,242,-11
Sapcd1,10,21,211,242,-11
Gm4841,4,15,223,242,-11
H2ac1,16,27,199,242,-11
Sass6,2,13,227,242,-11
Hspa2,3,14,225,242,-11
Reep2,0,11,231,242,-11
Reep4,3,14,225,242,-11
Bub1b,2,13,227,242,-11
Cep72,9,20,213,242,-11
Dgat2,2,13,227,242,-11
Slc12a5,4,15,223,242,-11
Kif4,2,13,227,242,-11
Zfp637,2,14,226,242,-12
4931428F04Rik,1,13,228,242,-12
Glt8d1,6,18,218,242,-12
Csf1r,9,21,212,242,-12
E2f8,3,15,224,242,-12
Melk,0,12,230,242,-12
Tmem151a,1,13,228,242,-12
Fam118a,3,15,224,242,-12
Chchd6,4,16,222,242,-12
Carmil1,2,14,226,242,-12
Gm9602,2,14,226,242,-12
Klhl18,2,14,226,242,-12
Eva1a,3,15,224,242,-12
Acp4,3,15,224,242,-12
Nrg4,1,13,228,242,-12
Cttnbp2nl,2,14,226,242,-12
Tex21,0,12,230,242,-12
Slc1a3,1,13,228,242,-12
Cetn3,3,15,224,242,-12
Trav4-3,23,35,184,242,-12
Trav4d-4,13,25,204,242,-12
Tafa4,2,14,226,242,-12
Ssxb1,1,13,228,242,-12
Etfbkmt,3,15,224,242,-12
Zfp639,3,15,224,242,-12
Ptpdc1,2,14,226,242,-12
Tsga10ip,10,22,210,242,-12
Ccdc38,1,13,228,242,-12
Cep112,3,15,224,242,-12
Zfp932,7,19,216,242,-12
Svbp,4,16,222,242,-12
Ccdc39,0,12,230,242,-12
Esr2,0,12,230,242,-12
Lefty1,8,20,214,242,-12
Chrng,1,13,228,242,-12
Gm8271,3,15,224,242,-12
Ccdc180,0,12,230,242,-12
Mgst2,11,23,208,242,-12
Klf8,6,18,218,242,-12
Ptpn20,0,12,230,242,-12
Mfsd4b4,5,17,220,242,-12
Zc3h6,1,13,228,242,-12
Klhdc9,3,15,224,242,-12
Cenpt,4,16,222,242,-12
Glipr1l3,5,17,220,242,-12
Rnf141,6,18,218,242,-12
Ttc30b,6,18,218,242,-12
Azin2,3,15,224,242,-12
H2-M10.2,1,13,228,242,-12
Sult2a7,1,13,228,242,-12
Tmem121,3,15,224,242,-12
Zfp985,7,19,216,242,-12
Zfp455,0,12,230,242,-12
Lrrc20,2,14,226,242,-12
Olfr740,0,12,230,242,-12
Hpdl,4,16,222,242,-12
Ccn5,2,14,226,242,-12
Zfp317,2,14,226,242,-12
C330018D20Rik,4,16,222,242,-12
Uts2,9,21,212,242,-12
Clgn,1,13,228,242,-12
Gm17078,0,12,230,242,-12
Col4a3,8,20,214,242,-12
Ugt3a1,18,30,194,242,-12
Zfp763,3,15,224,242,-12
Prl2c2,13,25,204,242,-12
Zfp354c,0,12,230,242,-12
Gtf2h2,2,14,226,242,-12
Lsm5,8,20,214,242,-12
Lrrcc1,5,17,220,242,-12
Stx17,4,16,222,242,-12
Lrrc75a,1,13,228,242,-12
Rsl1,9,21,212,242,-12
Prox2,2,14,226,242,-12
Zfp385c,4,16,222,242,-12
Tk1,3,15,224,242,-12
Rtl10,6,18,218,242,-12
Zfp386,2,14,226,242,-12
Gm14401,15,27,200,242,-12
Trim43c,2,14,226,242,-12
Kif20a,3,15,224,242,-12
H1f3,5,17,220,242,-12
Kif20b,3,15,224,242,-12
Olfr822,1,13,228,242,-12
Slc4a3,7,19,216,242,-12
Macrod2,4,16,222,242,-12
Epm2a,2,14,226,242,-12
Thtpa,2,14,226,242,-12
Crct1,5,17,220,242,-12
Golga7b,2,14,226,242,-12
Bbof1,3,15,224,242,-12
Cpt1c,0,12,230,242,-12
Fstl1,2,14,226,242,-12
1810024B03Rik,5,17,220,242,-12
1810055G02Rik,2,14,226,242,-12
Cirbp,3,15,224,242,-12
Pclaf,2,14,226,242,-12
Ostc,2,14,226,242,-12
Eps8l3,0,12,230,242,-12
Zfp169,5,17,220,242,-12
Cpa6,3,15,224,242,-12
Ophn1,1,13,228,242,-12
Sgpp2,3,15,224,242,-12
Tube1,1,13,228,242,-12
Pcdhgc4,11,23,208,242,-12
Ighv1-69,3,15,224,242,-12
Kdm4d,3,15,224,242,-12
Phf19,7,19,216,242,-12
Tubd1,4,16,222,242,-12
2300009A05Rik,4,16,222,242,-12
Zfp558,1,13,228,242,-12
Tex2,2,14,226,242,-12
Terb1,0,12,230,242,-12
Zfp979,9,21,212,242,-12
Pcca,2,14,226,242,-12
Cacna1h,4,16,222,242,-12
Prss43,1,13,228,242,-12
Zfand1,3,15,224,242,-12
Aurka,3,15,224,242,-12
Rbm12,6,18,218,242,-12
Wdr77,3,15,224,242,-12
Mxd3,2,14,226,242,-12
Gm4884,0,12,230,242,-12
Gm4924,3,15,224,242,-12
Traj33,1,13,228,242,-12
Asb5,2,14,226,242,-12
Dcp1b,3,15,224,242,-12
R3hcc1,2,14,226,242,-12
Cyp2r1,7,19,216,242,-12
Nat8f3,11,23,208,242,-12
Cemip,0,12,230,242,-12
1700001F09Rik,3,15,224,242,-12
Mst1,7,19,216,242,-12
Sox18,4,16,222,242,-12
Alg3,3,15,224,242,-12
Spc25,3,15,224,242,-12
Aspm,1,13,228,242,-12
mt-Cytb,6,18,218,242,-12
Ndufaf5,3,15,224,242,-12
mt-Nd6,6,18,218,242,-12
Mzt2,2,14,226,242,-12
Yy2,17,29,196,242,-12
Pkd2l2,0,12,230,242,-12
Dennd4b,0,12,230,242,-12
Gm5108,14,26,202,242,-12
Derl3,3,15,224,242,-12
Mrpl50,2,14,226,242,-12
Gm4779,4,16,222,242,-12
Gm6133,9,21,212,242,-12
Gm3500,5,17,220,242,-12
Rgs4,3,15,224,242,-12
Traf3ip1,2,14,226,242,-12
Rassf7,3,15,224,242,-12
Gm5941,7,19,216,242,-12
Gm3476,1,13,228,242,-12
Ccdc144b,0,12,230,242,-12
Pms1,2,14,226,242,-12
Tpte,0,12,230,242,-12
Gm6460,1,13,228,242,-12
Arhgef39,4,16,222,242,-12
Rfx5,1,13,228,242,-12
4930519G04Rik,1,13,228,242,-12
Agtpbp1,4,16,222,242,-12
Gm6583,1,13,228,242,-12
Ano1,5,17,220,242,-12
Dipk1a,5,17,220,242,-12
Cenpi,4,16,222,242,-12
Ndufaf1,2,14,226,242,-12
Dnajb5,2,14,226,242,-12
Ccdc12,3,15,224,242,-12
Mlf1,5,17,220,242,-12
Cutc,4,16,222,242,-12
Fkbp8,2,14,226,242,-12
Sp140,5,17,220,242,-12
Ints10,2,14,226,242,-12
Ncapg,1,13,228,242,-12
Spata48,5,17,220,242,-12
Hspb7,0,12,230,242,-12
Spata46,5,17,220,242,-12
Zscan2,4,16,222,242,-12
Ripk3,1,13,228,242,-12
Spout1,2,14,226,242,-12
Ndufa11,3,15,224,242,-12
Tmem237,3,15,224,242,-12
Spata4,4,16,222,242,-12
Rbm46,1,13,228,242,-12
Alyref2,2,14,226,242,-12
Platr25,4,16,222,242,-12
Iqca,0,12,230,242,-12
Gchfr,8,20,214,242,-12
Cenpf,4,16,222,242,-12
Gm50461,4,16,222,242,-12
Miip,3,15,224,242,-12
Rbm8a2,7,19,216,242,-12
Fam205a4,5,18,219,242,-13
H3c10,21,34,187,242,-13
Zfp981,3,16,223,242,-13
Trgc4,5,18,219,242,-13
Bora,0,13,229,242,-13
Grtp1,3,16,223,242,-13
Styxl1,8,21,213,242,-13
Top2a,3,16,223,242,-13
Pmis2,4,17,221,242,-13
Rassf10,0,13,229,242,-13
Clec11a,0,13,229,242,-13
Cep57l1,2,15,225,242,-13
Gm15517,18,31,193,242,-13
Grm1,0,13,229,242,-13
Gm15217,7,20,215,242,-13
Xkr5,1,14,227,242,-13
Bik,13,26,203,242,-13
Aknad1,1,14,227,242,-13
A430033K04Rik,2,15,225,242,-13
Grin2d,0,13,229,242,-13
Gm10999,4,17,221,242,-13
Pcbd2,3,16,223,242,-13
Zfp286,0,13,229,242,-13
Stil,0,13,229,242,-13
Gm6020,13,26,203,242,-13
Clcn1,1,14,227,242,-13
Zfp282,2,15,225,242,-13
Cfap97,3,16,223,242,-13
Kif15,2,15,225,242,-13
Dmrta2,0,13,229,242,-13
Rad51ap1,4,17,221,242,-13
Fyb,4,17,221,242,-13
Pla2g10,4,17,221,242,-13
Zscan20,6,19,217,242,-13
Arl11,4,17,221,242,-13
Proser3,3,16,223,242,-13
Gm5152,10,23,209,242,-13
Slc2a5,2,15,225,242,-13
Wbp11,3,16,223,242,-13
Zfp414,4,17,221,242,-13
Tigd5,0,13,229,242,-13
H1f5,9,22,211,242,-13
mt-Nd4,6,19,217,242,-13
Zfp968-ps,20,33,189,242,-13
1700014B07Rik,16,29,197,242,-13
Clspn,3,16,223,242,-13
Emilin1,2,15,225,242,-13
Ccdc91,10,23,209,242,-13
Cep70,3,16,223,242,-13
Ap1g2,2,15,225,242,-13
Mterf1b,4,17,221,242,-13
Thsd7b,8,21,213,242,-13
Fhl4,2,15,225,242,-13
Gm13285,5,18,219,242,-13
Ccl27a,10,23,209,242,-13
2610042L04Rik,3,16,223,242,-13
Myo1h,1,14,227,242,-13
Nek10,0,13,229,242,-13
Trpm1,4,17,221,242,-13
Gm4871,0,13,229,242,-13
Gm13306,17,30,195,242,-13
Lsm10,3,16,223,242,-13
Olfr432,0,13,229,242,-13
Tppp,0,13,229,242,-13
Lrr1,6,19,217,242,-13
2700049A03Rik,1,14,227,242,-13
Mterf2,5,18,219,242,-13
Ttc30a2,12,25,205,242,-13
Arhgap29,3,16,223,242,-13
Rtl8c,10,23,209,242,-13
Fam166a,2,15,225,242,-13
Ap5b1,2,15,225,242,-13
Ccdc169,4,17,221,242,-13
Gm7951,4,17,221,242,-13
Atg4c,2,15,225,242,-13
Shisa3,2,15,225,242,-13
Tmem262,29,42,171,242,-13
Mettl18,3,16,223,242,-13
Zdhhc13,5,18,219,242,-13
Gm21680,1,14,227,242,-13
Pou6f1,2,15,225,242,-13
Nupl2,3,16,223,242,-13
Aym1,10,23,209,242,-13
Pigbos1,6,19,217,242,-13
Mycn,1,14,227,242,-13
E130311K13Rik,2,15,225,242,-13
Kcnj13,11,24,207,242,-13
Kmt5c,5,18,219,242,-13
Ccser2,4,17,221,242,-13
Ubd,9,22,211,242,-13
Rassf6,13,26,203,242,-13
Tsga10,5,18,219,242,-13
Acsm4,1,14,227,242,-13
E430018J23Rik,2,15,225,242,-13
Gm4450,6,19,217,242,-13
Gm3029,2,15,225,242,-13
Trav2,1,14,227,242,-13
Sfmbt2,1,14,227,242,-13
Klhl20,2,15,225,242,-13
Gm29394,22,35,185,242,-13
Nrcam,5,18,219,242,-13
4930558K02Rik,2,15,225,242,-13
Zfp799,3,16,223,242,-13
Spryd4,4,17,221,242,-13
Gm8206,5,18,219,242,-13
Sp1,3,16,223,242,-13
Gm28044,36,49,157,242,-13
4930563M21Rik,4,17,221,242,-13
Gm3020,5,18,219,242,-13
Adam22,5,18,219,242,-13
Lca5l,1,14,227,242,-13
Nsun7,0,13,229,242,-13
Galntl6,5,18,219,242,-13
Pus7l,3,16,223,242,-13
4932414N04Rik,5,18,219,242,-13
Dram1,4,17,221,242,-13
Tet1,7,20,215,242,-13
Ppbp,7,20,215,242,-13
Nod2,0,13,229,242,-13
Cyp24a1,1,14,227,242,-13
Cdh18,2,15,225,242,-13
BC147527,10,23,209,242,-13
Xrcc4,4,17,221,242,-13
Gm3248,6,19,217,242,-13
Zswim7,5,18,219,242,-13
Gm6710,8,21,213,242,-13
Zfp128,2,15,225,242,-13
Ccdc105,2,15,225,242,-13
Plbd1,2,15,225,242,-13
Hscb,2,15,225,242,-13
Depdc1b,4,17,221,242,-13
Rnls,3,16,223,242,-13
5031410I06Rik,6,19,217,242,-13
Fam228b,12,25,205,242,-13
Ankrd27,2,15,225,242,-13
Nkg7,7,20,215,242,-13
D16Ertd472e,3,16,223,242,-13
Map4k1,1,14,227,242,-13
Dnajc27,1,14,227,242,-13
Efcab7,4,17,221,242,-13
Nme4,4,17,221,242,-13
Septin4,3,16,223,242,-13
Hilpda,4,17,221,242,-13
Trav5-1,4,17,221,242,-13
Nfatc4,5,18,219,242,-13
B430306N03Rik,0,13,229,242,-13
Cyp2t4,1,14,227,242,-13
Gm10184,6,19,217,242,-13
B4galnt4,1,14,227,242,-13
Trav3-1,5,18,219,242,-13
Ngfr,2,15,225,242,-13
Gm20422,32,45,165,242,-13
Asb15,1,14,227,242,-13
Rhebl1,4,17,221,242,-13
Rnf32,12,25,205,242,-13
Gnb1l,4,17,221,242,-13
Slc9b1,6,19,217,242,-13
Asb14,1,14,227,242,-13
Itgae,2,15,225,242,-13
Camk1g,1,15,226,242,-14
Car15,8,22,212,242,-14
Lfng,4,18,220,242,-14
Ccdc7b,2,16,224,242,-14
4930512M02Rik,9,23,210,242,-14
Lexm,5,19,218,242,-14
Defb41,3,17,222,242,-14
Ttk,4,18,220,242,-14
Pars2,3,17,222,242,-14
Sp4,4,18,220,242,-14
Pf4,10,24,208,242,-14
Cit,0,14,228,242,-14
Zfp965,12,26,204,242,-14
Popdc3,3,17,222,242,-14
Tnfrsf9,6,20,216,242,-14
Sorbs2,5,19,218,242,-14
Gm11009,9,23,210,242,-14
Gm42715,4,18,220,242,-14
Tslp,10,24,208,242,-14
Chrac1,3,17,222,242,-14
Tsku,3,17,222,242,-14
Parpbp,4,18,220,242,-14
Uqcc1,5,19,218,242,-14
Usp29,0,14,228,242,-14
Tspan15,5,19,218,242,-14
Gm4767,19,33,190,242,-14
Gm2897,9,23,210,242,-14
Gm36368,19,33,190,242,-14
Tmem39b,2,16,224,242,-14
Gm3099,2,16,224,242,-14
Gm8050,9,23,210,242,-14
Gm7929,2,16,224,242,-14
Morn4,1,15,226,242,-14
B3galt4,4,18,220,242,-14
Gm9611,0,14,228,242,-14
B3gnt4,7,21,214,242,-14
Gm9803,16,30,196,242,-14
Med16,2,16,224,242,-14
Tmem179,2,16,224,242,-14
Gnb3,3,17,222,242,-14
1700029J07Rik,3,17,222,242,-14
Fndc11,4,18,220,242,-14
Syngr4,9,23,210,242,-14
Gm6902,2,16,224,242,-14
Nlrp9b,14,28,200,242,-14
Gm3252,2,16,224,242,-14
Stambpl1,0,14,228,242,-14
Fam71e1,11,25,206,242,-14
Zkscan4,4,18,220,242,-14
Zfp54,2,16,224,242,-14
Atp10a,0,14,228,242,-14
Zfp808,5,19,218,242,-14
Pnpla6,4,18,220,242,-14
Shroom1,0,14,228,242,-14
Gm2974,13,27,202,242,-14
Gm3002,9,23,210,242,-14
Six2,3,17,222,242,-14
Mfsd2a,6,20,216,242,-14
Gm8108,11,25,206,242,-14
Gm21972,8,22,212,242,-14
1700056E22Rik,4,18,220,242,-14
Atoh1,0,14,228,242,-14
Tmem186,2,16,224,242,-14
Mfap2,7,21,214,242,-14
Srp54b,21,35,186,242,-14
Zfp810,2,16,224,242,-14
Slx4,3,17,222,242,-14
Smim11,2,16,224,242,-14
Cenpe,2,16,224,242,-14
Spink4,16,30,196,242,-14
Gm3264,12,26,204,242,-14
Gemin4,7,21,214,242,-14
Sema4a,5,19,218,242,-14
Vrk2,3,17,222,242,-14
1700016D06Rik,4,18,220,242,-14
Pom121l2,1,15,226,242,-14
Gm14408,20,34,188,242,-14
Frs3,5,19,218,242,-14
Fsip1,3,17,222,242,-14
Lrrc29,0,14,228,242,-14
H2ac21,24,38,180,242,-14
Gm14214,10,24,208,242,-14
Sertad3,4,18,220,242,-14
Pdia5,7,21,214,242,-14
Spata9,5,19,218,242,-14
Lpxn,3,17,222,242,-14
Tssk5,1,15,226,242,-14
Serpinb9b,2,16,224,242,-14
Jrk,0,14,228,242,-14
Gm49711,4,18,220,242,-14
Cacng8,4,18,220,242,-14
Abca17,1,15,226,242,-14
Glb1l,2,16,224,242,-14
Gramd2,1,15,226,242,-14
Sh2b2,0,14,228,242,-14
Ahcy,10,24,208,242,-14
Celf3,0,14,228,242,-14
Gm20431,25,39,178,242,-14
Tmem81,0,14,228,242,-14
Mamstr,3,17,222,242,-14
Pheta2,1,15,226,242,-14
Ccdc102a,0,14,228,242,-14
Tmc5,12,26,204,242,-14
Spdya,3,17,222,242,-14
Grin3b,2,16,224,242,-14
Kif14,2,16,224,242,-14
Nek2,1,15,226,242,-14
Gstm5,5,19,218,242,-14
Igip,3,17,222,242,-14
Xcl1,10,24,208,242,-14
Tgds,2,16,224,242,-14
Tspan32,3,17,222,242,-14
Pde6h,7,22,213,242,-15
F10,1,16,225,242,-15
Zfp354b,2,17,223,242,-15
Pparg,2,17,223,242,-15
Znhit3,2,17,223,242,-15
Gm10408,8,23,211,242,-15
Gm8138,2,17,223,242,-15
Adat2,3,18,221,242,-15
Nqo2,2,17,223,242,-15
Pik3cd,2,17,223,242,-15
Ribc1,2,17,223,242,-15
Pym1,3,18,221,242,-15
Kcnip4,2,17,223,242,-15
Gm3239,5,20,217,242,-15
Spink7,4,19,219,242,-15
Art3,7,22,213,242,-15
Pinlyp,7,22,213,242,-15
Micu2,2,17,223,242,-15
Nkapl,1,16,225,242,-15
Cd46,0,15,227,242,-15
Arhgef33,4,19,219,242,-15
Gm5426,32,47,163,242,-15
Snx22,1,16,225,242,-15
1700010B08Rik,4,19,219,242,-15
Cdc42ep2,2,17,223,242,-15
Gm3685,4,19,219,242,-15
Mutyh,4,19,219,242,-15
Gm43518,15,30,197,242,-15
Wdr54,1,16,225,242,-15
Zbtb9,9,24,209,242,-15
Tmem219,3,18,221,242,-15
Tmem217,8,23,211,242,-15
Foxp2,20,35,187,242,-15
Casq1,1,16,225,242,-15
Zfp956,1,16,225,242,-15
Fzd6,4,19,219,242,-15
Zfp551,3,18,221,242,-15
Zfp977,4,19,219,242,-15
Hao1,0,15,227,242,-15
Prl2c5,3,18,221,242,-15
Clip4,2,17,223,242,-15
Zfp37,3,18,221,242,-15
Kif18b,3,18,221,242,-15
Abcc3,0,15,227,242,-15
Guk1,2,17,223,242,-15
4930474N05Rik,2,17,223,242,-15
Aurkb,3,18,221,242,-15
Cox16,3,18,221,242,-15
Psd4,4,19,219,242,-15
Gm8281,6,21,215,242,-15
Dynlt4,8,23,211,242,-15
Fbxo5,1,17,224,242,-16
Tex14,12,28,202,242,-16
Tead2,2,18,222,242,-16
Pln,8,24,210,242,-16
Kcnj9,0,16,226,242,-16
Kcne3,3,19,220,242,-16
Igkv4-63,7,23,212,242,-16
Iglc2,7,23,212,242,-16
Fam229b,7,23,212,242,-16
Immp2l,10,26,206,242,-16
Ccnf,1,17,224,242,-16
Cd180,7,23,212,242,-16
Cdkl1,5,21,216,242,-16
Tnni3,6,22,214,242,-16
Dhx58,0,16,226,242,-16
Mppe1,3,19,220,242,-16
Msh4,1,17,224,242,-16
Capn1,2,18,222,242,-16
Ckap2l,4,20,218,242,-16
Arhgap19,2,18,222,242,-16
Gm5795,5,21,216,242,-16
Zfp563,4,20,218,242,-16
Gm9903,1,17,224,242,-16
Speer4d,6,22,214,242,-16
Calcoco2,8,24,210,242,-16
Trafd1,3,19,220,242,-16
Agtr1a,17,33,192,242,-16
Zfp512b,3,19,220,242,-16
A730071L15Rik,3,19,220,242,-16
Wnt16,2,18,222,242,-16
A930007A09Rik,1,17,224,242,-16
Smim17,11,27,204,242,-16
H1f4,4,20,218,242,-16
Zfp41,1,17,224,242,-16
Gm27027,20,36,186,242,-16
Rpl9-ps1,15,31,196,242,-16
Gpr31b,0,16,226,242,-16
Slc5a6,2,18,222,242,-16
Mettl22,3,19,220,242,-16
Srpk3,5,21,216,242,-16
Gm904,3,19,220,242,-16
B3galnt1,2,18,222,242,-16
mt-Nd5,6,22,214,242,-16
Ssxb2,5,21,216,242,-16
Dlg2,10,26,206,242,-16
Wfdc3,11,27,204,242,-16
Ppp1r14d,5,21,216,242,-16
4930558C23Rik,2,18,222,242,-16
Cbr2,11,27,204,242,-16
Tsnaxip1,0,16,226,242,-16
Parp11,3,19,220,242,-16
Pbk,5,21,216,242,-16
Zfp82,8,24,210,242,-16
Gm42417,24,40,178,242,-16
Tsga13,1,17,224,242,-16
Zfp759,4,20,218,242,-16
Zfp786,3,19,220,242,-16
Adgrf3,4,21,217,242,-17
H1f0,3,20,219,242,-17
Pwwp3a,2,19,221,242,-17
Coa4,6,23,213,242,-17
Gm15097,7,24,211,242,-17
Lyar,2,19,221,242,-17
Lrrc4c,1,18,223,242,-17
Wdr31,5,22,215,242,-17
Prr22,4,21,217,242,-17
Ldhal6b,3,20,219,242,-17
Zfp28,2,19,221,242,-17
Zfp433,13,30,199,242,-17
4930556J24Rik,1,18,223,242,-17
Cenpu,6,23,213,242,-17
Sgms2,5,22,215,242,-17
Prss57,2,19,221,242,-17
Plk1,4,21,217,242,-17
Pif1,2,19,221,242,-17
Gm20537,17,34,191,242,-17
Igsf10,3,20,219,242,-17
Ccnj,2,19,221,242,-17
Gdf1,15,32,195,242,-17
Kpna2,8,25,209,242,-17
Btbd8,0,17,225,242,-17
Exo5,3,20,219,242,-17
Apoa2,17,34,191,242,-17
Ifnz,5,22,215,242,-17
9130019O22Rik,1,18,223,242,-17
Ttc39a,1,18,223,242,-17
Lipt2,6,23,213,242,-17
Pet117,22,39,181,242,-17
Mtg1,5,22,215,242,-17
Zfp72,3,20,219,242,-17
Zfp974,4,21,217,242,-17
Haus1,2,19,221,242,-17
Iqce,3,20,219,242,-17
mt-Nd4l,6,23,213,242,-17
Rwdd3,5,22,215,242,-17
Gm10799,9,26,207,242,-17
Cbx2,0,17,225,242,-17
Smpd5,4,21,217,242,-17
Sema4c,1,18,223,242,-17
Pagr1a,26,43,173,242,-17
Tipin,4,21,217,242,-17
Fam24a,7,25,210,242,-18
Gm3604,3,21,218,242,-18
Tcea2,2,20,220,242,-18
Gm3055,13,31,198,242,-18
Gm5861,2,20,220,242,-18
Gm42674,17,35,190,242,-18
Il18,2,20,220,242,-18
Fancd2os,3,21,218,242,-18
Gm49320,1,19,222,242,-18
Pttg1,5,23,214,242,-18
Pttg1ip2,9,27,206,242,-18
Gm3005,7,25,210,242,-18
1190005I06Rik,1,19,222,242,-18
Ypel4,1,19,222,242,-18
Gm45799,19,37,186,242,-18
Zpbp2,1,19,222,242,-18
Tex38,7,25,210,242,-18
Gm20538,21,39,182,242,-18
Hoatz,2,20,220,242,-18
Slc25a4,5,23,214,242,-18
Zfp39,1,19,222,242,-18
Haspin,1,19,222,242,-18
Trmt5,3,21,218,242,-18
Zfp973,5,23,214,242,-18
Zfp111,0,18,224,242,-18
a,7,25,210,242,-18
Ccdc62,1,19,222,242,-18
H2bu2,9,27,206,242,-18
Cort,9,27,206,242,-18
4930550C14Rik,4,22,216,242,-18
Gm20479,30,48,164,242,-18
Homez,5,23,214,242,-18
Gm3893,7,26,209,242,-19
Myl10,3,22,217,242,-19
Pimreg,5,24,213,242,-19
Spag5,1,20,221,242,-19
Gm42420,27,46,169,242,-19
Nanp,3,22,217,242,-19
Evi2a,8,27,207,242,-19
4632433K11Rik,4,23,215,242,-19
Gm10203,19,38,185,242,-19
Gm3667,4,23,215,242,-19
Yipf6,3,22,217,242,-19
G530012D18Rik,22,41,179,242,-19
Etfbl,16,35,191,242,-19
Gng13,12,31,199,242,-19
Adam32,11,30,201,242,-19
Brme1,0,19,223,242,-19
Gpr183,2,21,219,242,-19
Dscc1,0,19,223,242,-19
Lrwd1,6,25,211,242,-19
Tmem249,8,27,207,242,-19
Zbtb3,1,20,221,242,-19
Spag8,5,25,212,242,-20
Cdkn3,9,29,204,242,-20
Cdc25c,3,23,216,242,-20
Gm49527,20,40,182,242,-20
Troap,3,23,216,242,-20
Espl1,2,22,218,242,-20
Pjvk,5,25,212,242,-20
Gpr162,0,20,222,242,-20
Fignl1,1,21,220,242,-20
Iqgap3,0,20,222,242,-20
Enkur,2,22,218,242,-20
H2ac11,16,36,190,242,-20
Gm7324,16,36,190,242,-20
Tgfbr3l,7,27,208,242,-20
Zfp85,3,24,215,242,-21
Spats1,4,25,213,242,-21
Car11,18,39,185,242,-21
Tmsb15b2,28,49,165,242,-21
Ska1,3,24,215,242,-21
Trbc2,10,31,201,242,-21
Nkx6-2,4,25,213,242,-21
Gys2,11,32,199,242,-21
Cdca3,7,28,207,242,-21
Mfsd6l,2,24,216,242,-22
Glce,4,26,212,242,-22
Morn3,9,31,202,242,-22
Hepacam2,3,25,214,242,-22
Gm3411,3,25,214,242,-22
Neil3,2,24,216,242,-22
Trav13-2,8,31,203,242,-23
Gm2237,7,30,205,242,-23
Bcl2a1a,6,29,207,242,-23
Npb,14,37,191,242,-23
Efna4,0,23,219,242,-23
Shcbp1,4,27,211,242,-23
Gm614,1,25,216,242,-24
C1ql4,0,24,218,242,-24
Pfkfb1,4,28,210,242,-24
Gm50364,12,36,194,242,-24
Tyw3,3,27,212,242,-24
Ccnb1,2,26,214,242,-24
Chst12,2,26,214,242,-24
Zfp784,3,27,212,242,-24
Lkaaear1,4,29,209,242,-25
1700029I15Rik,16,41,185,242,-25
Gm3636,2,28,212,242,-26
Hdhd3,4,30,208,242,-26
Gm3468,8,34,200,242,-26
Ssmem1,5,31,206,242,-26
Gm32687,16,42,184,242,-26
Efcab8,3,29,210,242,-26
Wfdc21,13,40,189,242,-27
Dnah14,14,42,186,242,-28
Gm15013,8,36,198,242,-28
Gm45785,5,33,204,242,-28
1700109H08Rik,16,45,181,242,-29
Il4i1,7,37,198,242,-30
Tmem89,8,39,195,242,-31
Spata45,18,49,175,242,-31
Fam24b,14,47,181,242,-33
1700028K03Rik,4,39,199,242,-35